rqyy	的
ggll	一
jghu	是
dhfd	在
dhi	不
bnh	了
def	有
tkg	和
wwww	人
ypi	这
khk	中
dddd	大
hgd	上
ytny	为
whj	个
fpi	过
lgyi	国
trxy	我
nywy	以
fbn	地
wbn	他
svf	要
goi	来
wun	们
jfy	时
gcfj	到
tgd	生
ehk	用
wthf	作
ykiy	就
bmk	出
gfk	于
wfcu	会
cfy	对
wvr	分
dnxy	成
rhfk	年
skd	可
mgkd	同
ygd	主
bnhn	也
ntcy	发
aaaa	工
yukq	说
bbbb	子
ghi	下
cexx	能
fcet	动
tgsh	行
ute	产
dmjj	而
qqu	多
rgkd	后
yygt	方
dmjd	面
tkhh	种
ipbf	学
aftj	著
ughf	着
tjgf	得
pghu	定
ifcy	法
nav	民
rnrh	所
xcag	经
fgh	十
dggg	三
pppp	之
fjpk	进
pgeu	家
tffu	等
ukbh	部
jfd	里
ftjb	都
thd	自
fgg	二
vkg	如
gjfg	理
fhnv	起
ent	力
tayi	长
wxn	化
gmqn	现
ihty	小
oaci	度
pudu	实
hkou	点
ykmk	高
dhpi	还
ivf	当
jnv	电
ekg	加
gmww	两
wwy	从
fcu	去
tqrt	物
rcn	把
sgd	本
vbg	好
iiii	水
rmhj	制
wsgg	体
gak	开
ogd	业
tgjf	重
wgkr	使
gdi	天
qdyo	然
hxff	些
jgjf	量
uejj	前
lhng	四
ngbh	那
qhy	外
gkvh	事
pxb	它
qkf	名
wgkf	合
ldi	因
oigd	应
mhng	由
adwu	其
jjjj	日
ntgg	性
pyfg	社
yri	义
wgf	全
sugh	样
ghty	政
geu	表
swn	机
udu	关
usrh	新
gufk	平
tkf	各
shg	相
ujd	间
nyny	心
ghd	正
gngd	与
sghg	西
gaet	形
rci	反
rhf	看
jeg	明
cccc	又
tcu	么
mwi	内
wqiy	你
wjgg	但
tjh	利
uthp	道
drii	原
iwcy	没
txht	第
xxn	比
wgkb	命
ovty	数
kwu	只
xfxy	线
tmkd	向
ukd	问
ujnu	意
uhkg	站
hxn	此
akgd	或
tsu	条
fqv	无
wcu	公
rfmi	质
xfkg	结
qehg	解
ngeg	情
vgpk	建
eeee	月
shnu	想
tvey	很
yocu	变
ftjf	者
wayy	代
nnnn	已
uuuu	立
txiu	系
plj	军
jbcu	最
uaj	并
rjgh	提
ipkq	党
jghm	题
rnb	气
gghg	五
naei	展
qkeu	象
yygy	文
cehp	通
uknu	总
jsi	果
uqwy	次
kmu	员
akfj	革
itdg	活
tkgg	程
ipkh	常
udi	头
wug	位
ftxb	老
fhf	直
tyi	入
tffy	特
kkkf	品
wtgh	件
mmmm	山
mqb	见
khtk	路
giyi	求
tphn	管
byi	及
xbyy	级
ite	少
adwf	基
kejh	别
ywcy	设
aayi	式
uqwm	资
tdkg	知
xegg	组
wtn	几
rtgh	手
ywxn	论
xycq	统
ruvg	接
pei	农
puhc	被
epe	边
rxjg	指
uqfy	将
oufh	料
vtn	九
unwy	决
tfqb	先
svey	根
adwe	期
yfh	计
xkjy	强
fggh	干
hkay	战
lkd	回
yty	放
vbn	她
xwgk	给
wtfg	任
fcpi	运
wdty	做
nte	必
iyck	流
ari	区
bcy	取
uyhn	门
thi	处
rndg	据
fmuf	南
mjh	则
bwy	队
ltui	图
uxn	北
djf	百
igqb	光
ickg	治
aii	东
wksy	保
fnu	志
lywr	较
wycm	领
itxy	海
kkkk	口
agn	七
nfu	导
ymfk	调
vcbh	即
wfh	什
tfkp	造
qqqq	金
ktnn	吃
fwmq	规
qvhj	争
lnu	思
anv	世
awu	共
ywu	六
ywy	认
ywru	交
epcu	受
bwjh	阶
qcb	色
budy	联
sbyy	极
ugdu	美
iyjh	济
gjri	更
rsh	打
nty	改
gmfd	再
fulj	增
nhty	收
igeg	清
avt	切
fhwu	真
ftbt	教
fnrt	场
scy	权
pvf	安
gqe	万
syi	术
yghg	证
tmdt	身
ter	务
fhu	走
gkph	带
ufk	斗
qehj	角
ulj	单
awxb	花
hhhh	目
pfqb	完
fnr	声
rvyo	热
rbcy	报
wty	八
rrrr	白
fte	才
hwu	具
gcff	至
xtay	张
cgd	马
txu	每
ytdg	话
dpi	达
lfny	转
yyry	议
tufh	科
kkdk	器
fiu	示
dqeh	确
ytfh	许
wynb	今
wgqj	例
wysu	集
wyg	信
ynn	记
tkwy	积
vtkg	群
hhr	步
gkih	整
oygt	广
wri	风
wfny	传
lwjj	界
wxfj	华
egd	且
fqb	元
yrbc	离
dfyi	压
dgah	研
pwvb	究
ukqn	况
nnhy	书
rug	拉
odu	类
abj	节
esu	采
cmqn	观
fhgy	越
wwwu	众
rffy	持
knhh	叫
img	油
gkip	速
xkwy	织
ssy	林
wdwc	段
cwyg	难
fdmj	需
hdhd	非
tjtu	复
qtn	儿
tvgh	律
dmhj	布
bfiy	际
lpk	连
thaj	算
ipws	深
pwwk	容
tfk	千
rpk	近
mfkd	周
jyke	影
onrh	断
nngn	己
ewi	办
edmy	须
yumk	商
dgtg	石
gef	青
oyty	米
wgjr	便
dgkn	感
ithf	省
fcu	支
wskg	何
lfte	团
cgwg	验
ugk	半
tygg	往
xqyy	约
dyi	太
dqb	克
aper	劳
dee	历
tlf	备
gqjh	列
wqay	低
tvf	委
ymhj	市
kri	史
ktmk	响
uwyg	准
ogeg	精
nud	习
iieg	消
pgng	写
whnd	候
ffff	土
tqiy	称
rfcy	技
pwaf	空
owfi	府
usu	亲
tfnv	毛
ijlg	温
yxif	率
bpfq	院
ajh	划
ufye	装
dhbd	存
hvey	眼
nnwy	快
sfiy	标
wfhg	值
yttd	族
gggg	王
sjgf	查
iag	江
adwr	斯
gxiu	素
fcbh	却
bwgs	除
kgnb	号
wygg	住
stkg	格
cder	参
iagw	满
vckg	始
tewc	般
qnv	包
ykwy	识
fnyi	专
ykiu	京
jvko	照
lgnh	车
rpvg	按
tfqp	选
oooo	火
jqrr	易
dgt	厂
krh	听
yynw	该
xag	红
ntky	属
xwyg	维
egcu	县
godr	严
irey	派
nnkd	局
yfjh	讲
knxn	呢
xonn	继
uthf	首
thgn	片
sqcy	构
vvvv	女
tfln	德
gqxv	死
ywrt	效
yooy	谈
rwi	失
pyjh	神
yneg	望
wwjh	价
qrwy	铁
sgct	酸
oqay	底
amwu	黄
bdep	随
aewu	苏
xhh	引
rwyg	推
anb	艺
qiu	尔
phnn	官
tdpd	适
rxxn	批
amdu	英
tfkf	告
oamh	席
igwg	举
sbf	李
jgmh	师
rvye	势
xlg	细
dtbh	帮
jogf	显
admy	项
udyy	状
pbf	字
ycef	育
nfci	层
dhcy	破
aitk	落
thfn	怎
apkk	营
fqpv	远
fghg	士
ckf	台
whf	企
epdc	爱
yyyy	言
iskg	河
sgnn	配
lfnh	围
gajf	型
ebcy	服
fjfe	朝
lcag	轻
jcxi	紧
fhny	武
wcy	仅
ker	另
ujfj	章
gogd	亚
pymq	视
fffy	封
pntm	密
iygg	注
sftt	材
pvsu	案
wawy	供
hhgg	止
ssss	木
xfnd	续
jfj	早
byt	防
rynt	护
ugjh	判
dynu	态
ngkd	司
ldd	固
wnyw	似
lhdd	罪
lfou	黑
ycqb	充
igwu	兴
afsu	某
scfy	树
gbj	击
gcft	致
lkmi	圆
iywy	液
ujf	音
jcff	坚
khu	足
qmu	负
pdhk	害
wynk	含
wgsu	余
fwi	夫
rhdd	排
xjmu	费
idri	源
ipmq	觉
aibb	范
daf	左
qkqq	够
ugaf	差
fdny	城
dwjf	春
wyve	食
rgwu	兵
ytbn	施
pgkl	富
fqug	均
lfhf	置
udgy	减
dty	故
kju	虽
uljf	曾
hkf	占
udpi	送
ttdu	笑
yaay	试
bkwy	职
rnug	氧
bjg	阳
icy	汉
qyvl	留
khve	跟
whte	修
cnhn	巴
wbjh	创
eget	助
fii	未
qtbn	犯
puvt	初
aet	功
rywn	抗
llll	田
fdhy	坏
btah	降
dghg	古
nyuu	尽
gxgd	互
mftt	财
ipwk	溶
ugmw	病
kfh	叶
rwcy	投
tgmi	策
gmu	责
ihcy	波
wycu	令
qtjy	独
ftgn	考
dkf	右
ygeg	请
ggiy	球
yhgg	让
gklj	副
ccy	双
swgg	检
pegf	宜
vsu	杂
qfxy	钱
sypi	述
bvey	限
tujf	简
ray	找
ukhh	冲
umdj	端
lwgj	输
wgcj	倒
ufwj	养
tdty	敌
bskg	阿
fhvk	超
rqmd	换
ytyh	州
etgg	胜
yuph	帝
wyey	依
wwfd	坐
xnn	纪
pwdy	突
wynn	念
ptkf	客
xqcn	绝
tak	升
baiy	陈
ltkg	略
uwlf	益
dhkf	否
lqu	罗
wbt	仍
kbyy	吸
adf	苦
qajg	错
bdii	承
dcu	友
ajfj	草
ywty	夜
tmgt	微
wdny	优
glbj	画
dbmh	础
fewy	协
yvei	良
tmdf	射
mad	曲
iugh	洋
sfy	村
dot	矿
xtuy	终
lwxn	轮
fnwy	块
gdhy	环
srh	析
tcag	径
kngb	哪
gqjo	烈
sywr	校
srcy	板
fcu	云
yryy	诉
vcaq	既
nfpk	迅
yntj	刻
tfkd	靠
pwfi	察
gepi	逐
mdi	央
tffy	待
xnny	母
fujq	境
iryt	激
ifpe	渤
sajd	模
rpwa	控
bgd	卫
qyi	久
qgbh	印
ynye	房
wyks	停
adwn	甚
hci	皮
iyth	洲
rykk	搞
thnu	息
tqqy	移
hjg	旧
wgkr	拿
adkf	若
sdmy	顶
tdgu	短
ideg	湖
rtdg	括
rplh	挥
wvpc	侵
lhnh	甲
iytb	游
ygkg	语
uwyc	冷
uogj	普
qvey	银
tnii	乐
atdi	医
oatq	烧
yjh	刘
kcgg	吗
qfh	针
xqan	纸
owvt	粉
aety	散
qvnu	急
cnhm	预
rot	扩
drin	愿
synw	核
kcn	吧
dxyi	龙
ykgd	误
cqwy	欢
bynw	孩
fhlf	盐
uguk	善
fghy	雨
wxmu	货
yfy	讨
imjh	测
xxgf	丝
pgcf	室
ijxx	混
xulh	弹
tufk	乎
qgug	鲜
jqkq	晚
tdnn	乱
iitt	沙
ocnh	序
rmnw	缺
aqty	获
yfnd	读
qgjf	鲁
flxy	载
ilrh	渐
wru	父
kbsk	啊
ipgw	演
mrjh	刚
pfu	守
psj	宁
rsu	杀
yleg	谓
gajh	刑
bwfy	附
rjgg	担
khgm	贵
gytg	班
tqvn	稳
qmry	钢
rpd	迫
twgk	答
khan	距
axqy	药
wnhc	假
ykpn	毫
udf	兰
fkuk	喜
xanw	练
nnll	乙
isgg	酒
rfhd	盾
lsi	困
nudu	买
pygl	福
tghg	征
begg	阻
rkmy	损
wjj	介
yjjh	剂
pwat	穿
qkhh	钟
kdmy	顺
nui	飞
dhk	丰
nrg	怕
pyeg	祖
cnht	矛
rvyy	执
jtgf	星
ywyg	谁
tld	血
uxef	背
ipkr	掌
eukq	脱
rdmh	希
yguf	评
ipwn	沉
svcq	概
khqn	跑
ykbo	熟
wtet	伤
yeu	衣
saah	械
oldy	烟
pjhj	审
rnrt	扬
toln	翻
toy	秋
fkhk	露
njlc	慢
geqh	静
qkqb	免
wkhy	促
khfy	践
efcb	脚
vcgg	妈
puhy	补
aigf	薄
tgk	牛
qkd	句
rngf	握
xyna	编
odi	庆
ykpw	亮
ttfn	笔
ndd	居
kfiy	味
jmdy	映
rtth	斤
fukg	培
swcy	松
xte	乡
yffy	诗
naj	异
bnn	孔
dbdm	顾
ktuf	呼
tjf	香
aesu	菜
dgvy	威
nxv	尼
rrhy	抓
aty	攻
dskf	奇
wukg	倍
jtyg	临
rhjf	掉
mqu	岁
ewgg	脸
ndjh	剧
sksk	哥
thnp	延
gsi	末
qieg	销
rgf	皇
ynii	永
irnn	汽
jyki	景
vyve	娘
wfnh	伟
yjj	齐
bgbh	陆
fhri	赵
flf	雷
qdbb	危
deg	胡
bciu	聚
dyck	硫
gkii	束
lmg	轴
ddcu	套
owwf	座
oyve	粮
osh	灯
yjsy	课
xvkg	绍
snrt	杨
ndhy	怀
qnrc	饭
fhfk	赶
xpwj	缩
ptkm	额
biy	孙
srmh	棉
fkuc	鼓
pamq	宽
xviy	绿
kthh	川
dfu	夺
jvg	归
goi	灭
oafs	煤
pfiu	宗
tqds	衡
udbb	卷
jelf	盟
xuxu	弱
ujqb	竟
qfhw	镇
wgsp	途
djbd	厚
qehj	触
rajg	措
adny	藏
gyi	玉
kwgk	哈
fwyc	零
swbn	枪
vou	灵
bwgg	险
ffiw	款
vkf	召
ynmp	遍
kaht	呀
nbty	敢
gogn	恶
wajg	借
sksw	歌
eyrb	脑
icgh	泽
ivsu	染
otfp	庭
kjjg	唱
ykh	训
ipkf	堂
fakg	域
sfhg	植
arqw	欧
ptfq	宪
gqje	裂
vcer	努
tavt	彻
rpws	探
iwkg	沿
yne	户
rdfe	振
oug	粒
hhdm	频
hgih	督
fkeu	袁
tfag	垂
xgbn	纯
xmwy	纳
rrh	折
rkks	操
jujg	暗
dmjf	耐
wwvt	份
viu	录
fnud	卖
vepi	退
jmhp	遇
awsu	茶
iugg	润
mwwi	肉
ovii	康
kwyg	唯
ipey	浓
eqnn	胞
twfu	符
fvf	雪
duxx	磁
fmuy	献
tewk	船
nynn	忙
wnnp	追
wvtt	伊
tukq	税
tcy	私
tyna	篇
telf	盘
dhtu	夏
hghu	卡
uglf	盖
sgh	丁
tbf	季
qbpk	迎
cnhj	予
eksu	架
beg	阴
vnt	刀
blh	阵
gnny	瓦
jfch	野
dnxl	盛
rnca	氢
iejh	削
wjhh	伸
fpxi	索
ytaw	旗
qrnu	忽
yyt	访
lxiu	累
oqdo	燃
hani	虑
yopi	迹
you	亦
mawu	典
jjjf	晶
dcwy	雄
itpy	泛
yafs	谋
rtan	托
tbpe	透
samw	横
ngcf	屋
rii	朱
nyki	惊
dlf	奋
fwfj	替
uceh	痛
fyey	裁
rmg	抽
ssnh	楚
nkup	避
dgjr	硬
paws	寨
osi	床
yupy	旁
khgp	遗
uxht	弟
itfq	洗
mhgl	幅
gxu	毒
gbnm	顿
imkf	尚
pawf	塞
jawi	暴
ytmf	谢
pgyu	宝
ludb	圈
rvkg	招
eset	彩
ubd	闻
eywr	胶
gqfy	残
gmap	遭
wrbj	爷
wgsf	斜
aqky	警
rjqn	揭
qgf	鱼
tocg	释
wxdm	倾
ifje	潮
xfmu	贯
wyna	偏
rerm	摇
jtyl	监
mqcy	购
twgs	徐
wfy	付
dou	灰
lfqv	园
rlfc	摆
gqri	殊
abio	蒸
dywf	碎
oovk	糖
yngk	词
ditn	耗
tfqm	赞
oqnn	炮
kgdu	吴
wgen	愈
fwyg	堆
mef	骨
mnwn	凯
tfj	午
stdj	桥
and	巨
giyt	救
apsu	荣
xwvt	纷
dwtu	秦
ysh	订
ytnh	旋
pdhj	割
wmjh	侧
xtfh	纤
wyi	凡
ynv	亡
sfh	杆
xyxy	弦
qnpn	馆
ldnu	恩
psu	宋
vvg	妇
kqwy	吹
ler	男
thgc	版
ssfi	禁
txti	繁
imeg	滑
mty	败
rgey	捕
rcgh	择
ovhk	唐
rtol	播
wrcb	爸
inxn	泥
khqi	跳
vtkd	君
iyox	湾
dmdo	碳
xpfi	综
onty	废
ofd	庄
kgbn	吨
olk	库
hgeg	睛
sovg	楼
ossi	麻
ihht	涉
nyi	尺
vijh	剥
woy	伙
gtu	麦
fjgg	坦
khxh	嘴
cqyg	鸡
bghg	耳
awsk	荷
pawm	赛
ecn	肥
mdfj	岸
wwkf	谷
rnn	扎
qmgk	铜
tffs	街
ohkd	店
tuu	冬
oynt	炉
vdg	姑
ndoy	恢
hawe	彪
nxfm	惯
yvce	朗
tbr	秀
cehe	勇
cgyg	驻
ekmu	贺
hef	肯
rlgh	舞
apfe	蒙
jjf	昌
oegg	粗
rqay	抵
qyvm	贸
wnn	亿
wtry	俄
qvgp	键
wqin	您
ytey	旅
wgku	登
nkuf	壁
tuxv	乘
fjk	井
uwi	闪
ijog	湿
xegc	缓
iawy	洪
tntt	秘
ayr	芳
ifh	汗
ufte	闭
hhy	卜
xxfj	毕
ajdu	莫
ivgh	津
rffg	挂
qipi	逃
ossd	磨
nhju	蛋
ewcy	股
tqti	黎
fawk	塔
ubtf	塑
amu	贡
iawn	港
owfw	腐
tawy	筑
uiy	冰
uqvh	净
wvgp	健
gqfh	殖
vqaj	婚
vcy	奴
rtfe	插
udyf	辩
xyt	纺
gmij	刺
krug	啦
akfe	勒
regc	援
wqke	像
wyry	仪
abut	萨
tfhy	徒
gaj	弄
iyve	浪
bqeg	陷
ian	汇
bibk	函
wsy	休
oanw	炼
wfkf	舍
fhcy	坡
qynm	岛
qtfj	猪
ykbb	郭
bgkh	隔
rnvi	氯
ynnu	忘
idu	尖
wdyy	伏
iebg	浮
haog	虚
eeg	朋
repc	授
ghcy	玻
htfg	睡
bujf	障
ufj	辛
ddgy	碱
wvmu	贫
mdf	岩
ihg	泪
ahnh	臣
xtdh	疑
iywe	滚
ufg	壮
ivws	梁
ainr	荡
ynkd	启
gmdj	瑞
pwer	穷
afd	甘
tshf	箱
ujff	童
iooy	淡
mtdh	峰
xmry	纲
ahte	牙
ncfg	怪
wxjh	佛
exjg	脂
othf	炸
fufj	幸
fwyy	截
tty	牧
wykf	售
ajtl	蓝
qujq	镜
fdfe	震
lfcu	罢
qkmw	锅
xatq	绕
lqwy	软
rehh	拥
usgf	尊
gkuf	豆
pynn	礼
tuxj	剩
rpwi	擦
difj	耕
utem	颜
dwiu	泰
altu	菌
xgmy	绩
akge	勤
thth	竹
rtbn	拖
dnyi	尤
wgg	伍
qud	匀
qtdh	锋
ojai	爆
fjh	刊
vtgg	姓
wyt	仿
ntfn	尾
eyni	脉
fnhp	违
wwkw	欲
tmgk	筒
imgk	洞
gyrc	璃
lfof	墨
lfoy	默
dtbh	邦
tieg	稍
gmyy	丽
griy	珠
stxy	梅
kjqn	喝
tmhk	币
pwtq	窗
qav	氏
ifwj	潜
rqnn	抱
sssu	森
pumg	袖
kdgy	喊
eawc	毁
cvey	艰
rqiy	挑
wyou	焦
pou	灾
iqnn	泡
ossr	摩
gudi	夹
sfcy	枝
fctd	埃
kgf	呈
kthg	咱
ralg	描
ibn	池
vegg	姐
pawu	寒
pkkf	宫
flay	戴
fou	赤
esvg	腰
fghy	寸
aqkt	敬
natf	懂
nnn	忆
ifkg	洁
myd	丹
ioac	渡
khtd	跃
mhny	贝
duog	碰
uxth	凝
yftj	诸
dgqe	励
ajdh	幕
sygg	柱
uqdu	奖
xxge	缘
vbt	奶
tdkj	智
ifnn	污
dfaj	奔
rvg	扫
vii	隶
mrri	网
qnqn	饱
tvrc	魏
vijk	肃
lvn	轨
hawv	虎
sfg	杜
bqvn	隐
kqb	兄
tfpd	廷
jtyq	鉴
vfu	寻
waye	袋
jhk	申
btgg	隆
ydny	诚
usgp	遵
sfiu	票
ssqu	梦
rrkf	哲
xitt	纱
ylf	亩
qtbl	猛
uvou	兼
fgey	埔
gwet	珍
rwbn	抢
fhbc	趣
djfd	厘
cqb	允
fgef	博
rqci	鬼
aynk	荒
qgey	铺
wwxn	伦
inrt	汤
nwgk	恰
rdcy	拔
awyn	恐
yoxb	弯
jatq	晓
cff	圣
jsdm	颗
dwgd	奏
vfiy	妹
khnu	忠
trfh	循
iqcy	沟
teyw	航
hxsu	柴
djgf	碍
tei	舟
pdsk	寄
qhkg	钻
rckg	抬
udbh	郑
trdh	稀
dmu	页
kfam	喷
rajd	摸
mdou	炭
agnn	巧
sskg	柯
mhkg	贴
hjsu	桌
caet	劲
eudg	腾
gvhv	妻
qdtf	铸
qukq	锐
bqrm	陶
ycaj	弃
fofo	赫
tpu	乏
uitd	阔
hxxi	紫
thgf	牌
ryjh	挤
opi	迷
uymh	闹
lyjj	罚
rrg	拍
dcgg	码
wjmy	偶
pyug	祥
nmd	届
wycb	邻
lrjf	暂
eajd	膜
qngd	乌
doqh	磷
ejgg	胆
ryct	撤
cay	戏
igql	辉
ynfh	讯
wfg	仁
awyy	巩
grdf	碧
rcyi	瓜
vynu	忍
twgg	签
cbh	邓
fkf	吉
wyfj	储
sffg	桂
uxhp	递
ubk	疗
prgw	宾
iyud	滴
glii	柬
xkjn	绳
rdny	扰
itkg	洛
evep	腿
yugh	详
jhny	虫
ttgg	牲
hdhn	悲
ksu	呆
hwbj	齿
qtgg	狂
sqtb	柳
jegc	暖
ukqb	竞
qlpy	链
wmwy	催
wkhh	仲
oudg	烂
sgjg	醒
rpwn	挖
xyy	纹
kkdy	哭
yxlf	畜
gfqn	玩
tdij	籍
ifxy	浅
xtdp	缝
vcnu	怒
erqn	貌
tonu	悉
bnt	乃
khij	踏
cnhs	柔
ykbf	享
ipkm	赏
jhf	冒
fff	圭
uqiu	浆
jdfe	晨
thcy	彼
kskg	呵
yned	肩
rhyc	爬
xxrf	皆
rnpv	氨
xwwy	纵
tegg	租
iff	尘
vpv	巡
xftj	绪
uagy	瓶
mhjh	帽
riu	泉
xet	幼
tykk	稿
qmwy	钠
pfqf	冠
xrcy	弧
fhqv	趋
iqgg	渔
twcy	役
wugh	伴
nkuf	辟
rfqn	抚
way	伐
wtfw	凭
xnhh	纠
txty	敏
fake	霸
qkkg	铝
wci	凤
ugj	羊
ihcv	婆
dxye	袭
pykq	祝
ptgj	牢
irrh	浙
qimy	锁
ycgh	译
odeg	糊
eqrb	胸
fpwb	壳
eewy	胁
wrqq	爹
nfam	愤
iwgs	涂
xfgg	疆
hdhl	辈
nypi	迟
hwbc	龄
tmod	奥
ubtp	逆
ffhw	填
dtfu	寿
lnn	轧
jgf	旦
nvey	恨
gkmj	融
lftj	署
rtec	搬
trwy	秩
qwkg	铅
wvlf	盆
kqyg	鸣
sdhy	杯
iaky	灌
uwai	阀
kkhk	串
ykpe	豪
kkhn	患
rtfp	挺
ipqn	沈
rdjn	掩
ebnn	乳
qyng	鸟
fjfh	韩
mpgg	贮
igdn	添
rkg	扣
gklp	逼
egcn	悬
mwyc	岭
pgfj	宇
nkue	臂
ordh	烯
uyki	凉
wsu	朵
whmy	侦
titt	秒
teeg	稻
tolf	番
nhd	眉
cgar	驱
jlxi	螺
rnoo	氮
dyi	丈
ijlc	漫
tdtf	筹
ggwn	琴
dsk	厅
fter	雾
bgud	陕
bpk	辽
cayk	巯
xwfc	绘
suxt	梯
akff	鞋
rnyw	拟
brcy	孤
rdfh	拜
wdui	僚
lkbg	辑
wjjg	倡
gmwi	丙
wqbh	仰
najg	惜
ryi	斥
rfwy	扶
infy	漏
wwwk	俗
alf	苗
vxy	姆
lgey	辅
rang	拒
wipc	偿
dpqb	碗
qjqr	锡
rcpi	返
qtqk	狗
iaqg	鸿
tduf	辞
fjfg	埋
aaht	芽
tdan	矩
mmru	岗
okks	燥
mpfi	崇
omd	庙
kywr	咬
mfhy	赋
dwgj	奉
dgqe	厉
sqiy	桃
blf	孟
rbcc	摄
uukq	阅
iceh	涌
kwfk	啥
vitt	妙
qci	勾
ywcy	讼
sqke	橡
qnjy	蚀
jajg	蜡
rvet	抛
qtve	狠
ahko	熙
rnhf	扭
rnty	拨
auqf	蒋
sagg	框
uaiy	冻
fnv	亏
vgkt	嫩
wgsc	叙
uejv	剪
jlcu	曼
ugrc	叛
sou	杰
cet	劝
hgic	叔
opwk	熔
qnqw	饮
wbg	仔
cgya	骗
rujf	撞
cccs	桑
nbmk	屈
sdwg	棒
gkim	赖
nmhj	刷
wdg	估
ipgh	淀
gkri	吏
tdxy	笼
tamw	簧
ynnd	扇
yuoj	谱
sgtk	酷
ykge	衰
seeg	棚
fyke	壤
asgf	苯
wyty	伪
lccu	轰
wtdj	侨
dptg	牵
thlj	鼻
kcy	叹
kkcg	骂
cgbi	骤
fueu	丧
jgg	旺
kjfg	哩
biji	隙
gmaj	曹
utdi	疾
kfg	吐
mmgd	册
sttt	覆
gogj	晋
rhy	扑
trhb	御
rehc	搜
wdyy	仗
jthf	昨
wfkh	舒
sriy	株
koss	嘛
rqwy	欣
etay	胀
ditt	砂
epwa	腔
wwgj	偷
xtkg	络
fqdm	顽
ixty	涨
tdaf	甜
kmhj	吊
uqwl	盗
sywn	杭
nngt	尸
rkhy	捉
uewc	毅
gqpe	迈
eofg	脏
qtyy	狱
rawk	搭
sfir	飘
oou	炎
uehc	瘦
ivpc	浸
dffg	硅
khdn	跨
iatq	浇
ohkg	粘
ahty	雅
jxxb	昆
sgmj	槽
iswi	漆
rqbh	抑
nieg	悄
ayxl	蓄
qrmh	锦
dhgh	歪
waym	贷
odmy	烦
raet	撒
ixjh	沸
usi	闲
ykps	亭
efg	肚
rnbm	掘
rytp	邀
yvcb	郎
itfk	浩
akuo	燕
isfi	漂
tghn	惩
evf	妥
wgef	傅
tsg	牺
wynm	贪
tfpk	迁
ians	渠
tfcu	丢
lqyg	鸭
xadt	绒
qsh	钉
icwy	滩
mhty	帐
dieg	硝
igqy	耀
efke	膨
mbh	邮
jcmu	贤
igwy	誉
uqwy	瓷
adww	欺
wwgf	丛
rgsy	抹
ndny	忧
bukg	陪
gkf	吾
iter	劣
gjhn	惠
qlh	钾
oqeg	焰
tmgt	徽
wksf	堡
rbk	凶
ryud	摘
uni	闷
eqdb	脆
vqiy	姚
mfky	雕
bfwt	陵
atgf	董
yadk	诺
diu	泵
fhhi	赴
wgij	剑
eajg	腊
pwkw	窝
hnr	卢
qwdc	锻
rmay	罐
jtyq	览
pjvf	宴
qajf	昏
iexd	溪
uwri	疯
vipi	逮
puwk	裕
bclf	盈
adwe	勘
xryt	缴
trie	穆
xnn	幻
qwyg	锥
fywn	坑
pwdj	宿
inty	泼
ishg	湘
dxyf	垄
qnth	饰
cgkr	驶
ftjo	煮
tdjh	刮
dqwy	砍
nhyk	疏
jfj	旱
nayk	慌
icde	渗
agny	戈
igg	汪
ngkg	悟
jqbj	昂
sceh	桶
hcdm	颇
cgdk	骑
wffg	佳
fwyf	霍
xjf	旨
anu	芯
jhnr	畅
qjd	旬
rcwy	摊
ffuk	墙
ykmc	敲
anhk	蔬
uvei	痕
ncde	惨
qghn	钙
ipfc	尝
sfwt	棱
udyf	辨
tuej	箭
tmdk	躺
awbb	苍
agou	莱
wgmy	债
gdkf	吞
fmy	坝
qtvb	卿
rivg	挡
srg	柏
avij	萧
fhwm	颠
ftxu	霉
ypeg	谊
vyt	妨
twik	黏
iajd	漠
lgmw	辆
ywrb	郊
wgmw	俩
fkue	彭
qtny	夕
ufwt	凌
pdcu	宏
lqpi	逻
iwyg	淮
qnwn	饥
cexo	熊
xjhh	绅
fnhc	霞
uckg	冶
rvyf	垫
atdp	蓬
ucgg	冯
klge	喂
hwyo	瞧
yxu	玄
mnb	岂
cccg	叠
aqgy	葡
ykeu	哀
wmh	仙
kghy	吓
sadw	棋
iprw	滨
rgd	丘
wwgh	佩
ffu	寺
qtdy	犹
pyvi	禄
cgbn	驰
alpu	莲
aqv	匹
thhy	徙
yaww	诬
rwgk	拾
sdg	枯
iplh	浑
wcdm	颂
cgrr	驳
nfin	慰
ytbt	诱
qre	勿
ckbh	邰
jqww	歇
utkd	阁
fkuk	嘉
igsy	沫
udrj	拳
qnua	饼
dhgy	戚
qvhc	皱
ryki	掠
fovk	塘
wvn	仇
qpgh	锭
ujqn	竭
vffg	娃
pqky	冤
hghg	凸
rryy	拆
jhng	曰
rrqw	掀
shy	朴
rmwy	摧
iqyl	溜
rhbh	卸
fftj	堵
tjgh	筛
uhci	疲
fsxy	栽
eckg	胎
etjt	腹
ekcg	驾
xfnh	纬
rhg	扯
wvdm	颁
qnty	饿
whtn	悠
pykw	祸
dhdn	慧
temq	舰
uqwv	姿
yonu	恋
uepi	遂
ahnh	卧
qbnu	怨
sgyf	醉
ouvo	廉
khgp	遣
qtgd	狭
ahdd	菲
tjtg	犁
wntd	侯
nnyg	羽
vldy	姻
rufh	抖
dhvd	契
aqrm	萄
uulk	阐
ynhf	盲
tmds	躲
fnhk	韦
yxxr	谐
qii	兆
tdd	舌
wdag	佐
nuak	屏
ynvf	妄
enrt	肠
sgfb	酵
ajdf	墓
ngjg	恒
rmag	缸
sgmw	柄
ykbt	敦
nfhw	慎
fjgh	堤
rrpk	逝
madt	贼
lpdk	辖
fcrc	魂
rlh	押
sudg	栏
bmfi	祟
ief	肖
acnt	茅
rgvh	捷
rape	捞
dhqc	艳
jtdh	蜂
tdhp	逢
lhjf	罩
sivg	档
ulgk	兽
dfef	辱
ripq	搅
thdy	臭
aumt	蔽
qwyc	铃
tdjj	乔
ynwy	雇
rqkq	挽
awvr	芬
davt	砌
rugh	拌
nywf	翠
sgyb	醇
xqiy	弥
vehc	嫂
oywf	粹
rhcy	披
qtye	狼
pwtf	窄
sang	柜
issy	淋
jgeg	晴
rqkg	拘
phgc	寂
iuxx	滋
ahtg	鸦
rryf	誓
dgky	咸
aiyn	茫
udwd	凑
apu	芝
hqce	餐
mtay	账
mxxi	幽
nawc	殿
wgkl	盒
thdc	篡
ajef	萌
rqvh	挣
lgeu	畏
ermp	遥
ylkm	颤
sgyh	酬
vfh	奸
ddyi	厌
isg	洒
veff	垦
mukg	赔
rctd	挨
ritt	抄
xyuh	缔
mgud	峡
aynr	芦
wimk	倘
fdhg	坯
nttt	履
mhk	巾
pmf	宙
fcet	劫
sgye	酿
ctdu	矣
ucgd	闯
jigq	晃
mhkw	帜
rkeg	捐
tdtv	矮
itmd	澳
tonu	愁
pwav	窃
oawy	烘
jvkg	昭
dfiu	奈
ijtl	滥
aak	戒
nhfd	丑
awfi	蔡
oaop	遮
egmh	肺
kptk	喀
eyuy	膀
dfnb	夸
qnql	馏
whwy	俱
iwgu	澄
pwrm	窑
tpge	稼
why	仆
fpog	壶
aldy	蔑
puol	裤
isjg	渣
ugvf	姜
vthn	媳
drrr	爽
mbyu	岌
xrmh	绵
xwxn	纶
qnaq	饶
jcuf	竖
sdsk	椅
rdwg	捧
kkf	吕
xnhf	纽
rcah	拚
rvnc	殷
enun	鼠
rtfj	卑
idtf	涛
debh	郁
ifh	汁
uji	闽
ojfh	焊
ftbf	孝
cadm	颈
adxy	茂
elgw	舆
kqmd	唤
ewn	肌
fhg	址
rqrm	掏
wufj	伞
akfr	鞭
xgef	缚
ripr	撑
sag	杠
hndn	鼎
ykhp	谴
itsy	涤
yqjg	询
kieg	哨
jmhh	帅
ptab	宅
fadn	堪
fnhy	韧
rudg	拦
hnan	眠
onjh	麟
drtf	碑
xojf	缠
awnb	巷
fhwe	趁
tmdy	秧
qtge	猜
qwu	欠
ffcy	坛
acaf	茎
jsg	晒
syuy	榜
ogmw	炳
rwwf	挫
khrw	跌
ogmj	糟
srrr	攀
sgxj	酯
nvcq	慨
rwyb	携
kkfb	鄂
rnwv	氛
fshf	霜
sjxx	棍
qtfg	锤
ihkg	沾
wffy	侍
gygg	斑
cnhe	豫
ljxx	辊
meef	崩
aigf	萍
wfdj	儒
apwk	蓉
ynwe	谬
nwyg	惟
ijy	浊
kitt	吵
rcns	揉
yoju	蛮
heph	瞬
cyi	叉
xjtq	缆
adhb	荐
kary	哎
ivcq	溉
nukq	悦
sgnn	朽
mulj	赠
vtkb	郡
khpi	踪
iann	泄
utui	疼
ukjh	剖
aguf	苹
qufh	锌
bbh	耶
vnn	妃
mpd	迪
uxxb	孳
hqvh	睁
yntw	亥
umia	弊
ark	匠
smgk	桐
vuvo	嫌
rgmj	岳
fjfn	乾
sgwv	酚
pwu	穴
vpge	嫁
oftn	烤
gwyc	玲
rqym	捣
gehy	甫
vkbh	邵
isjf	潭
ajdn	慕
oitt	炒
iytf	浒
ldtf	畴
ahdd	匪
radr	撕
kyke	嚷
iuwl	溢
xdmy	顷
bukn	聪
wcnf	翁
itdy	沃
yuvo	谦
jsrh	晰
qld	甸
hfcy	歧
ywet	诊
pybh	祁
uqwk	咨
itol	潘
ysjf	谭
dwyo	礁
xngn	弓
nftj	屠
sgtx	酶
sary	枢
kwyn	吟
kwnd	喉
iwwk	浴
xtdm	颖
ughd	症
pufy	衬
ikhm	溃
mdff	崖
qkqe	勉
hjfj	卓
gyki	琼
rwpi	迭
mmvf	婴
iynt	沪
rnxj	氟
xywr	绞
rngb	挪
udgi	辣
wxb	仑
odxy	庞
ythp	诞
kgfh	吁
sgaj	醋
igey	浦
afwt	菱
bhg	耻
webg	俘
yerm	谣
tjtl	篮
oyvb	廊
nhwy	惧
khuf	蹲
hwvt	盼
mjqr	赐
ratq	挠
bfhy	陡
sjsy	棵
fcnd	翅
mcwt	峻
wdjn	俺
dgkf	厨
ugng	翔
ynky	赢
jmhn	愚
rdg	拓
akgn	惑
xmfk	绸
skf	杏
kldy	咽
rwvt	扮
aigy	蒲
xtbt	绣
kctd	唉
syck	梳
qkqp	逸
aqou	菊
aru	艾
qutt	铲
ykpe	膏
ugnf	羞
ajqn	葛
cgtj	骄
nhjf	悼
oveh	庸
ayuh	蒂
pufj	宰
ijqn	渴
dcvg	肆
ossc	魔
spwf	榨
aoao	蔗
tfh	秆
eeqg	鹏
ofg	灶
efwy	肤
nwyc	怜
rwyn	捻
wcwt	俊
nyrb	恼
igkh	滞
hnmg	凹
wdsk	倚
wfiu	祭
agqa	葬
rdxy	拢
uxxn	慈
damh	砸
tigs	衍
kccs	嗓
ogub	凿
dfek	唇
nii	尿
puet	衫
tqgs	衔
rket	拐
ertf	脾
qndg	锯
wgqt	傲
alqu	萝
qtaj	猎
gxwi	夷
hmu	贞
jfcu	昙
pwfj	罕
ddht	厦
nwgj	愉
rbt	扔
ahtb	邪
fyt	坊
vafs	媒
iwef	脊
axjl	蕴
kdet	呖
aynb	芒
inro	烫
venu	恳
kffg	哇
jpxn	蛇
yvkg	诏
nyjg	昼
qqkg	铭
qugd	镁
mhrg	帕
mri	冈
eugh	胖
qnjh	刨
sty	枚
pjmy	寓
abef	荫
dfei	辰
mrcy	贩
vntn	娓
qtal	猫
tmf	笛
hsh	盯
qtbt	锈
smu	贾
aeui	藤
sdhd	楔
ykhe	衷
wglg	僵
lrh	斩
ynma	扁
ywgj	谕
ihgc	淑
dshd	厢
env	甩
gdju	蚕
wyrc	禽
qryi	匆
rjfg	捏
hpdk	瞎
nnu	忌
bbf	孕
agaj	荆
wwgg	俭
efh	肝
qqwy	钦
xdmd	缅
othn	熄
nied	屑
pujs	裸
aqrn	葱
cccf	垒
qmg	铀
iqrm	淘
ryxf	摔
jftj	暑
kykb	哼
kmet	勋
ntxy	悔
qitt	钞
fdfn	垮
vpjh	婶
knty	嘱
onjx	鹿
epvg	胺
rlsy	捆
yyki	谅
teec	艘
scwt	梭
tjsu	梨
usgd	奠
gcgg	玛
smmg	栅
pwmh	帘
kgog	哑
rab	皂
ktry	哦
opfq	烷
kgkj	喇
awnu	恭
rag	扛
askf	苛
tguf	秤
novd	屡
boy	耿
kmdj	喘
nrqc	愧
rhyi	爪
kwy	叭
bipi	逊
ythf	诈
wowf	俯
sbde	椭
rgef	搏
yakg	谨
rygg	拄
ocag	烃
kqrt	吻
xdtb	绑
cgcj	骚
rsjh	刹
gqto	熬
edhg	胚
iwyf	雀
gbnv	屯
rwgg	拴
rawy	拱
terg	舶
yjse	裹
tdu	矢
pdev	寡
saiy	栋
tlon	粤
dmaw	碘
ssg	栖
uqsg	酱
eyt	肪
alfj	薯
gkhe	囊
xjk	弗
njqr	惕
tetp	艇
ekhh	肿
infh	汛
ivwo	粱
imkt	敞
uxlw	冀
ynna	氓
pntj	蜜
lgkl	辐
qqcy	钩
kwxf	哗
oykb	廓
mfxy	贱
bmgn	聘
eler	舅
ieeg	滔
nvt	忉
oywn	炕
hwgu	瞪
qtjh	狮
kynw	咳
khdd	啡
adef	葫
kwgj	喻
smmv	樱
qjnb	龟
qblg	锰
rylg	擅
omh	灿
yayk	谎
fqwy	坎
hlru	卤
pujn	褐
aitl	藩
tfno	毯
dxyi	戊
ulk	闸
itoh	渊
nkuy	譬
etkg	胳
ydmj	斋
sieg	梢
mlrj	崭
rwy	扒
ugvv	凄
fguf	坪
iyni	泳
wvnu	忿
pahh	宦
gmiu	枣
qtyr	狡
owwg	鹰
tsgf	笨
uugk	痒
wyuy	傍
ykbo	烹
ndmh	怖
qrbk	匈
fjng	塌
kekg	咖
adya	莽
nfif	尉
qgbn	钝
oawu	粪
tnpv	迄
fyy	坟
lef	胃
fobh	郝
pnwe	寥
klfo	嘿
qkqy	兔
jag	虹
ijfg	涅
ruah	拼
tvtr	笋
qyke	镶
mafw	嵌
tgvi	秉
rcde	掺
geht	敷
oynn	煽
rnge	氰
wudb	倦
bqtb	聊
khes	踩
pfqc	寇
kxqy	哟
ougo	糕
teer	筋
vyi	刃
udxf	辫
khqb	跪
tgjn	穗
rdbn	扼
oyne	庐
sgjr	梗
mgng	屿
haee	虏
idet	沥
ndgn	憾
gqtf	歼
ojy	烛
yceh	诵
orgg	煌
tomg	釉
spqn	枕
vgxw	姨
nkuv	劈
qyty	卵
utee	彦
dfny	砖
sgag	醛
sgg	枉
efcy	肢
khyh	蹄
rqnq	兜
auqw	茨
mtpy	贬
qjh	钊
wehh	佣
ivg	汝
irde	淆
ajf	昔
ywry	讽
wtxy	侮
tmfk	稠
nlaw	翼
shgc	椒
qafg	钳
kthf	咋
wtlt	傻
uldd	痼
oqwy	炊
odjn	庵
mhwy	帆
rrqc	魄
ktkg	咯
bpqn	耽
mdeg	贿
qgoh	鳞
vyi	丸
vahh	姬
jghx	匙
eilf	盥
mfcy	岐
wbb	仓
fjfn	翰
kawy	哄
jot	旷
elvf	爵
qtwd	猴
fhik	趟
grqc	瑰
yqdb	诡
khjr	踢
idjn	淹
igmh	沛
jplj	晕
rjtq	揽
sofg	桩
ibib	涵
wulj	僧
pwyg	鹤
puvk	裙
lugh	畔
dmjv	耍
oqyy	灼
ifhw	滇
iwxn	沦
idyy	汰
gudm	颊
eswi	膝
ngkm	懒
ukqb	兑
dicn	耙
khee	蹈
kbnn	吼
awyo	蕉
kmak	嗣
ghgo	焉
oqmd	焕
irbh	汹
ingf	渥
dufj	辜
ukkm	癌
atvf	萎
qqug	钧
bdjg	陌
qvto	煞
ssou	焚
wdkg	佑
kfje	嘲
bccu	聂
uvow	歉
cgtk	骆
nxxv	屁
sfkg	桔
nrgg	惶
tgks	衙
eafy	腻
pdxy	宠
fxyl	盏
puqn	袍
akff	鞲
rjfh	捍
qege	锄
adkn	惹
eipf	膛
qnkm	馈
jgcf	蛭
egef	膊
pwkh	窜
vtdj	娇
tnb	乞
kelf	嚼
kflb	鄙
qtjj	猖
xevg	绥
bkcg	亟
rcnh	抒
tagf	筐
iug	泣
ttdp	篷
rxjh	拂
mofg	赃
qpvg	铵
qoac	镀
qqyy	钓
udhf	眷
uxxu	兹
tmdr	躯
tkmy	禹
kdg	咕
ranw	拣
muvo	赚
udrf	瓣
khks	躁
wwbf	耸
kkwb	咒
tulj	箪
ovwi	庚
kfkk	嘻
xovg	缕
twyg	稚
otfp	糙
rfpy	挝
rrcy	扳
bqnn	孢
sgqy	酌
bdae	隋
kdpy	哒
fpbe	勃
ejtg	腥
obg	籽
atgq	尧
ajdj	暮
ykke	襄
qyi	勺
thff	乍
imfy	溅
ithy	溴
gssy	琳
iugi	澜
eqyy	豹
kvcb	唧
aqkf	苟
rxy	拇
ksh	叮
kwfy	咐
bxxf	陛
ijai	瀑
tfj	竿
rpsh	拧
gmmg	珊
rpfq	皖
ujqu	韵
gimy	琐
buwl	隘
ugeg	靖
gabh	邢
gty	玫
rumt	撇
wnkf	僻
ausr	薪
kkks	噪
xxgx	毙
aekf	茄
lqju	蜀
uejo	煎
spfi	棕
dwwy	雁
ujfe	彰
gkup	逗
vkxi	絮
iywu	淤
mwyf	崔
aeee	荔
tdtj	矫
mftj	赌
pgjg	宣
qvbh	邹
qntk	饷
pufh	褂
set	杉
kpgg	喧
ujfm	赣
tmdx	躬
utdk	痴
rjbc	撮
nqeg	懈
wgkw	凳
ivkg	沼
sqdy	檐
hhwy	瞿
ywwf	卒
rnnw	撰
hftj	睹
nulj	憎
gujf	璋
ujvk	韶
ajde	募
swgg	栓
wgep	逾
rqcf	魁
mwru	岚
kfmf	喃
kfcy	吱
qgqn	鲍
pugs	袜
tytd	簇
gadw	琪
rqcc	魑
afii	蒜
utnv	疙
pgmw	寅
tttt	禾
akfp	鞑
wlg	佃
rtoy	揪
kldn	嗯
xoxn	粥
rdef	肴
ipgg	泻
vjsu	巢
pqbb	宛
pusi	襟
atjj	莉
akfv	鞍
ipke	裳
yodu	奕
mfnd	赎
qgoh	鳙
plbh	郓
fyu	雯
dwjj	蠢
mtvc	巍
wgcf	侄
sgmk	酮
aiu	汞
rgud	挟
kcwt	唆
oaoi	庶
htoy	瞅
dwgg	硷
hagw	瞒
hoy	眯
sqyl	榴
dftj	奢
wvmj	岔
khag	嘘
srqc	槐
bwff	坠
ggnt	瑟
fqnb	雹
xkbg	缉
haag	虐
novi	慷
iujg	涧
bigf	丞
bgmn	陋
okwy	炽
otni	烁
kkdk	嚣
awnf	薛
kcb	邑
pawy	謇
qouo	镰
tglo	熏
qeg	钥
ssox	麓
ietf	淫
vjsj	剿
jgkg	晤
cgkh	驯
wrrj	斧
ldsk	畸
vnhg	媚
jqrj	剔
qtkg	铬
uguw	羡
eriy	腺
pief	宵
jukq	蜕
vtnt	姊
ttgf	笙
fykt	墩
cgyn	驴
ksjg	喳
anff	蔚
uffd	闺
pwfq	窥
otkg	烙
idff	涯
ktmd	噢
jyy	蚊
lfon	黔
swgu	橙
gqi	歹
igmy	渍
rqci	魅
dviy	碌
hfwf	睦
lwi	囚
iube	溯
pwgf	窒
ssu	栗
afqb	芜
dbv	厄
rutk	搁
medp	髓
oovi	糠
wfcy	伎
qlqy	锣
spvg	桉
sfmf	楠
cgli	骡
khlj	躅
qyuy	镑
pajd	寞
epqb	腕
qtoy	狄
pyaw	祺
kthy	嗅
xgoa	彝
vtry	娥
wgej	俞
ish	汀
ndae	惰
wcu	殳
apou	荧
dyi	犬
foty	赦
kdha	嘎
cgct	骏
sgty	酥
sphn	棺
ivyh	涩
ykby	孰
jkjn	蝇
bdef	堕
ltdj	轿
intt	泌
bty	孜
jfiy	昧
gfpk	迂
vtdy	妖
tfg	牡
xccc	缀
oxxv	庇
yxty	雍
tfxy	笺
uvg	妆
sng	栩
dxyb	聋
iuxt	涕
jans	蝶
tdnj	稽
yfhy	斌
dijy	耦
nfcy	怯
kyni	咏
damw	磺
ylki	禀
swry	枫
wngk	伺
wrfu	釜
slyt	楞
annn	蕊
htpy	眨
fxyi	戋
kegg	咀
wgit	敛
mhhk	帖
kmwy	呐
bcvf	娶
sgtq	酰
qnbg	饵
kftj	嗜
yopy	谜
twb	秃
rvyr	挚
qldg	锢
kgpd	逞
rhhc	攫
sxxr	楷
vjd	旭
snhg	楣
aiks	藻
awns	蘖
vkgd	娱
sgfc	酝
ntji	虱
aldu	茵
pdhk	豁
khdy	跋
fjhh	坤
xkeg	绢
rgtr	乒
ruga	搓
yaht	讶
xeeg	绷
qnhf	钮
bpxn	陀
jtga	戥
pwtk	窖
ileg	渭
hqdy	瞻
tff	竺
symh	柿
fkuo	熹
yjqn	谒
sdtb	梆
egey	脯
mdsk	崎
qnyr	饺
ktfg	唾
fhnh	赳
lfh	轩
fwnf	埠
kqng	呜
uhk	丫
xvyy	纫
ihan	滤
fkxy	哉
gmii	棘
jtmk	晌
dndy	臧
xwdc	缎
hxwy	雌
yskg	诃
jghy	虾
ypta	诧
akfc	靶
mieg	峭
ipks	棠
nwya	戳
wnnf	阜
tlug	衅
ddmy	硕
sdyy	杖
mykk	嵩
aiit	莎
dfff	奎
pyhm	祯
fssu	霖
qynx	鸵
fief	霄
kvij	啸
rntu	氡
rnyw	氦
tlqu	箩
ggey	琢
kgkg	唔
egeg	腈
putd	袄
kywn	吭
puvc	寝
yxiu	紊
tigf	簿
wrgd	凰
bfqn	阮
nlyt	愣
qtme	猾
akfo	鞠
mmgj	删
qwxf	铧
nanv	屉
dfcl	磕
puvp	褪
kgqj	咧
qgdy	鱿
dnae	碾
ifnd	渎
gqck	殆
iimk	淌
iyrc	漓
nmgk	恫
rovk	搪
kyuh	啼
ade	戎
cgpx	驼
gakg	瑾
iwbn	沧
wrqc	傀
dyuy	磅
ynwy	诀
gyve	琅
atgn	翘
iadn	湛
ynmn	翩
qtry	狐
wgud	侠
frgk	垢
rguf	抨
vnhe	婿
kgey	哺
tvpd	逶
yfnh	讳
tnnw	筷
uyi	闵
yyuy	谤
wkkg	侣
udvr	券
mhuf	幢
gqmd	殃
awyc	苓
iyct	澈
gkub	豌
kajn	噶
gdsk	琦
iffg	洼
iwgk	洽
iny	沁
rgyu	乓
ubte	朔
xqjg	绚
vyks	婷
ugca	羟
myet	彤
iugh	泮
deeg	硼
kxy	吆
nghg	怔
wlll	儡
abf	茸
aju	茧
sbbh	椰
aqty	莸
tfux	乖
pwan	窍
swxf	桦
tcgf	笃
kary	呕
hqiy	眺
swgj	榆
giye	裘
irh	沂
yriy	诛
yykb	谆
ucwy	瘫
emqb	觅
epqh	舜
khty	踽
lhng	皿
djnb	奄
mary	岖
gqtg	鳌
vfcy	妓
aube	蒴
atmt	薇
omkg	炯
vte	尹
sujf	樟
ihit	渺
puwy	袱
ucwt	竣
rgbh	邱
nhef	胥
sou	粟
qths	镍
kgkw	嗽
uwci	疫
jmhy	禺
tdtn	憩
trxg	鹅
kheg	啃
hagg	眶
iape	涝
qmy	钡
rohk	掂
ikks	澡
uqed	阎
awgd	葵
goga	戬
cgyw	骇
inbb	潺
irg	泊
qgwf	鲋
xdsk	绮
wqqy	侈
ykbj	亨
thdd	徘
kbh	叩
tbpv	迤
sjtl	槛
pyrh	祈
asgo	蘸
qtjg	猩
wroo	飚
irdf	湃
imdj	湍
aghg	廿
efpb	脖
vpqb	婉
akfx	靴
kwn	叽
twdm	颓
gcft	臻
kitx	嗨
dgxy	戌
agfj	芋
uqwn	恣
sset	彬
sdwj	椿
xhjf	绰
jyki	晾
yuwl	谥
ugty	羲
qtgp	逛
vnxn	妮
kadr	嘶
dsg	硒
cgcg	驿
fwsy	垛
nlrh	惭
rgkg	捂
qdwy	詹
pudf	褥
hpgf	壑
qehj	蟹
qnjc	馒
aflf	蕾
ajlc	蔓
abiu	荪
elny	腮
khhg	趾
iyos	滦
kawk	嗬
ulgj	痹
dmfk	碉
arj	芹
nffy	恃
tmqy	秽
srrd	樊
arwc	殴
hxyf	訾
snn	札
yegg	诅
ebf	孚
jdeg	蝴
aadk	匿
jsu	杲
sekg	枷
dubw	厥
kwgu	噔
nigq	恍
onwe	廖
krtf	啤
naj	羿
iwvt	汾
rdgn	撼
mhwy	帷
wywr	佼
dmjk	厕
awwi	巫
dans	碟
edxy	胧
jlfj	曙
lonx	辘
adwf	斟
rmdj	揣
khoc	踱
yhdd	诽
otdh	烽
vkeg	娟
rhkg	拈
mfd	冉
pynn	祀
pynk	祠
qtmy	狈
khme	蹦
ihhm	濒
dhkg	砧
mffy	峙
ygli	谏
vknu	恕
aqbb	苑
tbyu	笈
umfk	凋
llge	圜
tqvh	筝
tdi	夭
lbnn	辄
qnfy	饯
rxxr	揩
tyrc	篱
vutd	嫉
fyke	壕
gdeg	瑚
ryke	攘
aqwu	芡
dnjl	尴
onrg	熠
iykb	淳
utjk	痢
ktuy	咚
ilg	泗
spwk	榕
rtfn	撬
sylg	檀
afnh	苇
pjyw	冥
vfkk	嬉
ossd	靡
rwyc	擒
aqnb	苞
jcgg	蚂
sfgy	甄
pwnm	窟
jriy	蛛
vuxt	娣
uawk	瘩
cgdy	驮
gyck	琉
jnhc	暇
sdgf	橱
aukf	菩
kgmj	嘈
pyul	禅
dhvn	恝
qgjf	鲤
kjhh	呻
dxyw	龚
dqdq	兢
mhjq	幌
ctgj	牟
alk	匣
sgbn	酏
faj	卉
apgg	萱
uyli	凛
npqn	忱
rftn	拷
rbig	拯
kxxf	哔
njfh	悍
xdd	毋
dhdf	砉
qwwf	锉
pjdh	幂
hakd	虞
mlnu	崽
dtni	砾
fgjg	垣
vusy	娴
gamd	瑛
rtfg	捶
jcef	肾
gqpw	殡
lakg	羁
jwgk	蛤
qtdw	獗
ibyy	汲
fvey	垠
uapk	迸
xugh	绊
qsgg	钵
dydr	飙
rovg	搂
jqkq	冕
jfdj	蠕
efy	肘
rbmh	拙
rieg	捎
qnnk	饲
qqng	钨
xpgh	绽
akgq	觐
mtkg	赂
jyry	蚁
edcy	肱
kwcn	嗡
sfxy	栈
nkhh	忡
yemk	裔
mkpd	迥
eape	朦
icwt	浚
yntg	肇
agvv	萋
dnwj	尬
dcef	髯
xcy	弘
nwea	戮
imh	汕
wnbm	倔
raay	拭
keqg	鹃
ssvf	婪
fhag	墟
kfpi	嗦
kyud	嘀
cguw	骥
kwvt	吩
tadc	簸
adij	藉
iujf	潼
eugk	膳
yute	谚
eet	肋
uubw	阙
iyy	汶
khnd	踞
fbyy	圾
ywn	讥
aihc	菠
uwbv	疮
tadw	箕
noi	屎
nkuy	璧
fuvf	霎
jtxy	晦
ahkm	颐
nbcc	慑
edyy	肽
ung	翊
fajv	堰
jffg	蛙
jaht	蚜
vngb	娜
onwy	炔
fug	垃
qhg	钼
ngd	刁
wgkg	鸽
sgkg	梧
gqqj	殉
umin	憋
vrtf	婢
vynt	妒
pwvk	窘
icag	泾
iqtk	漪
tthp	筵
rqku	搀
dwyy	矾
safg	柑
rdui	撩
ynte	劾
vgho	嫣
koy	咪
dtfo	焘
tdwy	雉
jqwp	遏
afuk	蔷
eldy	胭
oang	炬
org	粕
ayi	弋
gyth	璇
hndm	颅
hxqh	觜
duga	磋
qnqe	馅
khdf	踌
ifke	澎
jceh	蛹
wpgg	伫
exdu	奚
mwyn	岑
xdui	缭
yajd	谟
dceq	髡
wrg	伯
halg	瞄
qdyy	钛
bdxy	陇
lskg	轲
ugct	羧
ucv	疤
ackf	苔
kftb	嘟
qywr	铰
hmng	卣
njtg	惺
ymwy	讷
lnae	辗
agsu	茉
term	徭
uvf	妾
buep	隧
yoaj	弈
npqb	惋
awgf	荃
punr	褶
jpqb	蜿
uqmd	痪
kftb	哮
kdbn	呃
nckg	怡
rfhp	遁
ntbg	悸
wctd	俟
qjfg	锂
jskg	蚵
pydf	祷
acb	芭
nitg	犀
ntlg	恤
idhh	沣
pwfd	窦
tamf	篝
fgjr	埂
mfhm	巅
ayjn	蔼
lkwy	轵
qdg	钴
vpmh	帚
atol	蕃
qehf	斛
difc	耘
vosc	嬷
tgle	甥
afpb	荸
usgf	酋
kvt	叨
qtfe	猿
fnwj	馨
qftn	铐
germ	瑶
pygd	祆
quxt	锑
jkmw	蜗
cajh	刭
awks	葆
xdjx	弼
xprw	缤
uiwe	瘠
jxe	曳
mtnn	屹
dyxy	戍
abmj	茁
txyk	毓
spgg	楦
qdhd	锲
yans	谍
odui	燎
rceh	捅
aaff	苷
alkf	茴
jywr	蛟
eujn	臆
xtn	匕
tlkg	徊
lxxn	毗
iadw	淇
sryt	檄
scnn	懋
aqjf	荀
kqgj	噜
sufh	梓
rvym	贽
xgej	蠡
igkw	漱
ekpd	迦
ntmd	懊
nkkn	愕
rmhj	帛
kdxy	咙
iwgj	渝
gkk	卅
krrg	啪
qou	炙
tlff	睾
yqay	诋
shmy	桢
mckg	贻
puue	褙
qgyt	鲂
dyuh	碲
avdf	菇
wieg	俏
ugd	闰
aywf	萃
kepc	嗳
vyud	嫡
thlj	劓
wrtf	俾
abib	菡
nmdj	惴
hagp	遽
qalg	锚
wekg	伽
fxet	坳
ipgg	渲
qivg	铛
lgbn	囤
ildg	涸
iavj	潇
jplh	晖
kdyy	吠
apgy	莹
ijym	灏
rwgg	捡
dddf	磊
osso	糜
rccc	掇
aqkr	擎
fjfa	戟
lfoj	黯
kqqy	哆
sgop	醚
trah	箍
kawk	嗒
nkcn	悒
qtoy	锹
pujg	袒
khch	踊
kgmy	啧
dfcy	砝
kwbn	呛
khaj	躇
kcqn	吮
hyxy	眩
sape	檬
qtfq	铣
aqkf	茗
eowf	腑
xfwt	绫
ywke	褒
xxal	畿
weqn	倪
qqvh	铮
dqy	矽
khye	踉
twau	筏
uxhj	剃
frcy	坂
rrju	蜇
dcen	髦
xcgh	绎
bjmy	隅
rtfm	攒
dheh	甭
awnb	孽
jthp	蜒
qtpf	狩
hayi	虔
kdui	嘹
lvlg	辎
qtbh	卯
pytf	祚
nwyf	翟
umih	瞥
afcu	芸
isy	沐
twiu	黍
gqtm	赘
amhk	匝
rmnn	皑
uthx	瘪
nbtn	憨
kqnn	咆
cgcy	驭
aykk	蒿
jlgy	蝈
wfcj	刽
meyw	骸
kape	唠
lfod	黩
eef	舀
lfoe	黝
ujld	瘟
gvtr	瑙
khgh	咔
dcew	鬓
fjff	斡
yxjg	诣
cknu	怠
rfwl	撵
iouo	濂
vnhf	妞
hpqn	眈
agd	匡
khwb	啮
ipsh	泞
xtdg	肄
qang	钜
qujg	锏
wfg	仕
awgs	荼
swfc	桧
fhfh	矗
khaw	唬
wwyc	伶
apju	萤
waf	仝
nfdj	懦
ntay	怅
dolf	盔
afwu	芙
tdqa	舐
khcs	蹂
nohk	惦
ayna	匾
fnkf	霹
eywy	腋
btfh	阡
sfiy	瓢
ugod	羹
rqeg	掐
wugh	佯
khlf	盅
nfce	恸
metk	骼
mdlf	盎
tfd	壬
wdfn	侉
kogw	噗
qtle	猥
awjj	芥
mhhm	帧
fwwm	赍
ixuu	溺
dguf	砰
ydoy	诙
iepd	逍
tuf	笠
sgd	酉
ifqn	沅
sjtq	榄
argy	瓯
dcek	髫
ugli	阑
snbt	橄
owyk	焓
aosd	蘑
spsh	柠
odg	炻
qrg	铂
iswc	淞
ifjn	瀚
rngg	氩
qehq	觥
epey	脓
xugk	缮
tdgn	舔
udjn	阉
rjxt	拽
nujf	憧
qghg	钲
eywn	肮
ntdg	恬
jajd	蟆
uhxv	疵
tovf	篓
iugi	漾
thdi	纂
tgef	箐
khws	跺
hdhe	裴
rdpy	挞
njyi	憬
ywb	亢
fpgn	懿
watq	侥
ktaw	噬
mmgk	峒
qntf	饪
agud	荚
adiy	藕
hdhg	韭
qdui	镣
cehn	恿
gqv	兀
kujn	噫
nmnn	恺
plge	寰
xxxx	幺
ftfp	霆
dsjg	碴
aerq	藐
sgaf	酣
spwy	榷
caj	弁
hdhn	翡
sqdb	桅
rudb	掷
yckg	诒
gogw	璞
uywu	瘀
rflg	擂
pwbg	窿
qgln	鳃
rywy	掖
mnmq	觊
tirf	箔
hgvh	睫
pwb	冗
mnbm	崛
nfio	熨
hesy	睬
qykk	镐
lrff	堑
gjgf	亘
ffhy	卦
khub	踯
wftx	佬
rltk	撂
kcep	嗵
anmu	贳
opgg	煊
qcgh	铎
udhk	痞
sgrb	酗
tlwt	稷
cehj	甬
rdfi	捺
kbmh	咄
iyth	漩
jpvf	晏
rnkj	氚
uqyl	瘤
dmqn	砚
fofj	赭
ajqg	鹊
brcy	阪
xtah	绛
ytxy	诲
qgey	匍
kovg	喽
dxjh	砩
twgu	簦
eyxy	臃
wfiu	佘
yplh	诨
opfi	粽
aqgj	蓟
gmyb	郦
ionx	漉
scnk	橘
oqab	粼
tlnu	惫
ivlg	淄
gwgj	瑜
thkf	咎
rcyj	搔
xbn	弛
iqmd	涣
uooi	痰
iyjh	浏
igef	溥
xfqg	鸨
sgfh	酐
ebbh	郛
ykbf	塾
khtf	踵
qtps	狞
bhcy	陂
apwj	蓿
onjf	麝
hnty	瞩
dhgb	邳
isrh	淅
cgwf	驸
jdny	晟
bwyc	聆
nuyy	悯
wfam	偾
rfkg	拮
uqgg	癣
jwyp	暹
ecag	胫
syvb	榔
sgtk	酪
wtjh	俐
xfcy	纭
ldbn	轭
ftxn	耄
igmj	漕
qkkn	锷
qgsi	鳔
tcb	笆
qtjf	狸
jfcf	墅
nngn	巳
kyg	唁
ajdg	蓦
autd	蒺
arqq	蔸
qnte	饬
vcag	暨
uywf	瘁
qyou	灸
xmmv	缨
oojh	剡
scyy	杈
swyg	椎
qvf	刍
mtux	嵊
thhs	衢
qlqj	镯
fqng	坞
xuwl	缢
rnjj	氘
ogbn	炖
fskg	坷
vftx	姥
ajdr	摹
feqb	霓
rwxn	抡
ytdk	旖
ddgq	砺
wycn	翎
onjw	麂
ltni	轹
khbc	蹑
apxi	萦
qnad	馍
xglg	缰
vqyg	鸠
jada	蟒
ofdj	糯
khwy	趴
mwwk	峪
qtle	猬
ovf	娄
atfj	芊
snn	杞
ouep	燧
fhdd	霏
jdhh	蚌
ywxn	讹
wwnu	怂
utht	夔
qmdu	奂
trgg	徨
uywu	阏
dhdv	彗
ftxj	耆
jugy	曦
vkpd	迢
wgod	俨
nmun	惘
vmmg	姗
mtry	峨
rdfj	皋
dcei	鬃
yyuh	谛
yooc	燮
pnhi	寐
iphn	涫
sabh	栉
akfg	靼
kngg	叼
tykk	篙
jrgg	蝗
rhae	掳
agef	菁
sjng	榻
eudi	滕
rywr	皎
jxhh	蚓
julh	蝉
rdfn	挎
eyjh	脐
wxxr	偕
wgnb	兮
scn	杷
qyne	袅
lfom	黜
lfoi	黥
ubqn	瘾
ayke	蓑
dadr	厮
ayhu	苄
rxet	拗
rtdj	挢
kgjr	哽
kdhy	嘁
qtqn	狍
qnfb	饽
ynij	昶
qpge	镓
idg	沽
cgqk	驹
ixwy	潍
refy	捋
kfoy	哧
ipfi	淙
sxxn	枇
iagn	懑
akfr	靳
lvd	囡
hdhj	蜚
hsfi	瞟
kfpu	噎
owxf	烨
sjfj	覃
jwcy	蚣
qglp	鲢
ufqb	羌
avkf	茹
mqdy	赡
qrqw	锨
ymh	讪
sqkg	枸
etkg	貉
lyct	辙
kxxg	咝
fmyg	坍
ynkc	扈
oukg	焙
jtry	蛾
qgyi	鲸
wphn	倌
tsyy	秫
ugkm	癞
qwyy	钒
qnev	馁
wcgy	瓮
rfjf	擀
hfcl	瞌
tckf	笞
tepx	舵
kgxw	咦
der	夯
waqt	儆
ntfc	屐
tfnd	犊
ggcb	琶
srgb	栀
tvij	箫
qehr	觞
cgmn	骋
rovt	擞
oyxy	炫
nulh	惮
ilpy	涟
yomj	峦
tewd	磐
emaw	腆
wdwg	俸
issy	溧
arqg	鸥
whty	攸
ngki	悚
fnhe	韬
ywuy	於
putf	衽
pufj	褚
qgvb	鲫
ggxx	琵
djhh	砷
yrve	亵
nguf	怦
inhg	湄
qqtb	铆
qbcc	镊
apqg	莺
rdwd	揍
owwe	膺
pwup	邃
tfqu	筠
fder	雳
ssbh	郴
ynky	嬴
rdmy	颀
nhfp	遐
qgjf	鲥
thlf	鼾
rnbr	氖
rkbg	揖
tolb	鄱
atxi	蘩
xnwe	缪
judb	蜷
geph	靛
jyna	蝙
eftt	豺
sgjg	桓
nqrn	惚
nfuf	悻
vjjg	娼
ibws	滁
ithp	涎
kpsh	咛
kimy	唢
vegc	媛
tjtt	馥
dvcq	厩
wrwy	佚
ftnn	圪
uejn	翦
wgeg	倩
ugqj	冽
kbhj	嗤
gkit	敕
thgd	牍
tdnm	嵇
uynw	阂
qflg	镭
apiu	荥
nykw	咫
xvyy	纨
rwvr	掰
ipxn	沱
sukk	榈
sprw	槟
rnan	抿
qftj	锗
wkkn	侃
kmy	呗
jkgd	蜈
uqyi	疚
rary	抠
aqyu	芍
jtdk	蜘
dwwm	赝
pyqy	祗
pyfk	禧
rtfk	皓
sgmu	醴
akfd	鞅
wayo	黛
qahs	桀
qtfh	钎
igoy	涞
iitv	娑
esfi	膘
jlf	蛊
rnua	摒
nnhf	忸
xfy	纣
tldy	篾
qnqu	馋
uwgd	痊
kuga	嗟
ikeg	涓
rkcn	挹
qyns	枭
tlgj	箅
ykf	吝
jjqn	蝎
ajvb	郾
iwyc	泠
vcbf	孥
ooou	焱
qwgg	铨
faet	霰
enuv	鼹
lgey	圃
sgdy	酞
tfnk	毡
ajfu	莳
ghqo	璨
olge	煨
yqku	谗
tfkg	秸
vtlx	媲
egdc	爰
evkg	貂
rqoy	掬
vulh	婵
lhnt	轳
wpxn	佗
kgty	唛
iyny	瀛
gfnh	玮
sgcf	桎
umit	敝
oewi	庾
gpws	琛
gmwy	璀
swyo	樵
wsjh	剁
onyu	烬
gkkk	噩
ytvg	诿
obh	邝
nfy	忖
ugd	闩
stfh	杵
xkjg	犟
dtkg	硌
hpjw	瞑
quoj	镨
khay	躏
iftj	渚
daif	礴
kmmv	嘤
igbn	沌
ekks	臊
qnn	钇
qjcf	铿
udge	豢
rthi	攥
kleg	喟
gskg	珂
qriy	铢
jrgg	蚯
gqfw	麸
ulbh	郸
xhdd	绯
rndq	氪
jtfn	蚝
axtr	芗
agjn	蕙
hxmu	赀
yary	讴
imau	澧
ijf	沓
hctg	眸
qsfi	镖
unkf	癖
wdwi	傣
idui	潦
aywr	茭
kamh	咂
mdfe	赈
bfdj	孺
wvyy	仞
ytfk	诰
ahf	芷
auwy	蔺
xbmh	绌
pyhg	祉
iegg	沮
ykky	瓤
tqjg	徇
xqvg	绉
jygg	蛀
kujg	喑
waym	岱
nfqn	怃
uagd	疟
fgfh	圩
kfhw	嗔
ngxi	愫
irdh	浠
jnxn	昵
ytee	膂
ynhd	扉
ermi	繇
atlx	蓖
nuf	翌
afqb	芫
atqi	藜
kgqt	嗷
jqiu	晁
sthf	柞
qayb	邸
eeen	勰
qtwk	猞
ihnt	泸
umih	蹩
gqul	殚
iujf	漳
ykpa	亳
ifcl	溘
pund	裾
ywce	衮
vamf	媾
eniy	脲
lty	畋
dhgh	蹙
ryxl	搐
utfq	冼
owdc	煅
ikmw	涡
itoy	湫
qqcn	铯
ihjf	淖
rxge	掾
ukkd	闾
mef	胄
khdw	蹶
ugou	羔
gudb	郏
mrqc	嵬
qtyf	猝
stmf	榭
ujgd	疸
utec	瘢
bmou	粜
rulh	掸
rwyc	拎
ghnv	丐
kyce	唷
nwbn	怆
cgye	骧
xvjs	缫
swnp	槌
hnbt	瞰
edfn	胯
uujf	瘴
qtqh	狰
yang	讵
awdy	茯
akkn	萼
fnhl	韫
syt	枋
qtni	铄
qawc	镬
fyjn	霭
qqqf	鑫
iukg	涪
xsfi	缥
kbxy	戢
ewfc	脍
vgk	聿
wynm	颔
khwu	蹬
yjlc	谩
fpxn	坨
kans	喋
kayk	嚆
kgke	囔
mlh	岬
njfg	悝
iwfc	浍
tghf	眚
cnhn	矜
ibg	洱
kdhg	呸
jegg	蛆
qbqg	鸳
qjbh	郇
rwfy	拊
ktoy	啾
kwyc	噙
mpwa	崆
gnhc	瑕
quqf	锵
owfc	烩
rbbh	揶
iamw	潢
laay	轼
qmnn	铠
dcen	鬣
rmhr	掣
kyke	嚎
rduw	撅
iary	沤
ipuf	滓
wlge	偎
ufcl	阖
xhit	缈
ttlx	篦
xdgy	缄
ethg	臼
agho	蔫
rwgj	揄
nywf	悴
sdwt	榛
lrwy	轶
dqay	砥
afbh	邯
btfg	陲
qtxj	狒
ijg	汨
lccc	辍
rnwy	抉
hujf	瞳
whdd	俳
qynw	凫
kxxn	吡
qtlh	狎
inmj	涮
xfhw	缜
ffnu	恚
djqn	碣
tjsy	稞
iavt	沏
cyju	蚤
puge	裱
meqg	鹘
unre	疡
lfke	辕
dbf	耷
isfg	湮
usgp	遒
gtfm	瓒
hdhy	斐
dwry	砜
yoqg	鸾
puov	褛
aplj	荤
muyn	罔
wajv	偃
ydg	诂
ovwm	赓
nmfk	惆
jqwn	曷
jqko	煦
khaq	跷
wgdu	癸
ogjr	粳
iqy	汐
gflf	盂
dskj	剞
wmfk	倜
apfq	莞
ixcy	泓
xwnd	缑
tdsk	犄
bkmy	陨
bfjh	阱
nfpb	悖
ofnh	炜
ohjf	焯
lrcy	畈
jyuy	螃
taqj	簪
akhm	匮
wgiy	俅
wwyo	僬
run	扪
kngf	喔
qngn	饨
idhc	滟
iovk	溏
vfqn	妩
gtgs	珩
skbg	楫
tfkg	鹄
pujl	褴
diwk	耠
tief	筲
qgts	鲦
wtfm	赁
rjh	刈
whty	倏
yyud	谪
avdf	薅
qnck	饴
qnjx	馄
capd	迳
gdxy	珑
qmjh	铡
wkgd	俣
mnan	岷
nwyo	憔
pwjs	窠
adwi	綦
umig	鳖
tlqi	囱
egxw	胰
frh	圻
ftmk	垧
ghkg	玷
tgkw	簌
udqg	鲞
dxxn	砒
wjfg	俚
fkh	圳
pawg	骞
pyfc	祛
dfh	矸
ermg	鹞
ufhm	癫
sgne	醪
khua	蹉
khjn	蹋
ogbh	邺
qtdk	猗
xepc	绶
qigy	玺
dhvr	挈
qatq	铙
sgsh	酊
lffg	畦
pgey	冢
ujfb	鄣
ntfh	忏
nbsk	屙
vgeg	婧
viph	嫦
gdmy	顼
usgy	猷
uape	痨
ugku	痘
ugwc	羚
yobf	孪
qyey	铱
txge	篆
fulk	啬
wyky	僦
yfkg	诘
yewy	谀
yujg	谙
amwu	芮
kuwl	嗌
kssi	噤
lbd	囝
nddy	恹
pdui	寮
sykk	槁
susf	樽
adwa	戡
tfnp	毽
qkqg	鸲
mmvg	鹦
uhdd	痱
purf	裨
diaf	耩
khby	趿
qgyr	鲛
enud	鼷
mwfi	赊
fpgu	壹
gjk	丌
waht	伢
yntl	谧
fgkh	塥
rjhh	抻
kpey	哝
ipfq	浣
pdfe	宸
vcxb	弩
xoxh	鬻
sqgj	橹
mnyu	赆
elh	胛
heqn	睨
khwb	跄
wybr	隽
wmgk	侗
qytb	孵
ikhk	潞
wriy	侏
klh	呷
inan	泯
cnhv	婺
jakg	蜮
hqco	粲
nrh	忻
ybmh	诎
mhjc	幔
qgny	钺
figh	霈
qgft	鲮
yqvh	诤
ykkn	谔
bhht	陟
yxtf	壅
ahgc	菽
rhan	摅
mhuf	幛
moqh	嶙
qtot	犷
qdmh	钸
fheg	趄
khmj	踹
akfs	鞣
enuk	鼯
wiu	氽
nagd	惬
haoq	觑
qwyn	钤
sghe	醵
qgty	稣
cdlf	畚
ayjj	荠
awuf	莅
yupk	啻
nsyy	怵
nplh	恽
uwgd	阕
inwy	濯
qipi	迩
vpta	姹
gpqb	琬
sduw	橛
ldg	轱
uljy	甑
jpgg	暄
epgh	腚
yttg	旌
qdhy	钚
jgkl	蝠
jtjt	蝮
tdgy	箴
ugmo	羰
gkua	豇
khok	踮
fqkn	鼋
qgmk	鲷
xxnt	毖
nawe	臀
wgmy	俪
gcfb	郅
lgkd	圄
idff	溽
vnyw	姒
govk	瑭
gamw	璜
teyt	舫
wovg	偻
amqb	苋
gooy	琰
sbcl	楹
gkuc	豉
lfoq	黟
gqyy	玖
teyx	舷
tyiu	汆
rtfb	郫
tyt	彷
iqiy	洮
sjf	杳
eewy	腴
hwgd	睽
jusg	蝤
tewb	舱
akfe	鞘
yqvg	诌
brgg	隍
abh	邛
kxn	叱
kehc	嗖
ntkg	恪
xthk	绺
sswy	梵
jgdu	昊
qhy	钋
qovg	镂
pwxb	穹
cwtc	皴
fejf	霾
qghk	鲇
iywf	淬
wgqi	夙
adfi	萘
kduw	噘
unbt	阚
xbg	弭
dwef	舂
sgto	醺
rdfn	翱
afmy	贰
hwby	龋
txen	胤
bhnn	鼐
dwi	仄
akd	叵
wqkg	佝
wweg	俎
yng	诩
yhag	谑
akgf	堇
akbf	葺
asjf	蕈
rpwh	撺
anyi	忒
kdff	喹
nmjh	恻
igud	浃
pdf	宕
qtop	逖
vprw	嫔
sviy	棣
syfj	槠
eoy	脒
edmd	腼
wrec	飕
hwgg	睑
hpgh	睿
qnnk	锔
qqrn	锪
wyog	鹪
diov	耧
jtfp	蜓
tgfj	竽
tsjf	簟
khmg	跚
khyj	跻
qgdy	鲅
qgya	鳊
qguk	鳝
merf	髀
mepq	髋
dcek	髻
dceb	鬈
fjj	亓
qgkl	匐
eksk	哿
avkf	苕
anwe	蓼
qpgw	夤
daht	砑
hnqg	鸬
tftj	箸
sxge	椽
fmgk	垌
khy	卟
tgoy	徕
jepc	暧
wgkw	歙
oyna	煸
dwn	矶
dary	砹
rrcy	皈
ayqg	鸢
jqdy	蟾
mdqg	鸯
rccs	搡
kvcy	呶
nmdy	怏
ithg	洎
vjfg	娌
thgs	牒
ojug	煜
ugnu	恙
wgky	龛
gqty	敖
pqbj	剜
gogf	垩
kadk	喏
vgvh	婕
uwry	飒
jsrh	蜥
ywcq	兖
fkmw	埚
fdri	塬
amff	苒
aulr	蕲
mhow	幞
njgg	怛
bnhg	孑
xakf	缂
xwgr	缏
nkuy	甓
qyt	钫
qtfk	锆
yoqf	銮
akkm	颧
kfph	嚏
wsh	仃
wdg	仨
atgo	薰
rnwy	擢
kccc	啜
qnws	馀
ufnh	闱
iyhy	汴
vgah	妍
xcnh	纾
sgog	桠
gngw	欤
wrhw	飓
yndy	戾
dpxn	砣
fnwd	磬
qgud	铗
khtg	鹭
putk	袼
puws	褓
jyxf	蟀
jtol	蟠
takf	笸
twht	筱
onjw	麒
rprw	摈
jlkg	蛔
agey	莆
qayi	氐
waqj	僭
tyou	籴
ycne	袤
awfc	荟
kwyo	噍
mgoy	崃
ojff	廛
ujjd	阊
ivfy	浔
oqap	遴
cggy	骊
dhau	戛
ujqw	歆
dwag	砼
jgeg	蜻
gei	豕
ossn	麾
eag	肛
wssy	傈
nhdd	奘
ghaw	琥
evgp	腱
qlny	锶
trtf	稗
adhf	茬
ahkf	苫
dhgf	丕
afwy	藿
rwgd	揆
kyvb	啷
kmee	嘣
udd	闫
xafg	绀
gawy	珙
sftn	栲
dgxy	碡
qfg	钍
aldn	蒽
udny	疣
kmwj	剐
vuth	馗
wfkg	佶
blge	隈
aqgg	藓
rxfm	掼
knmj	唰
qnnw	馔
qyvp	遛
vfsh	孀
sfiu	柰
sfhy	樾
syli	檩
tvgp	犍
ytnx	旎
wkso	煲
hgbn	盹
jdgq	蛎
tngk	笥
twgf	筌
trqq	篼
teie	艄
khaw	蹒
hwbf	龌
qgjf	鲣
qgti	鲧
raws	搽
yhy	讣
xtsy	绦
wqiy	佻
ugxg	冱
aiaf	茳
anyu	荩
kfkg	咭
krdf	嗥
mwgu	嶝
oyli	廪
uakg	阈
cglg	驷
xnaj	缗
xgoj	缙
grg	珀
saqy	柩
sftj	楮
gkhs	橐
dpgg	碹
hghn	眄
qakg	钷
qdcy	钹
qycq	铳
dibg	耔
yntm	颏
jovg	蝼
jton	蟋
tgkm	籁
khed	蹊
qgkn	鳄
qgem	鳐
akfh	鞴
dcex	髭
fpfq	垸
anhc	葭
kooy	啖
gjhg	瑁
lsh	町
qjxx	锟
uqsu	桨
yaah	诫
uffi	痔
wadk	偌
anyw	苡
awtf	荏
aovt	薮
katq	哓
kjmy	喁
vcmh	帑
mhtl	幡
mujf	嶂
smg	柚
stoy	楸
dxyd	砻
dqas	磔
qnxn	铌
qwyb	镌
jcfg	蛏
jqke	蟓
khyy	蹴
gemq	靓
fyjj	霁
hwbx	龇
qgjn	鳎
kfwy	呋
ilkg	洄
gehp	逋
qgkh	镉
aieg	菹
kxge	喙
qttj	猁
uyve	阆
stfk	梏
fnuq	觌
thgy	牖
egkh	膈
hdff	睚
qdeg	铕
ewi	臾
jjai	曝
kmbh	郧
rvyj	蛰
wgny	佤
rdsk	掎
kwsy	咻
kdht	嗄
kake	嘞
nhde	爿
imwn	涔
ssjg	楂
jwyk	晗
wgeq	觎
tdg	牯
qyxy	铉
qbsk	锕
qugi	镧
jdg	蛄
jmag	蛐
tmqb	笕
qgff	鲑
wjqn	偈
aqef	萏
lded	囿
lfuf	圉
nrnn	忾
ilxi	漯
fwfp	逵
xvlg	缁
xjlc	缦
lwet	轸
famu	贲
ghnu	忑
ldhu	罘
uwlj	蠲
qipf	镗
jebg	蜉
tagd	箧
tpwa	箜
tegj	艚
gqkh	趸
onjq	鏖
ajjf	菖
qntt	铋
yugi	谰
vqkq	娩
cddf	叁
sfij	剽
fwnd	堠
apfc	蔻
ksfi	嘌
knkf	噼
tryt	徼
qtuq	獍
qnnr	饧
icyy	汊
igey	涿
itie	潲
nbbb	孱
vgog	娅
vuah	姘
gkhk	璐
swyc	柃
sqay	柢
sfuk	樯
ehnt	胪
ehdd	腓
ouny	焖
hwyg	睢
fkuh	瞽
wfil	畲
djng	鹌
uiit	痧
pujr	裼
jtuf	蝌
etyt	豸
qgck	鲐
qgvl	鲻
qgfj	鳍
jpjw	螟
qgld	鲴
fpbf	孛
apgf	苎
kwwf	唑
qtlq	猡
iada	漭
iiiu	淼
twyn	稔
qgdj	鲕
wceh	俑
yag	讧
adxy	茏
axxf	荜
atxu	莓
afff	葑
rqqw	揿
kqrm	啕
kfwy	嚯
irgg	湟
iyuy	滂
vbsk	婀
xtfm	缵
snig	樨
ukgy	瓿
dukg	碚
hipf	瞠
quga	锎
qnhg	镅
ugxw	痍
ugki	竦
trhy	笊
gkmn	翮
yhu	卞
stfn	橇
dlk	厍
dajd	厝
wqdy	儋
yqeg	谄
atgs	荇
akmw	莴
aadn	葚
awuk	蓓
aujn	薏
rsay	弑
kfdj	嚅
mnhg	嵋
qtke	狷
qnat	馓
ipjw	溟
cgck	骀
skgn	枵
smnn	桤
swyf	榫
snie	榍
gqwe	殄
gqwg	殓
fwfl	辇
ttfn	牦
yugi	斓
dgaj	硎
dgmy	碛
hoqh	瞵
qhcy	铍
tfhw	稹
dujg	鹩
uusi	痫
ummv	瘿
kkfm	颚
jamw	蟥
tssu	篥
iite	裟
omh	籼
odgq	粝
sggy	酾
khpx	跎
qgvf	鲟
lfok	黠
sgjx	醌
gkmh	鬲
fjlc	墁
fkuf	鼙
asf	茜
akkf	莒
aptg	荦
kxhh	吲
kywf	啐
mdjn	崦
tmgt	徵
njlg	愠
nalh	懵
idmd	湎
ibcc	滠
isse	潸
igkm	濑
xfkm	缬
scfg	柽
qykt	镦
ykbg	鹑
cnhg	鹜
punw	袂
jxxn	蚍
jgud	蛱
txxf	筚
oxkj	糨
wgkn	翕
tkwy	雒
qgjx	鲲
mnjh	剀
wxxn	仳
yqtg	诳
oobh	郯
fwyn	埝
kdoy	咴
kwsy	哚
kfcl	嗑
lqre	囫
maps	嵘
mgee	豳
igjg	洹
irgw	浜
vywr	姣
sgli	楝
lvyy	轫
tykk	犒
rnmj	氙
hgnu	忐
hcwt	睃
tgsy	秣
srrf	皙
pwxe	窈
pwqi	窕
dii	耒
mdmm	颛
dfej	蜃
teyr	舣
khqy	趵
khhc	跛
khtk	踟
qggy	鲡
qghd	鲱
kwvt	咿
cgua	骈
qteg	狙
wwfc	侩
uehk	痈
bynw	陔
fdxy	垅
rusf	撙
iptk	喾
kgxi	嗉
nqjg	恂
nhda	戕
ikhy	浞
erqp	邈
cgaq	骁
cgaw	骐
vkcb	邕
gtkg	珞
gjxx	琨
scnh	杼
sdg	柘
shjf	棹
jwgd	暌
eudv	媵
qwgr	镎
qqyl	镏
umk	疝
jthf	蚱
jwyc	蛉
fnwm	罄
tadk	箬
khdg	跖
khya	蹁
khow	蹼
qgjj	鲳
qgto	鳅
medg	骷
meov	髅
fyuk	墒
krcy	呱
xudb	绻
txxn	秕
ucad	痉
ilwy	泅
dhvb	孬
wpey	侬
yagg	诓
yfmy	谳
ryne	掮
kmfk	啁
mdgy	崴
qtay	獾
nwcy	忪
vmg	妯
gway	玳
ejh	刖
melj	髑
ytnn	讫
uekw	瘸
qtgm	獭
qrjh	刎
wwn	仉
wtay	伥
wfkk	僖
ynky	羸
yfh	讦
yywf	谇
aveu	茛
abry	菰
kihc	啵
mqvh	峥
qtqg	獬
oqnv	庖
ntfh	忤
nvkg	怊
nyli	懔
ildy	洇
ihwy	濉
xgtx	彘
xjqc	艴
fitv	嫠
xphn	绾
xshg	缃
gwn	玑
gnan	珉
vjf	旮
efhw	虢
egey	豚
ewgj	腧
eprw	膑
dgud	硖
qrcy	钣
qjsy	锞
quwl	镒
qqgj	镥
qwgu	镫
diit	耖
bccm	颞
jagw	螨
tvel	簋
teag	舡
texx	舭
ekye	袈
othy	糗
sggd	酽
rrkh	踅
khtp	跹
nnaw	巽
jyvb	螂
wfvg	佞
ywgg	诠
bhkg	阽
fot	圹
ffhg	埴
fsfg	堙
flyt	塄
akby	蕺
aosd	蘼
rldn	摁
rmmv	撄
rfkm	撷
rqgj	撸
kann	呓
kpaf	噻
mhrw	帙
nssh	憷
ighn	沔
iywn	沆
iyty	沩
iafg	泔
iqtj	潴
inbt	澉
vatq	娆
cgwf	骅
xuvo	缣
jghh	韪
stni	栎
yosu	栾
sebg	桴
skkk	榀
swdc	椴
awwq	觋
ckou	炱
ujfn	戆
ldyy	畎
fclf	盍
qvkg	铷
kkfg	鹗
jfmf	蝻
tqkf	笱
temh	舢
ugjn	羯
sgdl	醢
onjt	麇
wtuy	佟
ylwt	谡
ywwg	谶
fans	堞
atry	莪
adcw	蕻
ket	叻
kwfc	哙
kpta	咤
iecn	淝
rgkp	逅
rgpd	遑
biu	尕
svoy	棂
imkn	氅
epfi	腙
dywe	磙
qldy	铟
tdwf	矬
tebg	稃
ugkj	瘌
uhhy	癯
fkdm	颉
fhtm	趱
khvp	踺
rtfh	扦
eigq	胱
othj	糌
udyf	誊
yrgk	诟
bcag	陉
brqc	隗
tfkb	郜
fgog	垭
fjfy	埘
anud	荬
axgn	莼
aqky	菟
arcb	葩
rnrg	摺
aafy	甙
klfy	啭
kbcc	嗫
kpnm	嘧
qnec	馊
nuxt	悌
novh	慵
itah	洚
iwgt	潋
pawh	蹇
sndg	椐
gomu	赉
odeg	煳
ynuf	戽
tign	愆
qape	铹
qxxr	锴
qajd	镆
pwuj	窨
pwry	窳
puya	褊
purw	褫
trgf	篁
tesk	舸
ocns	糅
fhgj	趔
hwbg	龃
ossi	縻
atay	苌
aevf	荽
rube	搠
iviy	渌
ifae	灞
cnhg	骛
yjhg	齑
dmgk	硐
gqtb	聱
jynn	虻
jytb	蝣
jipf	螳
trkf	筘
twnd	篌
onjo	麋
ykig	鹫
khph	蹿
vdfe	娠
wary	伛
krdh	唏
kfke	嘭
mhnf	幄
tugh	徉
iwgc	溆
smqn	枧
gqkm	殒
tfnj	氆
qywn	钪
qgoy	铼
ttnt	秭
uxhg	鹈
uwnd	瘊
puak	褡
fotj	螫
fobc	赧
khga	趼
qvwy	雏
gfcy	珐
uwee	疹
hghg	芈
wywn	伉
wpwa	倥
ygey	诼
qngb	邬
rdcb	郄
agxw	荑
aufj	莘
adwt	蓁
lxxk	辔
mmg	岫
mcgh	峄
mykb	崞
gdnu	忝
itlg	洫
ivkg	洳
iuej	湔
iwow	濮
iwga	瀹
ckpd	迨
xkhm	缋
sdet	枥
sswv	棼
gqeb	殍
juf	昱
mynw	赅
nkur	擘
ytyk	旒
gego	燹
dtpy	砭
dwyg	碓
oguy	黻
hgoy	睐
lgjj	畀
qet	钐
qjgf	锝
qovh	镛
rvyg	鸷
udee	疬
ugyg	癍
cccm	颡
jblg	蜢
wyne	衾
meqy	骶
kgey	啄
qgjc	鳗
wdjg	佰
vtfg	妊
hnmq	兕
yieg	诮
ycnk	谲
uxbh	邶
ghgb	鄢
fnn	圯
apff	茔
apnf	茕
ahxb	茈
aduw	蕨
rfny	抟
roao	摭
lwyc	囹
mhly	帼
ntjt	愎
inn	汜
ideg	洧
iriy	洙
ifkf	澍
cwtp	逡
gqtp	遨
qehp	邂
vwyn	妗
nkuv	嬖
xieg	绡
vlf	甾
stfp	梃
sqeh	桷
sahd	榧
lmun	辋
jrh	昕
oygg	炷
pydy	祓
dpgh	碇
ldf	罟
qcyy	钗
qpxn	铊
qtfp	铤
qsjf	镡
pqqg	鸩
wwkg	鹆
fhng	鹉
oaog	鹧
uewi	瘐
ulxi	瘰
ubtg	癃
didf	耨
btdg	聒
jafg	蚶
jujf	蟑
tjgf	笪
ugqy	羝
ocn	粑
onhe	糈
khdf	蹰
khvn	躐
qggf	鲆
qgrg	鳇
yorj	挛
hrtf	睥
diyy	耪
ddyd	靥
akgb	鄞
fkkb	酃
fefy	埒
dkj	夼
rlxi	摞
rthj	擤
ksg	哂
kgkh	嗝
khae	噱
kpwi	嚓
mhfh	帏
mldf	崮
qtxf	狴
nkhm	愦
iqtb	泖
cgsi	骠
xdcy	绂
xwnp	缒
thwy	犋
eudf	塍
qyve	锒
qukg	锫
qyke	锿
ugkd	痦
bmfg	聃
jmqn	蚬
jfke	蟛
tvkf	笤
qgyj	鲚
khuj	蹭
wweg	佾
wyjh	侪
whjf	倬
wipq	傥
yaqj	谮
yqdy	谵
bjfg	陧
gmwb	邴
waff	垡
fhkg	坫
aanf	苣
aovf	蒌
rrtf	捭
kny	吣
lwxv	囵
qtvn	犰
qtfh	犴
qtjs	猓
qtuf	獐
ofqv	庑
uepc	阌
vylg	嬗
xkhp	缱
gqwc	殁
jfh	旰
tgkg	牾
fpgc	彀
ytmy	旃
lpqb	畹
qjgg	钽
qftx	铑
qwgk	铪
qdfa	锛
qytd	镞
qayg	鸱
bhgj	蚩
jwgs	蜍
jjqr	蜴
jgmj	螬
nkue	襞
atdn	翳
edjg	貊
hwbe	龈
hwbh	龊
iycq	鎏
xtwe	飨
wtfh	仟
dnhc	嘏
wdeg	侑
wndg	倨
wqrn	偬
wgka	龠
ulne	冁
yffg	诖
yuev	谫
ywyo	谯
gqet	劢
obxb	鬯
wvff	坌
fynw	垓
fnbm	堀
abr	艿
atbr	莠
aqto	荻
awcn	蓊
ageg	蕤
rukg	掊
rnae	搌
kmwu	呙
kqrn	唿
mdg	岵
mape	崂
muga	嵯
miwe	嵴
qtdi	獠
nary	怄
nnxn	怩
ncwt	悛
nhdd	悱
udci	闳
ueqv	阋
ufhw	阗
itni	泺
iqg	淦
iwru	滏
iadr	澌
ihqg	瀣
nugg	羼
vqyy	妁
xann	绁
xtfg	缍
ggyy	珏
gtln	璁
satq	桡
suga	槎
sffn	樗
loqh	辚
jthk	晷
mgiy	赇
txn	牝
eaiy	胨
ejhh	胂
eqkg	朐
euah	胼
rdmw	欷
fplc	毂
ough	烊
ojlc	熳
otol	燔
emgo	爨
wtfn	恁
lwet	畛
lyf	詈
qvg	钕
qvlg	锱
qono	镳
xxgg	鸶
uxxg	鹚
ubk	疖
uqnv	疱
uygd	疰
jnn	虬
jufh	蚪
trcg	箨
tonx	簏
tebl	艋
osg	粞
sguk	醅
khti	跞
khas	蹀
etlx	貔
wyyy	雠
qgfv	鳕
akfy	鞫
ddyc	魇
rqcw	魉
ddye	餍
ittn	滗
gkhj	蠹
wsoy	僳
tlri	囟
dfnj	刳
jhet	勖
ehcu	叟
hhwc	矍
ayxy	蕹
rvqy	拶
kuhh	吖
kagg	哐
kugh	咩
kctg	哞
kalg	喵
kpgh	啶
timk	徜
qtwc	狯
qahh	舛
njcf	悭
uqjn	阄
igqj	洌
ilgj	淠
ihaf	滹
pawr	搴
jnpd	遢
vlrp	邋
vjgg	妲
gsh	玎
gpfi	琮
stay	枨
sigg	榉
spwi	檫
efjh	肼
efqn	朊
edjn	腌
eoqh	膦
dcde	碜
lfmf	罱
qkh	钏
uskd	疴
uovd	瘘
puuj	裥
diae	耢
bsh	耵
bkhm	聩
jmwy	蚋
jyjh	蛴
mmrm	罂
teae	艨
khxf	跸
khtq	跣
khyr	跤
akfb	鞯
aftj	蓍
wtnn	仡
iitg	鲨
oyuk	熵
mjvf	岿
gsj	亍
rru	爻
wtfh	仵
wcwy	傩
wujf	僮
qyd	訇
bjxo	隰
ybh	邡
ibk	凼
fnig	墀
aegf	苴
avfu	荨
adff	蓐
athh	蓰
daru	奁
rvtk	捃
rsjg	揸
kyny	唳
maiu	岽
mtdj	峤
mwgj	嵛
mxth	嶷
qtnf	狃
qtxi	猕
qnag	馑
ncgh	怿
ulsi	阃
uqaj	阍
igki	涑
ithj	濞
iyke	濠
iolw	瀵
gmyp	逦
vipi	逯
nthh	屣
vsfi	嫖
vlxi	嫘
vccg	驽
cgwy	骓
xtgs	绗
gekg	珈
gegc	瑗
ghae	璩
susy	榇
gqtr	殇
gqfu	殪
jwxf	晔
mgef	赙
wgen	毹
tfew	歃
fpgc	觳
yttn	旄
pyqi	祧
pydd	禊
cfnu	怼
ykbn	憝
drh	斫
dyna	碥
oguy	黼
hitt	眇
hhxn	眦
qbg	铒
qgeg	锖
qadk	锘
qtfe	锸
qyud	镝
tdxh	矧
uwwf	痤
pucy	衩
puwg	裣
bpsh	聍
jdwj	蝽
tujj	螽
cnhj	蟊
rmk	缶
tgaj	笄
tpqb	箢
terc	舨
tehn	舻
tesg	舾
teuf	艟
sgne	醑
sgow	醭
sgyl	醯
khfw	趺
khwf	跗
khjs	踝
khrm	踬
khuk	踣
khyc	躞
fief	霪
itdq	鋈
qggr	鲠
qgli	鳏
txtg	鳘
qgmu	鳢
mewc	骰
gqwe	餮
aisk	菏
nnv	乜
hknn	乩
ytfq	诜
yadn	谌
bgqn	阢
bcib	鄹
qket	劬
blet	勐
fthp	埏
fovh	墉
awff	茌
aqgb	茚
ariu	茱
atdj	荞
asrj	菥
aswc	菘
amhk	萜
aebc	菔
aphn	菅
adgy	葳
ayks	藁
khxn	呲
kmqy	哕
krey	哌
kvey	哏
kjbc	嘬
kulj	噌
mrde	崤
muxx	嵫
qtad	狨
qtyg	狺
qwye	飧
qnrn	饩
qnuf	馐
owsi	庥
ndg	怙
nthf	怍
nlsy	悃
idxy	泷
iyxy	泫
ihmy	浈
ikjn	渑
iehc	溲
iapy	滢
pvb	宄
ahtp	迓
nvv	尻
vxxn	妣
vyty	妫
vmgn	娉
gqtg	骜
cgyn	骟
xlxi	缧
gepc	瑷
sgqn	杌
sguf	枰
sryy	柝
sigq	桄
sadn	椹
ltkg	辂
jpjw	暝
hhwn	氍
rntr	氕
rnld	氤
ewet	胗
eudy	朕
eylg	膻
oqyl	熘
otmd	燠
dnrt	砀
hxdf	砦
dape	礞
huxt	睇
qbh	钌
qun	钔
qymh	铈
qkgg	锃
qxjm	镄
qtgf	锺
tyke	穰
dfny	瓠
usfi	瘭
pulp	裢
pukg	裎
puxj	襁
awyj	蛩
cnhj	蝥
trcb	筢
sgtf	酢
sgwo	醮
khff	跬
qehy	觚
qehi	觫
hwbx	龀
qgnj	鲺
qgae	鳓
merk	骺
lfot	黢
yctd	诶
txty	後
xykk	缟
stgs	桁
qcn	钯
ufni	痣
wgkm	颌
wprw	傧
ywyn	谂
rlgy	掴
gkij	剌
yomw	脔
aewu	萸
mqjg	峋
ougk	庠
oany	庹
imdy	泱
qghn	鲈
afkf	薹
rdff	捱
kxet	呦
lged	圊
maht	岈
qtws	狳
xulj	缯
gplh	珲
jvb	旯
deqg	鹕
fdmy	顸
jdri	螈
hwbk	龉
rkej	捌
uwjk	疥
uegd	疽
iasu	柒
qifc	鼗
ddyl	厣
mqjh	刿
aeej	蒯
wet	仂
wtcy	仫
wnxn	伲
wbg	佴
wdtf	俦
wjsy	倮
yeeu	裒
ynky	蠃
ydiy	诔
ybcy	诹
yyna	谝
bthf	阼
brtf	陴
fbh	邗
ynbh	邙
ribh	邾
wfcb	郐
rdmb	郗
vket	劭
fryy	坼
fqay	坻
fkgg	埕
fjqr	埸
fqky	堍
avb	艽
abyu	芨
axb	芎
anb	芑
agmh	芾
afcu	芰
ader	苈
awyn	芩
aqab	芪
adhg	苤
amkf	苘
awfu	苻
aqyg	茑
aebf	莩
awyf	萑
akhm	蒉
ayks	葶
aire	蒎
agkw	蔌
alpy	甍
awgt	蔹
aias	蕖
agqg	薤
ankf	薜
afdj	薷
atqs	蘅
dfnn	匏
dnqy	尥
ryny	捩
rajv	揠
rpgg	揎
rrhw	搋
ktan	吒
kfqn	呒
kigq	咣
kdwg	唪
kuvg	唼
kxxr	喈
kdwt	嗪
kwrq	嗲
kube	嗍
kytd	嗾
mmqn	岘
tdmj	岙
mskf	岢
mqkg	岣
mqtb	峁
ttth	彳
qtcq	狁
qtbi	狲
qtwg	猃
qteq	猊
qtde	猢
qtcs	猱
qtto	獯
ortf	庳
oqeg	廨
nfcy	忮
nxjh	怫
bdan	隳
uywv	闶
uhdy	阒
iqjg	洵
ilfh	涠
idwt	溱
ilge	溷
iqdy	澹
iylg	澶
pdef	宥
pnhk	寤
vary	妪
vriy	姝
vkmw	娲
vgey	婊
vjlg	媪
vajd	嫫
vepc	嫒
vfuk	嫱
cgce	骖
bhhg	骘
cgql	骝
xgfh	纡
xdfn	绔
xgjr	绠
xuxt	绨
xjgh	缇
xlny	缌
xdff	缛
xkks	缲
xlge	缳
gbg	珥
gmmv	璎
sqyy	杓
sitt	杪
shnt	栌
spxn	柁
sftx	栳
stdg	栝
stfg	棰
syki	椋
sykb	椁
sakg	槿
sipf	樘
qtfs	橥
gqbg	殛
ltuf	轷
lvkg	轺
lgcf	轾
ldwd	辏
lkf	軎
wycy	瓴
jqug	昀
thjf	昝
jgey	晡
jykt	暾
mkqn	贶
mooy	赕
hkmq	觇
amfq	觏
wayg	牮
iitr	挲
tfng	毪
rnjl	氲
egbn	肫
emwy	肭
ercy	胍
emgk	胴
ekmw	脶
efmf	腩
dskw	欹
owbn	炝
ogkg	焐
oelf	爝
ynmk	扃
pyqi	祢
pyye	禳
fpwn	悫
natn	愍
aadn	慝
dlh	砗
datq	硗
dias	磲
dykt	礅
ogui	黹
qbhf	眢
hckg	眙
hehc	瞍
lujf	疃
lghf	罡
lfco	罴
lnwy	罹
lulj	罾
qlg	钿
qahb	铘
qtry	锇
qooy	锬
qegc	锾
qprw	镔
qyth	镟
qogw	镤
qpwi	镲
rtol	皤
wsqg	鸺
fpbg	鹁
gmyg	鹂
uvog	鹣
cnhg	鹬
akkg	鹳
usk	疔
uafd	疳
ugey	瘃
utvd	痿
uuga	瘥
uajd	瘼
uwfi	瘵
unac	癜
pwwj	窬
puwn	衿
puug	袢
pufj	襦
pusr	襻
dihn	耜
diod	耱
ftxf	耋
agmm	颟
jykm	颢
fdmm	颥
hhdf	颦
gqju	虿
jmfg	蚺
jatq	蛲
jugh	蛘
jctg	蛑
jieg	蛸
jtjh	蜊
jadw	蜞
jjsy	蜾
jmfk	蜩
japs	蝾
jdff	蝰
jsfi	螵
jawc	蠖
rmhf	罅
tqrr	笏
ttfq	筅
taww	筮
tkhm	篑
eqou	舄
thsu	臬
tlnf	衄
tekh	舯
temg	舳
oty	敉
ocde	糁
ownd	糇
ouxx	糍
vei	艮
ftjn	翥
rvyi	絷
gxhi	纛
swwo	麴
sgdg	酤
sgpx	酡
sgqk	酩
sgef	酹
sgde	醐
sgjh	醍
khek	跏
khck	跆
khtl	蹯
eajd	貘
qehl	觯
fnwy	謦
hwbn	龅
kjnb	黾
kkln	鼍
wyfj	隼
egwy	雎
awyq	銎
lrqf	錾
nkuq	鐾
ipqg	鲎
qgde	鲔
qgeq	鲵
qgfm	鲼
qgas	鲽
qgtt	鳆
qgcj	鳋
akfj	鞒
mejs	髁
kgne	饕
dces	髹
dcee	鬟
tqto	黧
enuv	鼢
wtvg	倭
mdhb	酆
fafg	坩
ahf	苜
awht	莜
ayve	莨
apqf	蓥
alph	瞢
kdyy	呔
jsqq	夥
qnge	馕
ijg	汩
cgjs	骒
xxxn	纰
gyy	玟
jou	炅
dug	砬
ywdm	颃
ossc	麽
thlg	齄
ahkm	赜
awyj	劐
bigb	卺
sfbh	鄄
ffnn	圬
fdet	坜
admy	蒇
auvo	蒹
aiye	蒗
aytd	蔟
rgdn	掭
ruvo	搛
rlge	擐
rnkf	擗
mhhc	帔
mgah	岍
mswc	崧
pneh	甯
leve	嬲
cgtn	骢
xtnn	纥
swwy	枞
sdxy	栊
slh	柙
skwy	枳
slqy	椤
nkus	檗
rwgr	搿
onrt	炀
otuf	烀
tfuk	穑
puiv	裆
xidm	颍
jxet	蚴
alvv	匦
dubj	劂
wwbn	伧
whgh	佧
wmgn	俜
ipaw	黉
uthg	馘
uswc	凇
yegc	谖
bbcy	陬
kgbh	郢
ugub	鄯
fhnt	垆
fnxn	坭
fxy	坶
fvph	埽
avyu	芄
adbb	苊
axxb	芘
awwu	苁
awcu	芟
aqtb	茆
aatq	荛
axfu	荮
afqw	莰
awgg	莶
apdf	菪
acnm	蓣
ajbc	蕞
alpx	薨
ahap	蘧
agth	廾
dnv	尢
rans	揲
rujg	揞
rxuu	搦
rnbt	撖
rfwy	攉
rgke	攮
kwyc	呤
kyjh	哜
krrh	哳
kran	唣
kssy	啉
kdjf	喱
lhng	囗
mhdf	帱
mhgm	帻
mnn	屺
mcb	岜
msvg	崾
movg	嵝
tegg	徂
qtcg	犸
qtct	狻
qtsg	猹
qtnh	猸
qnsg	馇
oxv	庀
oakg	廑
uygh	丬
iyyg	氵
itnn	汔
itbn	沲
igkg	浯
iqkq	浼
ipjh	渖
ians	渫
iwvl	湓
ijng	溻
tfpk	迕
thfp	迮
vngg	彐
xcag	弪
bhk	屮
vcnh	妤
yovf	娈
vcmw	胬
vbhj	媸
vujf	嫜
idiu	尜
byi	孓
cgeg	驵
cgqv	驺
cgnb	骣
xnng	纟
xot	纩
xxjh	绋
xckg	绐
ximk	绱
xjxx	绲
xyrc	缡
vnnn	巛
gwvt	玢
gndg	琚
emgy	璺
scgg	杩
smwy	枘
seg	桕
udsu	桊
siit	桫
sfnd	椟
lrsu	椠
svgp	楗
sdwd	楱
tdas	榘
srdf	槔
syke	榱
ubts	槊
sdhy	槭
sqef	槲
aqks	檠
swyc	檎
sxxe	橼
sflg	檑
gqty	獒
gqeg	殂
lwgg	辁
wbay	戗
bcla	戤
fkuy	甏
hcu	攴
jdwu	昃
jqtb	昴
eynw	胲
ewwf	脞
eebg	脬
epfq	脘
edwd	腠
ejlg	腽
ekkn	腭
epwf	膣
yrmh	旆
ovep	煺
dglg	礓
dawi	礤
hgfh	盱
hary	眍
hffg	眭
hqqy	眵
rtfg	鹎
uulk	瘅
plhc	皲
hav	虍
sgkg	酲
hlra	鹾
awyh	跫
khnn	跽
khhf	踔
khof	躔
khtm	躜
ewsy	貅
qehw	觖
ffnb	雩
hwbk	龆
wyg	隹
cnhq	鍪
gqtq	鏊
qgfk	鲒
qgpq	鲩
qgwn	鲶
qgdw	鳜
qguf	鳟
yxte	饔
lfoe	黪
thlv	鼽
rgbv	卮
agn	匚
wyoj	劁
wctg	侔
wwfi	傺
wlge	儇
wgig	佥
qtn	勹
yyg	亠
yuqk	谘
yipq	谠
lbwf	墼
fnn	圮
fgcf	垤
fmnn	垲
fyrb	垴
fkmy	埙
fdjn	埯
frtf	埤
feeg	堋
fviy	埭
fivs	墚
aghh	艹
aff	芏
aqrr	芴
abnb	芤
adcy	茇
anab	苠
amgk	茼
atfp	莛
aycq	茺
axaf	荭
aadw	萁
ardy	菝
artf	萆
aywu	菸
apqb	菀
ashf	葙
axxr	蒈
alnu	葸
ayrc	蓠
ayuy	蒡
ettt	彡
qttt	犭
ttny	夂
qnb	饣
qntd	饫
ofci	庋
ogqt	廒
nyyh	忄
nyhy	忭
nimk	惝
ntoy	愀
nuvo	慊
udpi	闼
ibet	泐
isyy	沭
iapi	潆
issv	漤
ikkn	漶
ifdj	濡
pyyn	宀
pntr	宓
pawe	褰
tahp	逄
giyp	逑
phnp	逭
mdmp	遄
amfp	遘
xgeu	彖
ntov	屦
gahb	琊
gqiy	珧
glpy	琏
jtgo	曛
jnwy	曜
jyke	曩
ttfk	牿
tyna	犏
tfnn	毳
cden	毵
tfnj	氇
ttgy	攵
ryty	敫
efnn	肟
eet	肜
ynef	肓
eqwy	肷
ehgh	胩
ethf	胙
eqay	胝
ersy	脎
eyuk	膪
efkc	臌
eouo	臁
wrqn	飑
oyyy	灬
pyyy	礻
pydg	祜
pyuo	禚
dmjn	恧
vhk	肀
ipiu	泶
dgbn	砘
dthf	砟
dayn	硭
dtlr	硇
dtry	硪
dccs	磉
dwgu	磴
cnhh	瞀
ldjn	罨
qtgn	钅
qnn	钆
qufh	钭
qoy	钬
qskg	钶
qdny	铖
qtfc	铥
qrsy	铩
qqiy	铫
qinr	铴
qany	铽
qefy	锊
qudb	锩
qehc	锼
qjlc	镘
qlxi	镙
qduw	镢
qpwh	镩
qujn	镱
tyve	稂
rcyw	瓞
aiqg	鸫
dmjg	鸸
tdqg	鸹
usqg	鹇
alqg	鹋
nhqg	鹛
nweg	鹨
qync	鹱
uygg	疒
ugqe	疠
uthf	痄
uyxi	痃
ugog	痖
uguf	瘗
unhc	瘕
ucyj	瘙
udhn	瘛
uamw	癀
unwe	瘳
uujn	癔
pwqu	穸
pwgn	窀
pwtp	窆
pwov	窭
puyy	衤
pumw	衲
pucc	裰
diik	耥
jwn	虮
gqji	虺
jtnn	虼
jfwy	蚨
jwjh	蚧
jmg	蚰
jjgh	蛳
jtdg	蛞
jufq	蜣
jrtf	蜱
jehc	螋
jwgj	蝓
jdwt	螓
gqtj	螯
jthn	螅
jyrc	螭
jovk	螗
jgjn	蟪
jugk	蟮
jape	蠓
jaly	蠛
jhhc	蠼
ttnt	笫
tthf	笮
tekf	笳
tepu	笾
tgmu	箦
traf	箝
tahd	篚
trhw	篪
tonr	簖
trql	籀
eaj	舁
tetf	舴
teuh	艏
uqwo	粢
ynti	綮
fhuw	趑
sgfy	酎
sgws	酴
sgok	醣
qgge	鲭
qgbc	鲰
akfq	鞔
mewj	骱
mepk	髂
mepw	髌
rqcy	魃
rqce	魈
rqcn	魍
dcet	髟
onjg	麈
enum	鼬
hhll	丨
ttll	丿
tav	乇
yyll	丶
jhh	刂
mhn	冂
wth	亻
uyg	冫
pyn	冖
yyn	讠
bnh	卩
bnh	阝
pny	廴
bnh	凵
cny	厶
adhd	葜
rghg	扌
pyny	辶
qgyy	钰
qkmh	铞
qyck	锍
qvpc	锓
qxkj	镪
tkkg	稆
dqyg	鸪
uekd	痂
puwk	袷
puve	裉
nhi	疋
jouo	蠊
tabj	筇
tgjr	筻
tenn	艉
xiu	糸
dceo	鬏
gnv	丂
hgd	丄
ghk	丅
dgt	丆
ghnn	丏
vygf	丒
gkgd	丗
gcu	丟
uxgf	丠
gmmk	両
gjan	丣
uogf	並
nhk	丩
ngk	丮
ehk	丯
njhg	丱
kkjk	丳
oguf	丵
uyt	丷
fjyi	丼
yyll	乀
yyll	乁
rty	乂
nyi	乄
nwi	乆
tur	乊
ithy	乑
rfmh	乕
tgai	乗
nnll	乚
nnll	乛
mnn	乢
xnn	乣
ghnb	乤
tunb	乥
ufnb	乧
cknn	乨
nld	乪
eknb	乫
annb	乬
dnb	乭
qtbn	乮
tufn	乯
uqwn	乲
rrnb	乴
ufnn	乵
gehn	乶
iitn	乷
bxi	乸
fjfn	乹
rnrn	乺
ywun	乻
iygn	乼
ftjn	乽
exin	乿
qjjn	亀
fjfn	亁
ecmn	亂
oqan	亃
fpgn	亄
hhll	亅
qhj	亇
guvh	亊
fnv	亐
fff	亖
mff	亗
ghng	亙
gkjg	亜
cccf	亝
gfgd	亞
yjj	亣
yoyu	亪
ykjf	亯
yjiu	亰
ywjg	亱
ykpv	亴
ylkg	亶
utvo	亷
ykbl	亸
yemg	亹
wgf	亼
wyu	亽
wnv	亾
wwy	仈
wwu	仌
wcy	仏
wfj	仐
wuu	仒
wmj	仚
wtan	仛
wag	仜
wfh	仠
wqyy	仢
wiy	仦
hgwu	仧
whgg	仩
wvyy	仭
wrcy	仮
witt	仯
wwyn	仱
weg	仴
wtdy	仸
wdhh	仹
wagf	仺
wgg	仼
wgxg	仾
wwcy	伀
wgmh	伂
wcnh	伃
wxhh	伄
wgbn	伅
wqrt	伆
wwcy	伇
wny	伈
wbyy	伋
wdbn	伌
wrh	伒
wdhy	伓
wpwn	伔
wfwy	伕
wdcy	伖
wvfh	伜
wfcy	伝
wlh	伡
wmqn	伣
wqug	伨
wyy	伩
wnyy	伬
wyxy	伭
wvcy	伮
wwiy	伱
wann	伳
wlg	伵
wmg	伷
wegg	伹
wguf	伻
wdhg	伾
wkwy	伿
whnn	佀
wckg	佁
wghg	佂
wafg	佄
wfiy	佅
wpsh	佇
wdmh	佈
wfcy	佉
whcy	佊
wvkg	佋
whxn	佌
wmdy	佒
whkg	佔
wntt	佖
wwmh	佡
wang	佢
wdg	佦
wqnn	佨
wlkg	佪
wtkg	佫
wtah	佭
wwgk	佮
wfhf	佱
wqkg	佲
wuah	併
wvey	佷
wtdg	佸
wqdb	佹
wwgg	佺
wuqw	佽
wgaj	侀
wtfq	侁
wota	侂
wynw	侅
swwi	來
wgxw	侇
wigq	侊
wync	侌
woy	侎
wtlg	侐
wpvg	侒
wvgh	侓
wdmj	侕
wgma	侖
wpta	侘
waay	侙
wqjg	侚
wtey	侜
wvkg	侞
wdhb	侟
wsg	価
wgmf	侢
wftn	侤
wynv	侫
wnyu	侭
wvtk	侰
wkgg	侱
wdfe	侲
wwwf	侳
wgnj	侴
wktk	侶
wnnk	侷
wgku	侸
wtfp	侹
wmwn	侺
wukq	侻
wfpb	侼
wlet	侽
wftb	侾
wevg	俀
wknd	俁
wtxi	係
wwgs	俆
wqtg	俇
wtfk	俈
wgkg	俉
wkcn	俋
wgey	俌
wyve	俍
wpfq	俒
wgva	俓
whqn	俔
wpsy	俕
wdhk	俖
wrdh	俙
wqkq	俛
wdww	俠
wtet	俢
wuxt	俤
wlh	俥
wfny	俧
wgoy	俫
wtcy	俬
wtkg	俰
wywe	俲
waay	俴
wgey	俵
whgc	俶
wecn	俷
wgfg	俹
wtlg	俻
wyce	俼
wrqw	俽
whaw	俿
wdey	倀
wtdk	倁
wtgf	倂
wthk	倃
wrde	倄
wywf	倅
wgmy	倆
wpqb	倇
wsww	倈
wyvk	倉
wwcn	倊
wldg	個
wmaw	倎
whto	倐
wug	們
wooy	倓
wtfg	倕
wfuf	倖
weeg	倗
wadw	倛
fjfw	倝
wyki	倞
wwyg	倠
wgvh	倢
wyty	倣
wfhn	値
wpfi	倧
wwga	倫
wswc	倯
wfwt	倰
wjxx	倱
wgji	倲
wgkh	倳
wdfa	倴
wfhy	倵
whgw	倶
wdfi	倷
wesy	倸
wwgw	倹
wbbh	倻
wwfk	倽
wuvg	倿
wamd	偀
wemf	偁
wuej	偂
wdmd	偄
wtgf	偅
wdwj	偆
wnkh	偉
wtky	偊
wnua	偋
wjgh	偍
wute	偐
wwtj	偑
wjgr	偒
wngf	偓
wkkn	偔
wftj	偖
with	偗
wkkk	偘
wyuh	偙
wtfe	偛
wuxe	偝
wans	偞
wrgg	偟
wsvg	偠
wadn	偡
wtoy	偢
wujg	偣
wusg	偤
wnhe	偦
wdqq	偧
whxs	偨
wqmy	偩
wgkl	偪
wtff	偫
wdmd	偭
wkbg	偮
wyke	偯
wdhd	偰
wrfh	偱
wlny	偲
wmdj	偳
wmjh	側
whmy	偵
wwgb	偸
whtl	偹
wthj	偺
whvh	偼
wyto	偽
wehc	傁
wrhw	傂
wgxi	傃
wduh	傄
wdri	傆
wabg	傇
wdff	傉
wkmy	傊
wamf	傋
wcoy	傌
wfhw	傎
wovk	傏
wykk	傐
wqas	傑
wexd	傒
wynn	傓
wuvo	傔
wpwy	傕
wwyk	傖
wyxl	傗
wwwf	傘
wath	備
wywt	傚
wpwk	傛
werm	傜
wjng	傝
wuga	傞
wwcn	傟
wyfy	傠
wuug	傡
wpge	傢
wfly	傤
wmeg	傦
wcce	傪
wlxi	傫
wovh	傭
wgmj	傮
wtln	傯
wmee	傰
wtwh	傱
wgjf	傳
wakk	傴
wgmy	債
wdhy	傶
wtjr	傷
wdrr	傸
wujq	傹
wakw	傼
wujf	傽
wxdm	傾
wgho	傿
waqh	僀
wton	僁
wlvg	僂
waqh	僃
wsfi	僄
wakg	僅
wlpy	僆
wnwe	僇
wjlc	僈
wgkw	僉
wsdn	僊
wwym	僋
wlty	僌
wtge	働
wnnw	僎
wugk	僐
wtdk	僑
wpwk	僒
wkhm	僓
wusf	僔
wogw	僕
wooe	僗
wimt	僘
wamw	僙
wadw	僛
wwgu	僜
wnbb	僝
weto	僞
wxxy	僟
wtol	僠
wgjn	僡
weph	僢
wfwj	僣
wkkl	僤
wffq	僥
wfam	僨
wueg	僩
wcnk	僪
wgfn	僫
woqh	僯
gmiw	僰
wyny	僱
wsqh	僲
wujg	僴
wxg	僶
waas	僷
wssi	僸
wsmy	價
wkks	僺
wmau	僼
wton	僽
wept	僾
wpaf	僿
wugy	儀
wwym	儁
wmae	儂
wylg	儃
wujn	億
wipl	儅
wwgj	儈
wwgw	儉
wssh	儊
wryt	儌
wobt	儍
wfly	儎
whqo	儏
wpgm	儐
wjxo	儑
wfkf	儓
wfnf	儔
wyuj	儕
wahl	儖
wxth	儗
wvhl	儘
wkhp	儙
walq	儚
wrlh	儛
wpns	儜
woos	儝
wgwr	儞
wipm	償
wvln	儠
whan	儢
woaw	儣
wjai	儤
wflm	儥
wono	儦
wfwm	儧
wrrm	儨
wmjr	儩
wdet	優
wyke	儫
wgeq	儬
wusq	儭
wdth	儮
wudo	儯
waeo	儰
wued	儱
wyfj	儲
wqky	儳
wyke	儴
whto	儵
wmwk	儶
wgmx	儷
wlxy	儸
wtfm	儹
waky	儺
wipo	儻
wkkt	儼
wlli	儽
wgke	儾
aqv	兂
rbqb	兇
wcqb	兊
wkqb	兌
tkqy	兎
dhgq	兏
hjqb	児
eqb	兒
aqaq	兓
ywkq	兗
fqck	兘
dqfk	兙
dqtf	兛
dqwv	兝
dqtn	兞
tfqq	兟
ruxq	兠
dqdj	兡
dqdf	兣
igqw	兤
tynv	兦
mtyi	內
gmhy	兩
wgeb	兪
ubj	兯
gwu	兲
wvkx	兺
ulaw	兾
urvc	兿
mfd	冃
mfd	冄
mhgd	円
dmb	冇
mak	冊
mkd	冋
mnmb	冎
mwkd	冏
jef	冐
mef	冑
amff	冓
jkgf	冔
pqv	冘
pmj	冚
pegf	冝
pou	冞
prxb	冟
pfeu	冡
pbcu	冣
pfqc	冦
pssu	冧
pgkl	冨
peqo	冩
pajh	冪
duu	冭
uag	冮
uaht	冴
uugh	冸
udcy	冹
unna	冺
uwgk	冾
uvgh	冿
ugki	凁
uqkq	凂
uwgs	凃
uldg	凅
uevh	凈
ugeg	凊
ugji	凍
uqg	凎
usfg	凐
umgu	凒
ussy	凓
uwyk	凔
upjw	凕
uwyf	凖
umwy	凗
uadr	凘
ulff	凙
ussi	凚
uylt	凜
utao	凞
uflm	凟
twv	凢
hwv	凣
nwv	凥
twv	処
wmhk	凧
wfci	凨
wsi	凩
whd	凪
wgjd	凬
wdjd	凮
mgkw	凱
wuvo	凲
ucow	凴
fbk	凷
bkcb	凾
vyi	刄
vwi	刅
tnjh	刉
tdjh	刋
fjh	刌
rnjh	刏
myjh	刐
fqjh	刓
nwjh	刔
vvvr	刕
xjjh	刜
egjh	刞
vkjh	刟
nnaj	刡
wycj	刢
ckjh	刣
kqjh	別
fcjh	刦
fcvt	刧
majh	刪
fxyj	刬
gjgj	刯
fjvw	刱
ffjh	刲
bsjh	刴
bjh	刵
fcvy	刼
gudj	刾
gvaj	剄
gkuj	剅
yvcj	剆
mjh	則
kejh	剈
wwfj	剉
dqjk	剋
rsyj	剎
uavy	剏
ajjh	剒
tqtv	剓
hdhj	剕
aajh	剗
adwj	剘
uavw	剙
gkvj	剚
mumj	剛
xgij	剝
cccj	剟
ykij	剠
geyj	剢
wgkj	剣
yjjh	剤
djnj	剦
dhdj	剨
oacj	剫
mdmj	剬
ngcj	剭
mnmj	剮
tgaj	剰
wgky	剱
awgj	剳
mgkj	剴
wyvj	創
xgej	剶
uttj	剷
gjhj	剸
nwej	剹
fitv	剺
meej	剻
cccj	剼
akkj	剾
cnhj	劀
vflj	劃
twgj	劄
lqjj	劅
ouvj	劆
hagj	劇
qyvj	劉
wglj	劊
kkkj	劋
hdgj	劌
wgkj	劍
wgkv	劎
ipkj	劏
yuhj	劑
wgky	劒
wgky	劔
rrmj	劕
qkxj	劖
tfqj	劗
ossj	劘
xgej	劙
nilj	劚
enn	劜
ret	劤
ywet	劥
eeer	劦
ret	劧
rwet	劮
det	劯
ret	劰
iper	労
uder	劵
rgke	劶
uget	劷
ffet	劸
ywre	効
ctge	劺
aget	劻
fket	劼
gqje	劽
dqet	勀
gvae	勁
tfke	勂
txet	勄
gkie	勅
yvce	勆
cehe	勈
dqee	勊
udbe	勌
ykie	勍
fwfe	勎
uket	勏
swwe	勑
xxre	勓
dmje	勔
tgje	動
jege	勗
cnhe	務
anme	勚
kmet	勛
wcne	勜
eude	勝
oope	勞
nwee	勠
sfie	勡
fwfe	勢
gmet	勣
xkje	勥
vjse	勦
rwye	勧
qkee	勨
anme	勩
tdke	勪
tole	勫
udxe	勬
ujfe	勭
hage	勮
ylke	勯
ajme	勱
tgjo	勲
tgle	勳
hale	勴
daje	勵
tyce	勶
ykke	勷
akke	勸
qfd	勻
qvv	勼
qwi	勽
qri	匁
qxv	匂
qwnv	匃
qynv	匄
qqi	匇
qguf	匉
qoi	匊
qrmk	匋
qwgk	匌
qdjn	匎
qtmx	匑
qawk	匒
qvcc	匓
qtmk	匔
xvtr	匘
aqyi	匛
abv	匜
aad	匞
aywv	匟
aqre	匢
agyi	匤
acak	匥
adww	匧
anhf	匨
abhg	匩
aqrj	匫
awgj	匬
alvv	匭
aiwy	匯
akkl	匰
akhm	匱
adkk	匲
awgw	匳
atha	匴
aflm	匵
aawe	匶
ahhy	匷
agn	匸
awgk	匼
ajvd	匽
akkk	區
nfk	卂
aghh	卄
vfj	卆
faf	卋
glk	卌
nhgh	卍
nghg	卐
feee	協
ilj	単
adwf	卙
yxxf	卛
hghg	卝
hlry	卥
hmnk	卨
byi	卪
qbh	卬
abh	卭
vkbh	卲
qqbh	卶
tlbh	卹
wwkb	卻
gqqb	卼
rxbh	卽
kkfb	卾
swib	厀
wgsb	厁
qdr	厃
dtav	厇
dfk	厈
daht	厊
dqay	厎
dthf	厏
ddxy	厐
dkxv	厑
drmk	厒
dffd	厓
dgcf	厔
ddny	厖
dufk	厗
dlk	厙
dkrk	厛
dtfg	厜
dhdd	厞
dmjk	厠
drii	厡
dtti	厤
dfhw	厧
dakg	厪
dgqt	厫
djtk	厬
djey	厭
dssy	厯
dimt	厰
dwgw	厱
dajy	厲
idnt	厳
djel	厴
drii	厵
dcu	厷
ccy	厸
vcu	厹
dcu	厺
ciu	厼
cccu	厽
nfci	厾
gmcu	叀
ccce	參
cccd	叄
cccn	叅
fcec	叆
fcvp	叇
nhcy	収
nhcu	叏
tdci	叐
cccu	叒
gkhc	叓
cccc	叕
nhfc	叚
pocu	叜
fcbc	叝
nfic	叞
hpgc	叡
oguc	叢
kvr	叧
vkf	叴
ktyy	叺
bkf	叾
kag	叿
ktfh	吀
ynkf	吂
kkg	吅
kbg	吇
kfy	吋
kbn	吔
ktfh	吘
koy	吙
kvtt	吚
knhf	吜
nkf	吢
kwjh	吤
kdhy	吥
kwxn	吪
kdcy	吰
kndu	吳
kmty	吶
knwy	吷
kwcy	吺
ktgh	吽
tgkf	吿
kqug	呁
ktkf	呂
bdf	呄
kyy	呅
ikf	呇
kngw	呉
kufh	呌
kfcy	呍
knyy	呎
ktah	呏
tdkf	呑
kty	呚
kynn	呝
kngk	呞
kyxy	呟
ksgg	呠
knna	呡
kxy	呣
kmfg	呥
kqay	呧
kfiy	呩
kkqn	呪
khkg	呫
klg	呬
kann	呭
kkwy	呮
kguf	呯
hxkf	呰
kqkg	呴
krwy	呹
kkgn	呺
kjgg	呾
kfcy	呿
kafg	咁
kwbn	咃
ukf	咅
kntt	咇
kxjh	咈
kmdy	咉
kty	咊
kckg	咍
krsh	咑
kgny	咓
kdag	咗
kdmh	咘
kpxn	咜
kgah	咞
kdjg	咟
kbf	咠
kbg	咡
kkfn	咢
kgcf	咥
kriy	咮
kqjg	咰
kudy	咲
kdfn	咵
ktdg	咶
kqiy	咷
kpvg	咹
kgjg	咺
mnmk	咼
kftx	咾
kmgk	哃
kqrb	哅
kdeg	哊
kfbn	哋
krhf	哖
ktgs	哘
kxwv	哛
ktfk	哠
kmu	員
kgah	哢
kgku	哣
kdny	哤
kkhy	哫
kwsk	哬
khqn	哯
kptg	哰
kfpb	哱
kyve	哴
kkej	哵
khgf	哶
kefy	哷
kevg	哸
kebg	哹
kjfh	哻
kukq	哾
ktbt	唀
kwwk	唂
kqeh	唃
kmy	唄
kwyk	唅
kkcn	唈
kdww	唊
kwgs	唋
kthp	唌
kpfq	唍
ktjh	唎
ksgg	唒
klh	唓
krfh	唕
kgkg	唖
kfhy	唗
dckf	唘
kqto	唙
kvpc	唚
gskx	唜
kamy	唝
kruf	唞
fckx	唟
kgmw	唡
kuwc	唥
kiit	唦
kbeg	唨
ktvg	唩
kqg	唫
kadw	唭
keqn	唲
kufq	唴
kdjn	唵
kajg	唶
kwyn	唸
kywu	唹
kmaw	唺
ksww	唻
ksrh	唽
kdff	啀
kebn	啂
khjf	啅
yumd	啇
kfuf	啈
kesy	啋
kpwa	啌
kykb	啍
tfgk	啎
ukd	問
kgvh	啑
knbm	啒
yntk	啓
ynak	啔
kqeg	啗
kpqb	啘
hxkk	啙
kflk	啚
kgvv	啛
ktkg	啝
kgfg	啞
ynkt	啟
rrkf	啠
kgmy	啢
krhb	啣
kgeg	啨
kffh	啩
kftj	啫
klgy	啯
klqy	啰
kmdg	啱
krqy	啲
kudb	啳
kulh	啴
kndg	啹
kjgr	啺
kwga	啽
kadn	啿
kjug	喅
fkfk	喆
kkyh	喌
khxs	喍
kmnk	喎
kdeb	喐
kthj	喒
ksvg	喓
kdmd	喕
ksdg	喖
kplh	喗
kqmd	喚
kegc	喛
krxb	喞
ktgf	喠
knkh	喡
ktfe	喢
kqko	喣
krgg	喤
koac	喥
kkkm	喦
kykw	喨
kwgb	喩
fkke	喪
kdhd	喫
tdkk	喬
kute	喭
kklj	單
kdfa	喯
kwye	喰
kxqy	喲
kdgy	喴
ipkk	営
gehx	喸
kwti	喺
kqvn	喼
kkks	喿
fpgc	嗀
krhw	嗁
kerm	嗂
kykk	嗃
kwyk	嗆
fwwk	嗇
kvkc	嗈
kamy	嗊
keee	嗋
kcoy	嗎
kaws	嗏
kpdk	嗐
kdff	嗕
kmeg	嗗
kexd	嗘
kyuy	嗙
kwno	嗚
kuvo	嗛
kuxx	嗞
ebtk	嗠
kjlg	嗢
ekwa	嗧
kimy	嗩
fhkx	嗭
kjsg	嗮
kwld	嗰
kwgr	嗱
kufc	嗴
kjaf	嗶
gqtk	嗸
klpy	嗹
kmwy	嗺
koao	嗻
kajd	嗼
kwym	嗿
kknk	嘂
kovh	嘃
kwvs	嘄
kvcq	嘅
kakw	嘆
kcce	嘇
kmdf	嘊
kftt	嘋
klvg	嘍
knwe	嘐
khaf	嘑
kdhv	嘒
klag	嘓
kakk	嘔
kgho	嘕
kgmy	嘖
ipkj	嘗
kihv	嘙
ktjf	嘚
kswq	嘜
kqef	嘝
kdea	嘠
kipf	嘡
kjfh	嘢
kthh	嘥
kwsv	嘦
kvoj	嘨
kagf	嘩
klmy	嘪
kqdo	嘫
kooe	嘮
kvfj	嘯
kxxy	嘰
kkhm	嘳
kffq	嘵
kthf	嘷
krlo	嘸
ktdk	嘺
kklk	嘼
kkkl	嘽
ksjf	嘾
knnw	噀
kgfn	噁
kusf	噂
ktol	噃
kdhi	噄
keto	噅
kaqj	噆
kujf	噇
kyky	噈
knbt	噉
kcnk	噊
kykt	噋
kwgn	噏
kkak	噐
krif	噑
koqh	噒
khag	噓
etnk	噕
kggn	噖
kvaf	噚
khob	噛
kxxi	噝
kwgw	噞
owwk	噟
kfup	噠
kqdy	噡
klqj	噣
kmae	噥
khdy	噦
kajy	噧
kryt	噭
klge	噮
kept	噯
kyxy	噰
kwgj	噲
khad	噳
kfam	噴
uthk	噵
kujw	噷
kgbm	噸
kipl	噹
kusr	噺
fkug	噽
kpwj	噾
knyf	噿
kpns	嚀
knwy	嚁
kahl	嚂
klip	嚃
kawc	嚄
kfoo	嚇
kdjy	嚈
kogf	嚉
kthj	嚊
kfnf	嚋
kyuj	嚌
kvhl	嚍
kipj	嚐
ktgo	嚑
kosx	嚒
kfph	嚔
kqoj	嚕
kdhn	嚖
kjai	嚗
kdet	嚘
khbh	嚙
kkak	嚚
krxs	嚛
klff	嚜
koaw	嚝
fkfk	嚞
ktqi	嚟
kqyj	嚠
kakf	嚡
gkhe	嚢
kosr	嚤
kako	嚥
kdth	嚦
khal	嚧
kued	嚨
kxgf	嚩
kuqe	嚪
kusq	嚫
khhm	嚬
fkuk	嚭
xtyk	嚮
kosd	嚰
khaa	嚱
ykbl	嚲
errk	嚳
kkdt	嚴
kqky	嚵
kmmv	嚶
klfk	嚸
krmf	嚹
klup	嚺
kkdk	嚻
kgqm	嚽
kaky	嚾
kawe	嚿
klgf	囀
kbbb	囁
kkdk	囂
kywy	囃
kyry	囄
kkle	囅
kajj	囆
kgmx	囇
kafc	囈
klxy	囉
ktfm	囋
kaqt	囌
fkuk	囍
kmuj	囎
akfk	囏
khay	囐
knij	囑
kaui	囒
kdhb	囓
kahq	囕
ktly	囖
mnv	囘
mngd	囙
lci	囜
lfi	団
lywv	囥
lii	囦
mwmg	囧
ldhi	囨
lfci	囩
tlry	囪
mjdd	囬
lwxv	囮
lgd	囯
lfjk	囲
luri	図
lwfd	囶
lti	囷
lghd	囸
lnna	囻
lckd	囼
lwye	圀
lyd	圁
lgei	圂
cluf	圅
lwga	圇
lakg	國
lmdj	圌
lnkh	圍
lcmi	圎
ludn	圏
llye	圐
lgef	圑
lfke	園
lkmi	圓
lfcl	圔
lvfj	圕
lkfk	圖
lcfd	圗
lgjf	團
lwdd	圙
lkhm	圚
llff	圛
lyxx	圝
lyxs	圞
fnn	圠
fyi	圡
fsh	圢
fhy	圤
fqb	圥
ftyy	圦
dfd	圧
ftan	圫
tdfg	圱
ftfh	圲
fqyy	圴
fhgg	圵
dff	圶
fghy	圷
fmh	圸
jff	圼
fqrt	圽
fwjh	圿
fqan	坁
ffqn	坃
fwcy	坄
fwyn	坅
fty	坆
fpwn	坈
fgbn	坉
fwvt	坋
xxff	坒
fjff	坓
iff	坔
rhyf	坕
fqff	坖
fgxg	坘
gvff	坙
fugh	坢
ipff	坣
fegg	坥
fdg	坧
frcy	坬
fckg	坮
fmkg	坰
fmdy	坱
fxjh	坲
fwff	坴
frgg	坵
fqkg	坸
fpwy	坹
fdcy	坺
fwyc	坽
fpsh	坾
fwfy	坿
ftuf	垀
ftdy	垁
fhng	垇
wayf	垈
fqnn	垉
fnna	垊
fthg	垍
ftkg	垎
fvgh	垏
uqwf	垐
fqqy	垑
sff	垔
rgkf	垕
fwnn	垖
fqiy	垗
fwdy	垘
figq	垙
ffff	垚
fbsy	垜
fqdb	垝
fpta	垞
fugh	垟
fwgk	垥
fpfy	垨
fuah	垪
fawy	垬
fdpy	垯
fhgh	垰
fivg	垱
ftgs	垳
fpvg	垵
fufh	垶
fhqn	垷
fdtb	垹
febg	垺
fmy	垻
twcf	垼
irff	垽
fjfh	垾
foch	垿
tfuf	埀
fmwn	埁
ftdh	埄
byff	埅
fqeh	埆
fceh	埇
fcwt	埈
fdww	埉
miff	埊
fyve	埌
fkeg	埍
fvpc	埐
rrff	埑
fefy	埓
fawx	埖
fhht	埗
fmwk	埛
ssff	埜
fpgh	埞
fgfg	埡
fudb	埢
fywf	埣
fgeg	埥
fpqb	埦
fhwy	埧
fwga	埨
fqvh	埩
fpwa	埪
fimk	埫
fgji	埬
fooy	埮
fesy	埰
fhgc	埱
fdwg	埲
fqeg	埳
ftfg	埵
fwfy	埶
fufy	執
fykb	埻
fdsk	埼
bcff	埾
inxf	埿
fjsy	堁
yyff	堃
feqn	堄
ahnf	堅
fmum	堈
fyce	堉
gfgf	堊
fldg	堌
ffwt	堎
syff	堏
fdff	堐
fjxx	堒
fmdf	堓
fpws	堔
fvtr	堖
fpwy	堗
fudf	堘
fplh	堚
fgkl	堛
fgli	堜
fmnk	堝
fxge	堟
fwks	堢
fjmy	堣
cnhf	堥
fxxr	堦
fdmd	堧
fjqn	堨
fngg	堩
frbt	堫
fwgj	堬
frgg	堭
fkkn	堮
fffq	堯
fufc	報
vcbf	堲
fnhg	堳
fjgr	場
fdae	堶
fujg	堷
fwtj	堸
ftgf	堹
flwj	堺
ivgf	堻
ffff	堼
flgh	堽
fdwj	堾
fdgy	堿
fnua	塀
liff	塁
fawn	塂
fayk	塃
fwdc	塅
fyox	塆
fpgg	塇
vcaf	塈
fiwe	塉
frqc	塊
oopf	塋
fpwk	塎
fmgu	塏
fgxi	塐
fjff	塒
fpjw	塓
fwcn	塕
ftux	塖
iwgf	塗
fykk	塙
fpgy	塚
fssy	塛
fpfe	塜
fyuy	塝
agqf	塟
fwnp	塠
fxhw	塡
fwno	塢
ikgf	塣
fkmy	塤
blff	塦
fuwl	塧
fawn	塨
ftkl	塩
feeg	塪
fjlg	塭
ftmf	塮
fqyl	塯
itxf	塰
yvcf	塱
ftjr	塲
ftdp	塳
fmee	塴
onjf	塵
fonx	塶
fhlo	塷
fakk	塸
lrff	塹
ossf	塺
fajd	塻
fgjf	塼
fdrr	塽
flvg	塿
fsfi	墂
fdhy	墄
faqh	墆
fujf	墇
fade	墈
fuff	墊
fcce	墋
foao	墌
rxaf	墍
fykb	墎
nhdf	墏
fakg	墐
fyud	墑
fmwy	墔
fgho	墕
fwgl	墖
fulj	増
ffjn	墘
fnff	墛
buef	墜
fffq	墝
fkkl	墠
fugk	墡
fwxc	墢
fogw	墣
fkhm	墤
fujf	墥
ftol	墦
ftdk	墧
ykbf	墪
fusf	墫
bxgf	墬
fdnl	墭
bdaf	墮
ndaf	墯
fsjf	墰
fwgu	墱
frlo	墲
ffam	墳
famw	墴
fffc	墵
ffup	墶
fagf	墷
fafj	墸
fujg	墹
ftmd	墺
ffwk	墻
fryt	墽
evef	墾
flff	墿
fnkf	壀
nawf	壂
fglg	壃
scnf	壄
errf	壆
fylg	壇
fylt	壈
fhae	壉
ffle	壊
fipl	壋
fywe	壌
ilrf	壍
ftgo	壎
fahl	壏
gwmf	壐
fafl	壒
djef	壓
ffnf	壔
ffdj	壖
fvhl	壗
lllf	壘
foaw	壙
fhal	壚
fuqe	壛
fjfc	壜
fkhp	壝
fyle	壞
uegf	壟
fued	壠
hpgf	壡
fdth	壢
fbxg	壣
fdlf	壥
faky	壦
fkkt	壧
lllf	壨
ffae	壩
fyxx	壪
fbj	壭
nhdf	壯
fpxb	壱
fpqb	売
fkuf	壴
ffff	壵
fpkg	壷
fpgg	壸
fpfg	壺
fnhe	壻
fpgg	壼
fnaf	壽
fkun	壾
fusf	壿
fnkf	夀
flld	夁
bci	夃
tahj	夅
tdhj	夆
tou	夈
yotu	変
qyi	夊
cwtu	夋
fwtu	夌
wwft	夎
qmwt	夐
yoot	夑
dhht	夒
edht	夓
qbn	夗
qbh	夘
vqu	夛
qtgg	夝
qhkx	夞
qqqk	夠
qqfk	夡
alpq	夢
yclq	夣
adwq	夦
gnyi	夨
nwi	夬
djj	夰
dfj	夲
dff	夳
diu	夵
ddy	夶
dkf	夻
dfcu	夽
dwwi	夾
dcb	夿
dhdu	奀
dqay	奃
dqtb	奅
danf	奆
ffgy	奊
hkdu	奌
udjj	奍
qmwd	奐
dynw	奒
dqqu	奓
cdjn	奙
djef	奛
hdhd	奜
dmfk	奝
dwyf	奞
deef	奟
dhdj	奡
gdje	奣
ddmd	奤
cnhd	奦
tmtd	奧
uefd	奨
dakk	奩
dwyf	奪
dijg	奫
nhdd	奬
ddjj	奭
dwyl	奮
dhdy	奯
llld	奰
yxxd	奱
dftl	奲
vsh	奵
vtfh	奷
vqyy	奺
vvg	奻
vtan	奼
vmh	奾
vyvd	奿
nvg	妀
vag	妅
vpqn	妉
vfwy	妋
vfjh	妌
vwjh	妎
vyy	妏
vwcy	妐
vcn	妑
vywn	妔
vkhh	妕
vfcy	妘
vdhy	妚
bhgv	妛
vnwy	妜
nhdv	妝
jvf	妟
vmwy	妠
vrh	妡
vwvt	妢
vdhh	妦
vfqn	妧
vdg	妬
vdcy	妭
vthf	妰
vvkg	妱
vqiy	妳
qbvf	妴
vygg	妵
vyxy	妶
vrwy	妷
vskg	妸
vgsy	妺
vntt	妼
vjhh	妽
ekvf	妿
vty	姀
vqkg	姁
vtpy	姂
vghg	姃
vnna	姄
vugh	姅
wfvf	姇
vwyc	姈
vgmh	姉
vmfg	姌
vmah	姍
vmdy	姎
vafg	姏
hxvf	姕
vang	姖
vwtf	姙
vmgk	姛
vfkg	姞
vynw	姟
vtmk	姠
vtdg	姡
vceg	姢
vrgk	姤
vvvf	姦
vvfh	姧
vrhf	姩
vgcf	姪
vahh	姫
eeev	姭
vgjg	姮
vigq	姯
vqjg	姰
vdfn	姱
vpvg	姲
vqkg	姳
gqjv	姴
vwgh	姵
vwgk	姶
vdeg	姷
vgdf	姸
vtfq	姺
vqqy	姼
vqdb	姽
vwgg	姾
vadt	娀
vawy	娂
vhqn	娊
vieg	娋
vdny	娍
rrvf	娎
vdny	娏
vebg	娐
vtxy	娒
vdqn	娔
vgki	娕
vkhy	娖
vtfp	娗
vgva	娙
vlet	娚
vknd	娛
vdhk	娝
vevg	娞
vfny	娡
vwyk	娢
nhdv	娤
vrgw	娦
vukq	娧
vjfh	娨
vgkg	娪
vthp	娫
vfhy	娬
vctd	娭
vyg	娮
vknw	娯
vwnw	娰
vtjh	娳
vbcy	娵
vtfg	娷
vadw	娸
vxyx	娹
vccc	娺
vgji	娻
vviy	娽
vdff	娾
bskv	娿
lvf	婁
vrmh	婂
vpfi	婃
vukg	婄
vqoy	婅
vesy	婇
vfwt	婈
vhaw	婋
vhgc	婌
vdsk	婍
vwyg	婎
vqky	婏
vjsy	婐
vtvg	婑
vooy	婒
hdhv	婓
vhdd	婔
vgdn	婖
veqn	婗
vudb	婘
vqvh	婙
vyki	婛
ahnv	婜
vpgh	婝
vfuf	婞
vldg	婟
vphn	婠
vsww	婡
vjgg	婣
vmfk	婤
vhjf	婥
vvph	婦
vwga	婨
vmdf	婩
vjxx	婫
vetf	婬
vgfg	婭
vndg	婮
gmyv	婯
vmaw	婰
xyxv	婱
vawx	婲
vglb	婳
vjgr	婸
vsvg	婹
vfmf	婻
vadk	婼
vnhc	婽
vwgb	婾
vjmy	媀
vnkh	媁
vyuh	媂
vcns	媃
vugd	媄
vadn	媅
vdmd	媆
vusy	媇
vplh	媈
vngf	媉
vuej	媊
vdwj	媋
valg	媌
vqmy	媍
vftj	媎
vmdj	媏
ahkv	媐
vtgf	媑
vrgg	媓
vdmd	媔
vwga	媕
vamd	媖
vpgg	媗
vxxr	媘
vdgy	媙
vhmy	媜
tovf	媝
vjgh	媞
vans	媟
vdae	媠
vgli	媡
vjhg	媢
vivs	媣
vlny	媤
vyna	媥
vleg	媦
vmnk	媧
vusg	媨
vdeg	媩
vhvh	媫
vwks	媬
edmv	媭
vwgj	媮
vyto	媯
vqbt	媰
verm	媱
vfke	媴
vabg	媶
vdff	媷
vqyl	媹
vmgt	媺
tewv	媻
vlwl	媼
vcoy	媽
vrqc	媿
vdwt	嫀
vfhw	嫃
vdri	嫄
vuga	嫅
vpwk	嫆
vpjw	嫇
oopv	嫈
vgxi	嫊
vxuu	嫋
veeg	嫍
vyuy	嫎
vyvb	嫏
vlev	嫐
dhsv	嫑
vqmx	嫓
vatn	嫕
vakk	嫗
vyth	嫙
vjlc	嫚
atdv	嫛
vovi	嫝
vovh	嫞
vaak	嫟
fwhv	嫢
vakg	嫤
vgjf	嫥
vgmy	嫧
vakw	嫨
vnwe	嫪
voao	嫬
vhaf	嫭
vffn	嫮
gqtv	嫯
vgkw	嫰
voss	嫲
umiv	嫳
vduf	嫴
vrlo	嫵
vwyo	嫶
vbde	嫷
vugk	嫸
vamw	嫹
vueg	嫺
vusy	嫻
vlfo	嫼
vdui	嫽
voqh	嫾
vvfg	嫿
veto	嬀
vwgu	嬁
vujy	嬂
edmv	嬃
vfpu	嬄
vagf	嬅
vwgn	嬆
vkhm	嬇
vffq	嬈
akuv	嬊
vkkl	嬋
vtdk	嬌
vmgt	嬍
vqkg	嬎
vtol	嬏
vwgw	嬐
vujn	嬑
vwgj	嬒
vryt	嬓
vqkg	嬔
vlff	嬕
vuep	嬘
vfwk	嬙
vouo	嬚
vlge	嬛
ujqv	嬜
vwve	嬝
vatf	嬞
vugy	嬟
vkks	嬠
vept	嬡
vywe	嬢
vpns	嬣
vosx	嬤
vnwy	嬥
vfnf	嬦
vvhl	嬧
vuxn	嬨
vegw	嬩
vpgm	嬪
voos	嬫
vfdj	嬬
vgwr	嬭
djev	嬮
vfkf	嬯
mmvf	嬰
ilrv	嬱
vawc	嬳
vxrh	嬵
vthj	嬶
vptl	嬸
vemw	嬹
vaan	嬺
vflm	嬻
vqyj	嬼
vlhd	嬽
vgkm	嬾
vako	嬿
fkkv	孁
vtvl	孂
vyke	孃
vugi	孄
vwwg	孅
vmmv	孆
vwyc	孇
vmwk	孈
vaky	孉
vosd	孊
vgmx	孋
yxxv	孌
vkkt	孍
vnij	孎
vaui	孏
bgd	孒
bbg	孖
bnu	孞
ngkb	孠
bckg	孡
xebf	孧
bbbf	孨
btxi	孫
bmy	孭
bpfi	孮
ahnb	孯
bgfg	孲
bbbj	孴
yxyb	孶
fitb	孷
errb	學
nkub	孹
bvhl	孻
btwb	孼
bmmv	孾
yxxb	孿
pwb	宂
pxb	宆
pdyu	宊
pywu	宍
ptdu	宎
phng	宐
pfjj	宑
ptfn	宒
pygf	宔
pxcu	宖
pdwu	実
pahh	宧
pqiu	宨
pou	宩
pdny	宬
pvtk	宭
pktk	宮
pftb	宯
pwtf	宱
pksu	宲
ptou	宷
pkgk	宺
pcum	宻
pfqv	宼
pesu	寀
pgvh	寁
pqky	寃
pgef	寈
pwyf	寉
phmu	寊
pawb	寋
pnlf	寍
pnhw	寎
pqmd	寏
pwvc	寑
pjgh	寔
pdls	寕
pivc	寖
pntf	寗
pfhw	寘
prcy	寙
pgrm	寚
pahq	寛
pnlh	寜
plvf	寠
pnhc	寢
pnhy	寣
pxfm	實
pnls	寧
ptol	審
peto	寪
peqo	寫
pahy	寬
pgjn	寭
pwym	寯
pnhs	寱
pxth	寲
pgqm	寳
pusq	寴
pued	寵
pgrm	寶
pmdu	寷
efu	寽
yfy	対
akfy	尀
gmfu	専
gehf	尃
dqfi	尅
nhdf	將
gjhf	專
vakf	尋
fkuf	尌
oguf	對
uthf	導
iyu	尐
wiu	尒
tiu	尓
hgiu	尗
imkf	尙
iiiu	尛
duji	尞
jght	尟
adwt	尠
igqx	尡
wqb	尣
wqqy	尦
dney	尨
wqgd	尩
dngd	尪
gqgd	尫
faqb	尭
dnbs	尮
dnqb	尯
dntf	尰
dnuo	尲
dnme	尳
dnkm	尵
gqal	尶
dnal	尷
nmi	屃
npwi	屄
nfbk	屆
nld	屇
nkmh	屌
ngqx	屍
ndfe	屒
nmi	屓
rgnx	屔
nufk	屖
ntff	屗
ntfb	屘
nfi	屚
ntgf	屛
ntan	屜
nhdd	屝
nans	屟
nlvd	屢
nulj	層
ntas	屧
ntlv	屨
nttk	屩
npdi	屪
nnhk	屫
nilj	屬
nmmm	屭
ubtr	屰
tmj	屲
tymj	屳
mer	屴
mdr	屵
mvr	屶
mbt	屷
mag	屸
mvyy	屻
mgqn	屼
mfh	屽
mmh	屾
mmj	岀
mvyu	岃
meg	岄
mrcy	岅
mtdy	岆
mqbj	岇
mqrt	岉
cmj	岊
mbyy	岋
mwvt	岎
mfqn	岏
mwyn	岒
mrh	岓
mwjj	岕
mthf	岝
mthf	岞
mmdy	岟
mang	岠
mumk	岡
mpwy	岤
mhcy	岥
muf	岦
mvkf	岧
megg	岨
mxjj	岪
mpxn	岮
mdhg	岯
mxet	岰
mkqn	岲
mrgg	岴
mrg	岶
mvkg	岹
mwyc	岺
mqay	岻
mguf	岼
mhkg	岾
mmf	峀
mtuy	峂
ipmj	峃
mcah	峅
mwgk	峆
mwgk	峇
mtkg	峈
mtkf	峉
wnnm	峊
mgcf	峌
mvgh	峍
mveu	峎
mdmj	峏
mynw	峐
mwgf	峑
mgxw	峓
mftx	峔
myjf	峕
mpvg	峖
mqdb	峗
mgjg	峘
mdff	峚
mgqj	峛
mwhf	峜
mmgk	峝
mqdb	峞
mdef	峟
mhgh	峠
mgqj	峢
matq	峣
mywr	峧
mtry	峩
mahb	峫
mgey	峬
mvtk	峮
mtdh	峯
qtnm	峱
mtjj	峲
mwht	峳
mhqn	峴
mpdc	峵
wvgm	島
mufj	峷
mdny	峸
wgsm	峹
mgjr	峺
mtfk	峼
mdww	峽
irmj	峾
mgkg	峿
myve	崀
mfqw	崁
mwgg	崄
mqeh	崅
pfim	崈
mijg	崉
mssy	崊
mgaf	崋
mndg	崌
msww	崍
mqaj	崏
mjxx	崐
mjxx	崑
mywf	崒
mldg	崓
mdff	崕
mmum	崗
mwga	崘
mwga	崙
mfwt	崚
mtfg	崜
mgeg	崝
mqf	崟
mgji	崠
mbib	崡
mevh	崢
mtvf	崣
mrtf	崥
mgvh	崨
mywf	崪
mnbm	崫
mgji	崬
mqg	崯
mvlg	崰
mmjj	崱
mrgg	崲
mwgj	崳
mjgr	崵
mfff	崶
musg	崷
mdmy	崸
myuh	崹
mytb	崺
mtff	崻
mjgh	崼
mkkn	崿
msyg	嵀
madn	嵁
mtvg	嵂
mute	嵃
mugd	嵄
mdgy	嵅
tdnm	嵆
megc	嵈
myks	嵉
cnhm	嵍
mjmy	嵎
mrbt	嵏
mwtj	嵐
mjqn	嵑
kkkm	嵒
mkkk	嵓
mlge	嵔
mrbt	嵕
msjg	嵖
mdgy	嵗
mtuf	嵙
mqqw	嵚
mukh	嵜
wgsm	嵞
mdwy	嵟
mexd	嵠
mwcn	嵡
mwyk	嵢
movk	嵣
oopm	嵤
mqas	嵥
mmgu	嵦
mqyl	嵧
mwno	嵨
mykk	嵪
myuy	嵭
mfhw	嵮
muvo	嵰
mpwk	嵱
mths	嵲
muga	嵳
mjff	嵵
mxuu	嵶
mtwh	嵷
mtwh	嵸
mxkj	嵹
mnwe	嵺
movi	嵻
mutg	嵼
maqh	嵽
mcce	嵾
msdm	嵿
mffn	嶀
mlvg	嶁
mlrh	嶃
mlrj	嶄
gqtm	嶅
mgmj	嶆
makk	嶇
mnhf	嶈
mkwy	嶉
mrwy	嶊
mwvo	嶋
mwvo	嶌
mnrg	嶍
mnff	嶎
mdsn	嶏
mbtg	嶐
mqke	嶑
mulj	嶒
mtol	嶓
mqqw	嶔
mwyo	嶕
mwgn	嶖
mooe	嶗
msaa	嶘
mdui	嶚
mdui	嶛
maqj	嶜
bdam	嶞
musf	嶟
mtdk	嶠
mduw	嶡
mffq	嶢
mwyo	嶣
mffq	嶤
mduw	嶥
mqdy	嶦
mlff	嶧
errm	嶨
mmae	嶩
mogi	嶪
mogi	嶫
mugy	嶬
mwnf	嶭
mwgw	嶮
mkby	嶯
mqeg	嶰
majn	嶱
mwym	嶲
mgef	嶳
tmom	嶴
mlhd	嶵
mtmt	嶶
moos	嶸
mfnf	嶹
mwym	嶺
mfwy	嶻
megw	嶼
mqty	嶽
mean	嶾
mfdj	嶿
miwa	巀
mday	巁
mwyk	巂
mued	巃
mued	巄
mook	巆
mhaa	巇
mako	巈
mqky	巉
mmmv	巊
mwnh	巋
midt	巌
mdht	巎
maky	巏
myka	巐
mtfm	巑
yxxm	巒
mxhm	巓
mfhm	巔
muwv	巕
mkkt	巖
mkkt	巗
mhay	巘
mutt	巙
mhay	巚
bnn	巜
ynkb	巟
gvaf	巠
ijsu	巣
vlrn	巤
annb	巪
awfw	巬
aefw	巭
gvak	巰
rgcv	巵
vknn	巶
ahkn	巸
bign	巹
nngw	巺
udnb	巻
ckxb	巼
gmhk	巿
gmhk	帀
mhsh	帄
vmhk	帇
mhwv	帉
mhcn	帊
qamh	帋
ynmh	帍
mhpq	帎
wayh	帒
mhgs	帓
mhdy	帗
mhdj	帞
yomh	帟
emhj	帠
mhua	帡
mhwk	帢
udmh	帣
vkmh	帤
wnnh	帥
mhuq	帨
mhie	帩
mhde	帪
wnnh	師
vtkh	帬
gkgh	帯
ytvh	帰
mhtf	帲
mhde	帳
mhaa	帴
mhpb	帵
aqph	帶
mhuv	帹
mhaw	帺
mhfj	帾
mhwd	帿
mhhm	幀
mhdm	幁
mhnh	幃
mhjn	幆
fffh	幇
mhna	幈
mhas	幉
mham	幊
tewh	幋
mhee	幍
mhpw	幎
mhpe	幏
eudh	幐
tmtt	幑
mhtn	幒
mhce	幓
mhsi	幖
mhlg	幗
mhgm	幘
mhad	幙
dtbh	幚
mhji	幜
mhkl	幝
mhuy	幟
mhro	幠
umih	幣
imkh	幤
mhir	幥
nkuh	幦
mhks	幧
mhqy	幨
mhfm	幩
mhae	幪
fffh	幫
mhff	幬
mhay	幭
mhof	幮
mhtb	幯
mhpn	幰
mhui	幱
gdfh	幵
tgdf	幷
fjff	幹
xxdy	幾
osk	庁
owi	庂
oci	広
otci	庅
owyn	庈
ogbn	庉
oaht	庌
ork	庍
owjk	庎
ofyi	庒
olk	庘
ohxv	庛
otui	庝
oyei	庡
ogcf	庢
oqii	庣
offi	庤
oftb	庨
owgs	庩
orfc	庪
olk	庫
odny	庬
osgd	庮
ogey	庯
ouak	庰
ofwt	庱
osww	庲
oajd	庴
owcs	庺
oaww	庻
oxdm	庼
ojmy	庽
oald	庿
opoc	廀
omjk	廁
oshd	廂
owfq	廃
ovcc	廄
ofcl	廅
orqc	廆
oqyl	廇
odht	廈
oehc	廋
onjo	廌
oukb	廍
oxdm	廎
orxc	廏
orxq	廐
olvd	廔
obwc	廕
oaqh	廗
oonx	廘
olaw	廙
ofkf	廚
onfj	廜
oadr	廝
oqqw	廞
ofje	廟
oimt	廠
orlo	廡
owxc	廢
oamw	廣
olkx	廤
owgj	廥
onkf	廦
ofwk	廧
oylt	廩
oene	廫
ohal	廬
otgm	廭
ommv	廮
oqog	廯
obfn	廰
ovky	廱
ogmx	廲
obgn	廳
vpv	廵
mpd	廸
rpd	廹
lkpd	廻
spd	廼
mjdp	廽
wvaj	弅
fcaj	弆
wgka	弇
nhda	弉
agyi	弌
afyi	弍
adyi	弎
ffny	弐
rsyy	弒
xhk	弔
xgf	弖
xgfh	弙
uxhj	弚
xxn	弜
xcn	弝
xqwy	弞
xang	弡
xbhc	弢
xwfy	弣
xqay	弤
xvkg	弨
xahh	弫
xahh	弬
udxb	弮
xieg	弰
xkeg	弲
xgva	弳
xykb	弴
xdey	張
xyki	弶
xcjy	強
xeeg	弸
xgmx	弻
xans	弽
xilh	弾
pawx	弿
xskk	彁
ogxd	彂
xjaf	彃
xakk	彄
xuev	彅
umix	彆
xvfj	彇
xkkl	彈
xamw	彉
xglg	彊
xlge	彋
xgwr	彌
xoaw	彍
yxxx	彎
xhhc	彏
xgd	彑
xgiu	彔
xgps	彙
vpjs	彚
vowa	彛
xgoa	彜
voxa	彞
vfac	彟
vakc	彠
yee	彣
yder	彥
akgy	彧
gmye	彨
mfke	彫
pwwe	彮
sfie	彯
gmye	彲
tqyy	彴
tbn	彵
tbyy	彶
twcy	彸
tgg	彺
tqay	彽
twyc	彾
txjh	彿
ttgg	徃
tsg	徆
tffg	徍
tkgg	徎
thht	徏
tgva	徑
tuhy	従
tapy	徔
tpfi	徖
tgli	徚
tdsk	徛
tfhg	徝
twwh	從
tmfk	徟
tsww	徠
tgvh	徢
tajg	徣
tvgp	徤
tjgh	徥
tnhc	徦
tyna	徧
ttjt	復
tnkh	徫
tyuy	徬
texd	徯
tghh	徰
tsfi	徱
tnig	徲
tfln	徳
tmgt	徴
tumt	徶
tujf	徸
tyct	徹
tffq	徺
twgj	徻
tmyt	徾
tued	徿
tyke	忀
tjbi	忁
thhy	忂
net	忇
fnu	忈
nsh	忊
nnn	忋
tfnu	忎
nfh	忓
ntnn	忔
ndy	忕
nbn	忚
nwyy	忛
oni	応
ynu	忞
nyy	忟
gnu	忢
nbyy	忣
rnnu	忥
nwjh	忦
nfqn	忨
wcnu	忩
ncnh	忬
nqan	忯
nvfh	忰
ndyy	忲
ngbn	忳
nwyn	忴
nfcy	忶
nrbh	忷
ngg	忹
nqwy	忺
nywn	忼
nang	怇
nann	怈
nqnn	怉
nnna	怋
ndhg	怌
nqkg	怐
nugh	怑
nvcy	怓
nhkg	怗
dnu	怘
negg	怚
nmg	怞
nqay	怟
nrwy	怢
rwnu	怣
wfnu	怤
nlg	怬
nntt	怭
nxet	怮
nyxy	怰
qryn	怱
ngmw	怲
nkqn	怳
ngny	怴
nhcy	怶
fqyn	怷
synu	怸
wbnu	怹
nyni	怺
nfiy	怽
nkwy	怾
nqqy	恀
nfkg	恄
nftx	恅
nghg	恆
nagg	恇
nctg	恈
nxjg	恉
neee	恊
nqiy	恌
ngcf	恎
vbnu	恏
nqdb	恑
nsg	恓
nywr	恔
tlrn	恖
ndfn	恗
nwsy	恘
nlkg	恛
naay	恜
ngxw	恞
nqrb	恟
ndhf	恠
nrdc	恡
bny	恥
ntmk	恦
nwgg	恮
nwcq	恱
nuah	恲
yjnu	恴
gmnu	恵
wsnu	恷
nayn	恾
nceh	悀
nkeg	悁
nxxf	悂
nwkq	悅
wgsn	悆
nwgs	悇
naah	悈
rrnu	悊
nykg	悋
ntfk	悎
ndww	悏
qton	悐
ngey	悑
nhqn	悓
nrdh	悕
nqkq	悗
atdn	悘
nykb	悙
nkgg	悜
nknd	悞
tjnu	悡
nyve	悢
tlqn	悤
ynu	悥
ntjh	悧
nirb	悩
gkjn	悪
nkgd	悮
npfi	悰
fhnn	悳
ndey	悵
uni	悶
nyny	悷
phnn	悹
nphn	悺
ngvv	悽
npwa	悾
ngdn	悿
nwga	惀
srnu	惁
nqeg	惂
njxx	惃
hgin	惄
nykb	惇
njsy	惈
ihkn	惉
pqbn	惌
nqg	惍
adwn	惎
nssy	惏
nakg	惐
tknu	惒
nudb	惓
nooy	惔
jqrn	惖
nwyn	惗
nccc	惙
nqaj	惛
nrqw	惞
gfgn	惡
nnnu	惢
tqrn	惣
nxyx	惤
ewnu	惥
fhnu	惪
nvtr	惱
nplh	惲
nans	惵
dwjn	惷
nqjb	惸
nmjh	惻
nyna	惼
nnaj	惽
nrbt	惾
njgh	惿
fpbn	愂
npgg	愃
nlge	愄
nakf	愅
nnkh	愇
ngkl	愊
negc	愋
nqmd	愌
ndmd	愐
ncee	愑
njqn	愒
njgr	愓
nujg	愔
nadn	愖
cnhn	愗
nptk	愘
ptkn	愙
epnt	愛
nadw	愜
najv	愝
ndmd	愞
nqrn	愡
nlny	愢
namd	愥
fpgn	愨
namy	愩
nkmy	愪
ubtn	愬
nftj	愭
nerm	愮
nwyc	愯
njiq	愰
nutd	愱
nmeg	愲
hhnu	愳
nwyk	愴
nxuu	愵
neee	愶
nmgu	愷
swwn	愸
npwk	愹
najf	愺
btxn	愻
nxhw	愼
ngef	愽
nrno	愾
nexd	慀
lgen	慁
icen	慂
nwcn	慃
nssy	慄
ncyj	慅
neeg	慆
rvnn	慇
nyxl	慉
cexn	態
nlwl	慍
npjw	慏
amnu	慐
ngmj	慒
nsfi	慓
najd	慔
nlag	慖
gkin	慗
ncce	慘
lrnu	慙
nlrh	慚
nmwy	慛
txtn	慜
nujf	慞
ntge	慟
ngqt	慠
ndrr	慡
nxfm	慣
fpwn	慤
ntfp	慥
giyn	慦
nlpy	慩
nakk	慪
twwn	慫
nakg	慬
godn	慭
haln	慮
ntjr	慯
ngjf	慱
namy	慲
nahf	慳
nnrg	慴
onjt	慶
aqpn	慸
fufn	慹
nlvg	慺
nudh	慻
dhgn	慼
ndhy	慽
wwkn	慾
ucan	慿
nnwe	憀
ntln	憁
dept	憂
dwen	憃
tfhn	憄
tgjn	憅
nipf	憆
tdan	憇
nhag	憈
nfke	憉
watn	憊
qqun	憌
ntdk	憍
nwfi	憏
noqh	憐
ucon	憑
nkhm	憒
ngjn	憓
nwgu	憕
swwn	憖
swwn	憗
nfkk	憘
fkun	憙
nkkl	憚
nsjf	憛
nbde	憜
nykt	憞
nsoy	憟
dubn	憠
ntgi	憡
nffq	憢
ntol	憣
nfam	憤
oopn	憥
nooe	憦
nueg	憪
nuyy	憫
ndui	憭
nrlo	憮
naqj	憯
ncnk	憰
nyky	憱
pgln	憲
nvaf	憳
nxg	憴
nkun	憵
nujn	憶
nwgw	憸
nmae	憹
nqdy	憺
nylg	憻
aqkn	憼
naqn	憽
nryt	憿
nwgj	懀
nlge	懁
akgn	懃
nake	懄
nhae	懅
nkks	懆
even	懇
owwn	應
nlff	懌
nylt	懍
nfwk	懎
nwym	懏
nyle	懐
nept	懓
djen	懕
qtdn	懖
nfoo	懗
iaqn	懘
negw	懙
nean	懚
nfkf	懛
nalq	懜
nxth	懝
nape	懞
ogun	懟
nyuj	懠
nosc	懡
nahl	懢
iamn	懣
nfnf	懤
nfph	懥
npns	懧
ndjy	懨
nufe	懩
njai	懪
nrrm	懫
oamn	懬
noaw	懭
ndet	懮
gehn	懯
nqyj	懰
naly	懱
tmgn	懲
ndhn	懳
nfhy	懴
ngkm	懶
nyle	懷
hitn	懸
nyke	懹
nwwg	懺
nuxw	懻
nhhy	懼
naky	懽
nbbb	懾
yxxn	戀
akfn	戁
nosd	戂
nipo	戃
nhhc	戄
ujfn	戅
ujfn	戇
gnxy	戉
akd	戓
aau	戔
mgka	戙
akgd	戜
may	戝
depa	戞
ujxy	戠
wgda	戣
ilay	戦
wyva	戧
sksa	戨
gcca	戩
deag	戫
pgma	戭
haoa	戯
kkla	戰
haja	戱
haga	戲
hhwa	戵
rnd	戶
gnr	戸
ynnv	戹
ynnn	戺
yndi	戻
nagn	戼
ynhk	扂
yntk	扄
ynqq	扅
ynye	扆
ynoo	扊
rvn	扏
ret	扐
rcy	払
rtyy	扖
rfg	扗
rdyy	扙
rqyy	扚
rgfh	扜
rfnn	扝
rfh	扞
rnfh	扟
rcyy	扠
rbn	扡
rtnn	扢
rgqn	扤
rtan	扥
rvyy	扨
rbyy	扱
rwyn	扲
rwjh	扴
rwuy	扵
rtdy	扷
rthn	扸
rqan	扺
rqwy	扻
rgbn	扽
rcqn	抁
rgg	抂
ryhy	抃
rqcy	抅
ryy	抆
rjg	抇
reg	抈
rny	抋
rpqn	抌
rtah	抍
rfcy	抎
rfqn	抏
rmwy	抐
rdhy	抔
rrh	抙
rdcy	抜
rxnn	抝
rnyy	択
rqug	抣
rgmw	抦
rkwy	抧
rmfg	抩
rdmh	抪
rpwn	抭
rwet	抮
regg	抯
rmdy	抰
rskg	抲
rnxn	抳
rann	抴
rrwy	抶
rdhg	抷
rtpy	抸
rfiy	抺
rfcy	抾
rkqn	拀
rekg	拁
rthf	拃
rdne	拋
vcrj	拏
rafg	拑
rpxn	拕
rdfh	拝
rrgg	拞
rtwn	拠
rocy	拡
rhgh	拤
rsg	拪
rvey	拫
rwtf	拰
awrj	拲
rdhb	拵
rqqy	拸
reee	拹
rgmi	拺
rdoy	拻
rrey	挀
rgcf	挃
rigq	挄
rbsy	挅
rwsy	挆
rhgh	挊
rahh	挋
rtkg	挌
rywr	挍
rmgk	挏
vkrj	挐
rgqj	挒
rpta	挓
ryey	挔
rbg	挕
rgxw	挗
rite	挘
igwr	挙
rgog	挜
rvfy	挦
rng	挧
rwkq	挩
rfpb	挬
rgjr	挭
ruxt	挮
rkgg	挰
riit	挱
rgva	挳
rtxy	挴
rgah	挵
rnnk	挶
rdtb	挷
rhqn	挸
rthp	挻
revg	挼
rdww	挾
rtgh	挿
rtdh	捀
rtfk	捁
rgiy	捄
rfoy	捇
rwgs	捈
rebg	捊
rjgy	捑
rgki	捒
rahb	捓
rqeh	捔
rpfq	捖
rhht	捗
rcwt	捘
rlh	捙
rjfg	捚
rkkg	捛
rjhc	捜
rukq	捝
rrgw	捠
rntn	捤
rpqb	捥
rqg	捦
rwfk	捨
rqaj	捪
rug	捫
rowf	捬
rgcj	捯
rjsy	捰
rudb	捲
rrgm	捳
rwcn	捴
rmaw	捵
rviy	捸
rdfa	捹
rtvg	捼
rywf	捽
rphn	捾
rgvv	捿
rdey	掁
rvph	掃
rwga	掄
rgeg	掅
rmum	掆
roqy	掋
rjxx	掍
radw	掑
rhgc	掓
ahnr	掔
rfwt	掕
rgfg	掗
revh	掙
rgmy	掚
rffh	掛
reqn	掜
rakg	掝
rooy	掞
rpgh	掟
resy	採
reeg	掤
rjqr	掦
rbcy	掫
rheg	掯
rrrj	掱
rjqx	掲
rwgb	掵
rovw	掶
rblg	掹
rcjy	掻
ruog	掽
radk	掿
rgli	揀
rhmy	揁
rusg	揂
ruej	揃
dgar	揅
rfmf	揇
rqyg	揈
rgkl	揊
rlge	揋
rlny	揌
reag	揑
rytb	揓
rqrn	揔
radn	揕
rrfh	揗
rrgg	揘
ryna	揙
rjgr	揚
rqmd	換
rwga	揜
rthj	揝
rnhe	揟
rptk	揢
rvcb	揤
ryuh	揥
rgkj	揦
gkir	揧
ryks	揨
torj	揫
rpwy	揬
rplh	揮
rngg	揯
rtgf	揰
iejr	揱
rdhd	揳
rvgp	揵
rtgh	揷
ruxe	揹
refb	揺
rdgy	揻
rdiy	揼
rjlg	揾
rukn	搃
rngg	搄
ramf	搆
rwye	搇
rpwk	搈
rpwy	搉
rqbt	搊
rkmy	損
rbti	搎
rabg	搑
ryuy	搒
rfcl	搕
rqrm	搖
rwvm	搗
rftj	搘
rdff	搙
reee	搚
rthy	搝
rlfh	搟
rgoj	搢
rdgy	搣
ruwl	搤
rwnp	搥
rynn	搧
rjng	搨
rqas	搩
tewr	搫
rssy	搮
reeg	搯
rmeg	搰
rnuf	搱
rpwy	搲
rpdk	搳
rlwl	搵
rwyk	搶
rfhw	搷
rdwt	搸
rgkh	搹
wgkr	搻
rudr	搼
rpwf	搾
rwno	摀
rbiy	摂
ramy	摃
rpwq	摉
rrsc	摋
rutg	摌
rpwj	摍
rnwe	摎
rdwe	摏
rtwh	摐
rlag	摑
rtdp	摓
raqh	摕
rwfi	摖
rgkw	摗
rlpy	摙
ripf	摚
ryrc	摛
rxfm	摜
ronx	摝
rlvg	摟
rtln	摠
rvcq	摡
rhaf	摢
rhag	摣
rdrr	摤
rtjr	摥
rdfy	摦
rnig	摨
rnhf	摪
rfwq	摫
rujq	摬
gqtr	摮
fufr	摯
fwfr	摰
rjlc	摱
rlrh	摲
rakk	摳
rffn	摴
rdhy	摵
rgjf	摶
rvjs	摷
rcce	摻
rahf	摼
rsfi	摽
rxkj	摾
rwuj	摿
fnwr	撀
ryxg	撁
lwcr	撃
umir	撆
rooe	撈
ykbr	撉
rueg	撊
rugg	撋
rkhm	撌
raqj	撍
rfpu	撎
rvaf	撏
ript	撐
rffq	撓
rjyi	撔
ramw	撗
rtwk	撘
rqdo	撚
roqh	撛
rwgu	撜
reto	撝
rtdk	撟
rfja	撠
rccn	撡
rsjf	撢
rkkl	撣
rwxc	撥
rdfj	撦
rxqc	撧
rwyo	撨
rcdl	撪
rrlo	撫
rugh	撯
rbde	撱
rogw	撲
rqqw	撳
rykt	撴
ragf	撶
ripq	撹
rfup	撻
rryt	撽
rmnp	撾
rwgw	撿
ryxy	擁
rmae	擃
rhae	擄
rafj	擆
rlff	擇
rogi	擈
rlqj	擉
lbwr	擊
ripl	擋
rtdw	擌
raqt	擏
rkby	擑
raiy	擓
rqdy	擔
rwym	擕
rajn	擖
rtmd	擙
rhae	據
raas	擛
rfmy	擜
rjel	擝
rgwr	擟
ryuj	擠
rfkf	擡
rfnf	擣
ahnr	擥
egnr	擧
rrhw	擨
rfdj	擩
djer	擪
rdjy	擫
rxth	擬
rawc	擭
rfwy	擮
rpgm	擯
rpns	擰
rutk	擱
rusb	擲
rtvb	擳
roaw	擴
rosr	擵
rtuj	擶
rfkm	擷
rvln	擸
rakw	擹
rlcx	擺
rlvt	擻
rqoj	擼
rrxs	擽
rdet	擾
ryup	擿
rufe	攁
rlll	攂
rawi	攃
rhan	攄
rfwm	攅
rfwl	攆
rpdn	攇
ront	攈
rdth	攊
rgkm	攋
rlle	攌
ryny	攍
rhal	攎
rued	攏
rpae	攐
regg	攑
rpah	攓
rugi	攔
rwwg	攕
rmmv	攖
rono	攗
rqky	攙
rook	攚
rpwn	攛
rmwk	攜
rbbb	攝
rlxy	攞
ront	攟
rosd	攠
ryry	攡
rtfm	攢
yxxr	攣
raky	攤
rgmx	攦
rfhm	攧
rpwy	攨
ripo	攩
rerq	攪
rahq	攬
rxgj	攭
fcee	攰
ufcy	攱
dskc	攲
fcvf	攳
gnty	攷
nnty	攺
fty	攼
wvty	攽
rty	敀
hkhc	敁
qkty	敂
nnat	敃
cnht	敄
wgkc	敆
gmit	敇
hgic	敊
tkty	敋
wgsc	敍
rdbt	敎
dfet	敐
wjht	敒
wkqt	敓
gkty	敔
mty	敗
wgst	敘
ukqt	敚
wynt	敜
mawt	敟
cccc	敠
jqrc	敡
jshc	敤
oohc	敥
dskc	敧
ukty	敨
ipbt	敩
ccct	敪
jgqt	敭
tfec	敮
najc	敯
mgkc	敱
mgkt	敳
yumt	敵
bgjt	敶
lvty	數
hptt	敹
akkc	敺
qmwt	敻
fkuc	敼
tdkc	敽
ugut	敾
tdkt	敿
lqjc	斀
lfut	斁
wgkt	斂
umix	斃
fitw	斄
errc	斅
errt	斆
ybf	斈
yjf	斉
ybf	斊
yhqb	斍
yjfi	斎
yyve	斏
yyna	斒
yjew	斔
yugi	斕
yemg	斖
qufh	斘
ccpf	斚
kkpf	斝
ewuf	斞
amff	斠
amwf	斢
lqjf	斣
rrh	斦
nhdr	斨
qkrh	斪
lrh	斬
ajrh	斮
ftjr	斱
nngr	斲
akgr	斳
oqar	斴
qyvr	斵
rlqj	斶
xxgr	斷
nilr	斸
ywjh	斺
ytwn	斻
ytmh	斾
ytbg	斿
yciy	旀
ytrh	旂
ythc	旇
yyck	旈
gehy	旉
yrny	旊
ytwc	旍
ytqi	旐
ydsk	旑
ytie	旓
yvgp	旔
ywux	旕
yujy	旘
ytol	旙
ytsi	旚
yttl	旛
ytyg	旜
ytwj	旝
ytup	旞
ytew	旟
aqv	旡
rxaq	旣
mnmq	旤
jfh	旪
jvt	旫
jdu	旲
jqyy	旳
jgfh	旴
jmj	旵
jnrt	旸
bhgj	旹
jyu	旻
jyy	旼
jgbn	旽
gbnj	旾
jtfh	旿
jgmh	昁
jrcy	昄
jbyy	昅
jtaj	昇
jynt	昈
jyt	昉
gdjf	昋
jjg	昍
jwvt	昐
jwyn	昑
jqrt	昒
jwcy	昖
jywu	昗
jyr	昘
dujf	昚
jang	昛
jgqr	昜
jgmw	昞
jyxy	昡
jbmh	昢
jwet	昣
jwyc	昤
jdjj	昦
jgsy	昩
jcaj	昪
jqkg	昫
najf	昬
jaer	昮
jghf	昰
jxjh	昲
jrwy	昳
jlf	昷
jtuy	昸
jyni	昹
jgmw	昺
jabj	昻
jdxy	昽
jocy	昿
jqiy	晀
jffy	時
jigq	晄
jgjg	晅
jffg	晆
jdfn	晇
jywr	晈
gccj	晉
jgcf	晊
jmgk	晍
jawy	晎
jynw	晐
jtmk	晑
jjfh	晘
jcwt	晙
jhqn	晛
juxt	晜
vfjg	晝
jrdh	晞
jdny	晠
rrjf	晢
jrrh	晣
jpfq	晥
jtfk	晧
jqkq	晩
jmaw	晪
jhjf	晫
jywf	晬
jmfk	晭
jooy	晱
jeqn	晲
srjf	晳
yntj	晵
jght	晸
jjqr	晹
jdjn	晻
jpqb	晼
jssy	晽
jjjg	晿
jtyg	暀
jfaq	暁
jhdd	暃
jngg	暅
jytb	暆
jplj	暈
jplh	暉
jdmy	暊
nnaj	暋
jjqn	暍
jamd	暎
jftj	暏
jnkh	暐
jjtg	暒
cnhj	暓
jfmf	暔
jgli	暕
jjgr	暘
jdwj	暙
jerm	暚
juga	暛
uujf	暜
jths	暞
jmgu	暟
jykk	暠
jwcn	暡
jhjr	暢
jrno	暣
jrdf	暤
jjpv	暥
dssj	暦
jwfi	暩
jamy	暪
lrjf	暫
fwfj	暬
jrif	暭
jajd	暯
jtwh	暰
jaak	暱
jujf	暲
jdhv	暳
jakw	暵
jyth	暶
jgjf	暷
jdui	暸
jkkl	暺
jjyi	暻
umij	暼
joqh	暽
jfkk	暿
jfpu	曀
rxag	曁
jamw	曂
jvip	曃
jagf	曄
jagg	曅
dttj	曆
jffc	曇
jujf	曈
jffq	曉
jxjm	曊
jsjf	曋
jepa	曌
jthf	曍
jlff	曎
jxtb	曏
jjjg	曐
jjje	曑
jryt	曒
jbmf	曓
jaqt	曔
jqdy	曕
jept	曖
jogi	曗
jfdj	曘
jape	曚
jday	曞
jjje	曟
joaw	曠
jjjg	曡
jpdi	曢
jako	曣
jfwy	曤
jhal	曥
jgkj	曧
jued	曨
jlxy	曪
yxxj	曫
jgmx	曬
jipo	曭
jkkt	曮
jnij	曯
jhk	曱
jxyi	曵
qrjf	曶
vfjf	書
gmjf	曺
jqah	曻
uljf	曽
aqaj	朁
jber	朂
wglj	會
jhgi	朄
fcjn	朅
uljr	朆
wglf	朇
ewvt	朌
ewyc	朎
ebmh	朏
muan	朑
emww	朒
eqiy	朓
eyve	朖
ecwt	朘
mwme	朙
ynje	朚
eykb	朜
adwe	朞
eamd	朠
erbt	朡
ahng	朢
eujf	朣
eeee	朤
muoe	朥
eued	朧
sghy	朩
fqyi	朮
snb	朰
swy	朲
swy	朳
bsu	朶
svt	朷
set	朸
svn	朹
snhh	朻
sxn	朼
ssh	朾
gmii	朿
styy	杁
stfh	杄
sgfh	杅
sfnn	杇
skh	杊
swyy	杋
sbg	杍
svyy	杒
stan	杔
sdy	杕
ynsu	杗
nsi	杘
sayy	杙
stnn	杚
sxn	杛
sbn	杝
saf	杢
smh	杣
sgqt	杤
sqyy	杦
synn	杧
shg	杫
sfqn	杬
sgmh	杮
gjii	東
sqwy	杴
sgbn	杶
swcy	杸
swxn	杹
sny	杺
snhf	杻
srh	杽
wcsu	枀
seg	枂
squg	枃
sgah	枅
stfn	枆
xxsu	枈
sqbh	枊
swvt	枌
swgn	枍
sfwy	枎
smfg	枏
sgxg	枑
saht	枒
sufh	枓
swyn	枔
stdy	枖
sdbn	枙
srhy	枛
sfcy	枟
svfh	枠
stah	枡
sdyy	枤
synt	枦
swcu	枩
smyg	枬
shkg	枮
sckg	枱
cksu	枲
skvt	枴
sqnn	枹
sgsy	枺
sann	枻
ansu	枼
fasu	枽
sfjg	枾
sfah	枿
shcy	柀
stbn	柂
snxn	柅
sug	柆
sty	柇
sugh	柈
stpy	柉
stuy	柊
ways	柋
sngk	柌
smdy	柍
swfy	柎
scnt	柕
svkg	柖
swkg	柗
sjhh	柛
smfg	柟
sfiy	柡
srwy	柣
segg	柤
sjgg	柦
srcy	柧
sdmh	柨
sxet	柪
sxjh	柫
sdcy	柭
sbmh	柮
sntt	柲
smah	柵
slg	柶
skqn	柷
sdhg	柸
stnt	柹
sket	柺
segf	査
spwy	柼
sghg	柾
sqbh	栁
sxy	栂
srgq	栃
ipsu	栄
gkhu	栆
stgg	栍
syni	栐
sqjg	栒
dhvs	栔
sahh	栕
sqqy	栘
stah	栙
sudy	栚
seee	栛
sgmi	栜
gdfs	栞
suah	栟
wtfs	栠
sdjg	栢
swtf	栣
suiy	栤
uqws	栥
syth	栦
sjxt	栧
suqw	栨
sdhb	栫
sqcn	栬
sdmj	栭
sbg	栮
sdeg	栯
sway	栰
sawy	栱
stmy	栴
sgqj	栵
sldy	栶
sxjg	栺
saay	栻
swdy	栿
vksu	桇
sgxw	桋
sdfn	桍
sabh	桏
fasu	桒
stlg	桖
sbsy	桗
swnn	桘
sctg	桙
svqy	桚
shgh	桛
sivg	桜
sqah	桝
sqbh	桞
sdxy	桟
svfy	桪
iits	桬
sdfe	桭
sdhk	桮
skgg	桯
sqak	桰
sgva	桱
sfpb	桲
scdf	桳
sevg	桵
srdh	桸
syve	桹
sgjn	桺
stdh	桻
swiu	桼
swwf	桽
svtk	桾
sjfh	桿
sgki	梀
sgiy	梂
ssgg	梄
sgah	梇
sykb	梈
snhf	梉
rrsu	梊
skeg	梋
swgs	梌
srxn	梍
srxn	梎
sxxf	梐
sqto	梑
swyk	梒
srgc	梔
svyn	梕
smy	梖
shqn	梘
skkh	梙
sqkq	梚
sngb	梛
sdww	梜
whts	條
snny	梞
wvgs	梟
skkg	梠
spfq	梡
smwn	梣
smwv	梤
pwcs	梥
sjfg	梩
sgku	梪
svpc	梫
smgn	梬
snnk	梮
slsy	梱
swkq	梲
sthp	梴
sntn	梶
hkcs	梷
stjh	梸
srgw	梹
ssgh	梺
swxj	梻
sdtf	梼
sfny	梽
sgoy	梾
slpy	梿
sukq	棁
tqts	棃
ycgs	棄
stgi	棅
swga	棆
swcn	棇
sgeg	棈
adws	棊
sesy	棌
spws	棎
sjgf	棏
hdhs	棐
shdd	棑
sukg	棓
sqaj	棔
sdey	棖
gmii	棗
syny	棙
syce	棛
sywu	棜
sldg	棝
slty	棞
sgji	棟
smum	棡
smun	棢
sajg	棤
srrs	棥
sqvh	棦
saay	棧
ynts	棨
sjgg	棩
sooy	棪
sakg	棫
sudb	棬
sywy	棭
swyn	棯
sgvv	棲
sccc	棳
sebc	棴
ssww	棶
sbcy	棷
bcsu	棸
awvs	棻
sswn	棽
sspw	棾
seqn	棿
spqb	椀
sviy	椂
shaw	椃
suvg	椄
smfk	椆
shwy	椇
sqoy	椈
yqas	椉
sywf	椊
spwa	椌
sgfg	椏
srtf	椑
sgey	椓
svlg	椔
swvs	椕
syny	椖
spgh	椗
sspu	椘
sjjg	椙
sug	椚
sawx	椛
swgw	検
fwms	椝
srsu	椞
sgcj	椡
slgy	椢
smaw	椣
stdk	椥
sude	椦
swgb	椧
sowf	椨
sovw	椩
suog	椪
sulh	椫
speg	椬
scde	椮
smdj	椯
stjt	椱
snkh	椲
slge	椳
snhc	椵
srbt	椶
sdgy	椷
sytb	椸
swks	椺
sajv	椻
stis	椼
suej	椾
stky	楀
sptk	楁
sngf	楃
syna	楄
sgkl	楅
ssvg	楆
smnk	楇
snhe	楈
sadk	楉
sjgr	楊
sgkj	楋
sute	楌
skkk	楍
splh	楎
sdff	楏
slwj	楐
swgd	楑
slny	楒
swtj	楓
sdae	楕
svcb	楖
cnhs	楘
scns	楙
sadg	楛
sdeg	楜
syks	楟
swgb	楡
susg	楢
sqrn	楤
segc	楥
samd	楧
shmy	楨
swgr	楩
sans	楪
sjqn	楬
ogui	業
srfh	楯
sewy	楰
sdgy	楲
safs	楳
syuh	楴
sbkg	極
uqws	楶
scns	楺
srgg	楻
risu	楽
sriy	楾
stjg	楿
spgf	榁
sslf	榃
sjlg	榅
spyh	榊
svvv	榋
snuh	榌
sdht	榎
suwl	榏
snae	榐
sgef	榑
sxuu	榒
sntl	榓
fpgc	榖
sgoj	榗
sawk	榙
sugo	榚
srsc	榝
sdri	榞
spuf	榟
spjw	榠
sgxi	榡
spge	榢
serm	榣
sqas	榤
sjiq	榥
fjfs	榦
shay	榩
scoy	榪
sfke	榬
oops	榮
sjff	榯
sftj	榰
slwl	榲
sotp	榳
sabg	榵
sovk	榶
sfjf	榸
srhw	榹
euds	榺
sfcl	榼
sexd	榽
smeg	榾
smgu	榿
ykms	槀
sbti	槂
tews	槃
seeg	槄
sgkh	槅
saqj	槆
sxhw	槇
sdff	槈
sutd	槉
samf	構
swyk	槍
suvo	槏
kkss	槑
syxl	槒
samy	槓
shjs	槕
fpds	槖
sdkk	槗
sugi	様
sfhw	槙
ssmy	槚
swyb	槜
swvm	槝
sujn	槞
sccs	槡
snrg	槢
spdk	槣
slpy	槤
sdhv	槥
sovh	槦
lrsu	槧
sykb	槨
rxas	槩
srxq	槪
sgjf	槫
sdfy	槬
scce	槮
smwy	槯
stdp	槰
ssgo	槱
nhds	槳
sync	槴
skkn	槵
slag	槶
fwfs	槷
sfwy	槸
srif	槹
sovi	槺
sfwq	槻
fwhs	槼
sjlc	槾
syud	樀
sdwe	樁
rxxs	樂
syve	樃
sbgi	樄
stwh	樅
syrc	樆
swhe	樇
sujq	樈
sdrr	樉
scep	樋
sxfm	樌
sgmy	樍
spwj	樎
slxi	樏
shlo	樐
sivs	樑
spnm	樒
slvg	樓
svjs	樔
sgkw	樕
wgkk	樖
ssfi	標
sonx	樚
snwe	樛
soao	樜
shag	樝
sakk	樞
samy	樠
swvo	樢
sugi	樣
swhs	樤
sath	樥
styg	樦
srsc	樧
srwy	権
sahf	樫
stln	樬
sadf	樭
ssoy	樮
sfvg	樰
safy	樲
svaf	樳
sujy	樴
sjbc	樶
ssbc	樷
sogw	樸
sfkf	樹
sagf	樺
skhm	樻
snbb	樼
skkl	樿
sycl	橀
stqj	橁
susd	橂
swxc	橃
srlo	橅
rlgs	橆
sffq	橈
soqh	橉
sgjl	橊
stdk	橋
sueg	橌
sugg	橍
stol	橎
sugk	橏
sdui	橑
sffc	橒
seph	橓
sykt	橔
sipt	橕
sips	橖
saje	橗
svfj	橚
dubs	橜
ssjf	橝
sgjn	橞
sxxy	機
syqe	橠
sbde	橢
spnh	橣
nnns	橤
sujf	橦
sulj	橧
sfam	橨
soof	橩
sqdo	橪
sagw	橫
saqj	橬
sduf	橭
sqym	橮
sooe	橯
sthf	橰
sfkk	橲
seue	橳
shxi	橴
saet	橵
sfja	橶
sruq	橷
sjjj	橸
sujg	橺
snhf	橻
sfup	橽
skks	橾
sglg	橿
sylt	檁
smae	檂
beas	檃
shdy	檅
sook	檆
swym	檇
slge	檈
sbkg	檉
sfjf	檊
sawl	檋
slhd	檌
sujn	檍
sogi	檏
sswj	檒
seac	檓
sipl	檔
lbws	檕
suep	檖
snkf	檘
shnn	檙
sssh	檚
smnp	檛
swgj	檜
skby	檝
sqeg	檞
ssmy	檟
slff	檡
swgw	檢
sfwk	檣
sutp	檤
sugy	檥
ssfj	檦
saqn	檧
sugw	檨
sris	檪
sqve	檭
sfnf	檮
sfkf	檯
sxrh	檰
staw	檱
slgf	檲
spgm	檳
sawc	檴
sxxn	檵
sdak	檶
sgwr	檷
spns	檸
sytk	檹
syke	檺
sahl	檻
sean	檼
sfdj	檽
oops	檾
djes	檿
sadi	櫀
spnj	櫁
snwy	櫂
sakm	櫃
stgo	櫄
syuj	櫅
srqf	櫆
shcm	櫇
swgw	櫈
sdff	櫉
sutk	櫊
sthy	櫋
sdet	櫌
srrm	櫍
soaw	櫎
ssdp	櫏
llls	櫐
slll	櫑
sawi	櫒
sqoj	櫓
sday	櫔
sfwm	櫕
shan	櫖
saly	櫗
sdhn	櫘
saak	櫙
sukk	櫚
stvb	櫛
gkhs	櫜
sflm	櫝
sxxe	櫞
srxs	櫟
sowc	櫠
stfj	櫡
slvt	櫢
salp	櫣
stuj	櫤
soff	櫥
sont	櫦
syfj	櫧
shal	櫨
suqe	櫩
sdth	櫪
gefs	櫫
susq	櫬
svcg	櫭
sgkk	櫮
sqot	櫯
syle	櫰
btws	櫱
scne	櫲
sued	櫳
sgkm	櫴
sawo	櫵
spdn	櫶
stxg	櫷
segg	櫸
savj	櫹
sfkk	櫺
smmv	櫻
swwg	櫼
beas	櫽
seri	櫾
sook	櫿
syke	欀
smas	欁
saif	欂
sqky	欃
sugi	欄
segr	欅
swyc	欆
sbbb	欇
smwk	欈
sogc	欉
saky	權
shhy	欋
sady	欌
sawe	欍
srrf	欎
slxy	欏
sgmx	欐
stfm	欑
yxxs	欒
sipo	欓
shhc	欔
skkt	欕
sahq	欖
saui	欗
snij	欘
slli	欙
sxgj	欚
sfae	欛
sgke	欜
srrf	欝
sfkw	欞
sakq	欟
jqwy	欥
wynw	欦
qkqw	欨
vkqw	欩
bmqw	欪
rhqw	欫
yntw	欬
ldqw	欭
ubtw	欮
fkqw	欯
tlqw	欰
wgkw	欱
hmaw	欳
yvcw	欴
xtdw	欵
gkiw	欶
ctdw	欸
ooqw	欻
cccw	欼
qqwy	欽
qeqw	欿
sfiw	歀
adww	歁
mdmw	歂
mnmw	歄
sfqw	歅
wgew	歈
ykmw	歊
rhaw	歋
wngw	歍
akfw	歎
akgw	歏
akkw	歐
hatw	歑
yumw	歒
rwyw	歓
haow	歔
famw	歕
fkuw	歖
vfjw	歗
ooow	歘
uguw	歚
wgkw	歛
lqjw	歜
lfuw	歝
jxxw	歞
egnw	歟
cccw	歠
akkw	歡
hhu	歨
hitr	歩
hang	歫
hteu	歬
hffy	歭
hhhf	歮
hobj	歯
vyvh	歰
htgf	歱
hdgy	歲
hdgy	歳
dssh	歴
hgmy	歵
hxjy	歶
dtth	歷
wnnh	歸
hqu	歺
gqrh	歽
gqqr	歾
gqqc	歿
gqtd	殀
gqtg	殅
gqtl	殈
gqga	殌
gqdw	殎
gqgy	殏
gqgi	殐
gqdq	殑
gqvi	殔
gquk	殕
gqdn	殗
gqaa	殘
gqqj	殙
gqas	殜
gqdt	殝
gqkm	殞
gqjl	殟
gqty	殠
gqah	殢
gqag	殣
gqtr	殤
gqpw	殥
gqwo	殦
gqyy	殧
gqkm	殨
gqho	殩
gqkl	殫
gqlf	殬
gqgg	殭
gqww	殮
gqpm	殯
gqfm	殰
gqfy	殱
gqwg	殲
ygwc	殶
fnwc	殸
atdc	殹
rswc	殺
fpwc	殻
fpgc	殼
rdec	殽
ftjc	殾
efwc	毀
ykmc	毃
lkwc	毄
akkc	毆
eowc	毇
qytc	毈
atdw	毉
fnwk	毊
xfd	毌
txff	毎
fxdf	毐
xbn	毑
lxxb	毘
qkxy	毚
tfni	毜
tfne	毝
xxtn	毞
ittn	毟
ektn	毠
tfns	毢
ntfn	毣
wcqn	毤
tfnj	毥
btfn	毦
tfny	毧
tfnq	毨
tfno	毩
tfny	毬
gkun	毭
ritn	毮
tfnk	毰
tfno	毱
cccn	毲
tfnd	毴
tfne	毶
jhtn	毷
tfnn	毸
tfnj	毺
daen	毻
jqwn	毼
jntn	毾
cccn	毿
lvtn	氀
tfnd	氁
fitn	氂
ujfn	氃
cnhn	氄
ylkn	氈
kkkn	氉
tfng	氊
apfn	氋
tfnj	氌
llln	氎
qafj	氒
rnri	気
rnjd	氜
rnmw	氝
rngw	氞
rnjh	氠
rnou	氣
rnsf	氥
rnga	氫
rngg	氬
rngi	氭
rnjr	氱
rnll	氳
bii	氶
yii	氷
nii	氹
ihyy	氺
iet	氻
iwu	氼
ibn	氾
ivn	氿
iwy	汃
iwy	汄
ignn	汅
ingg	汈
iqyy	汋
ikh	汌
ivyy	汍
iwyy	汎
idy	汏
itan	汑
iynn	汒
ibg	汓
miu	汖
itfh	汘
igfh	汙
ifnn	汚
ifg	汢
iqyy	汣
ifcy	汥
iqan	汦
igah	汧
ifjh	汫
fjiu	汬
imwy	汭
iqug	汮
idcy	汯
idyy	汱
ircy	汳
iwyn	汵
ity	汷
iyt	汸
inwy	決
itfh	汻
itgh	汼
icnh	汿
icnh	沀
ifcy	沄
icqn	沇
pqii	沊
idny	沋
igxg	沍
iwxn	沎
inhf	沑
iqcy	沒
iqrt	沕
ikhh	沖
gdiu	沗
ixxn	沘
ihg	沚
ithn	沜
iiy	沝
igmh	沞
irhy	沠
inyy	沢
iwry	沨
ifiy	沬
idf	沯
idg	沰
iwet	沴
iqiy	沵
ifiy	沶
idcy	沷
ilg	沺
ingk	泀
ikqn	況
imkg	泂
iqkg	泃
irwy	泆
iekg	泇
ituy	泈
ifah	泋
isgg	泍
ithf	泎
ibmh	泏
ixet	泑
ircy	泒
ituf	泘
iguf	泙
ihxn	泚
iqay	泜
iryy	泝
ighg	泟
inyw	泤
invn	泦
igny	泧
itgg	泩
ipwy	泬
iwfy	泭
itnt	泲
ilf	泴
ijgg	泹
ivey	泿
itey	洀
iyoy	洂
idoy	洃
igmf	洅
ibig	洆
iqdb	洈
irgk	洉
idhb	洊
iahh	洍
idmj	洏
itgs	洐
iwdy	洑
igmi	洓
iffy	洔
iweg	洕
ikgd	洖
iftn	洘
tkiu	洜
ipvg	洝
igxw	洟
ictg	洠
idiy	洡
iwvt	洢
ioy	洣
iwgg	洤
idjg	洦
iywr	洨
ijxt	洩
iwgq	洬
iagg	洭
dhvi	洯
iang	洰
iuah	洴
iqrb	洶
igcf	洷
iigq	洸
iqkg	洺
idfn	洿
imag	浀
iudy	浂
iqvh	浄
ijgh	浉
iway	浌
iutt	浐
inyu	浕
iefy	浖
igiy	浗
intn	浘
iwyk	浛
idny	浝
iwht	浟
ifpb	浡
igku	浢
ipdc	浤
ikcn	浥
ikgg	浧
ipsy	浨
ipwf	浫
ijfg	浬
igjr	浭
itjh	浰
idfe	浱
itdh	浲
iaye	浳
imye	浵
iptg	浶
idww	浹
inkh	浺
imwk	浻
ievg	浽
ifoy	浾
imy	浿
ihqn	涀
iset	涁
ilsy	涃
imgn	涄
ijfh	涆
igva	涇
ivyn	涊
ipdy	涋
iftb	涍
itfp	涏
itry	涐
ivtk	涒
iwug	涖
iwkq	涗
ictd	涘
iynd	涙
iukq	涚
ifpq	涜
ikmy	涢
iykb	涥
ifuf	涬
iepc	涭
iccc	涰
idey	涱
ipwa	涳
ipqb	涴
itfg	涶
igji	涷
itvg	涹
indg	涺
iwfk	涻
iyki	涼
iqaj	涽
iijg	涾
iuvg	淁
ijgf	淂
iudb	淃
inbm	淈
ijsy	淉
iqeg	淊
imfk	淍
idwg	淎
ijgd	淏
ijjg	淐
igvv	淒
iayt	淓
ifhg	淔
ifwf	淕
iqoy	淗
iyny	淚
irmj	淛
ieeg	淜
imaw	淟
iakg	淢
ieqn	淣
ixgi	淥
ipnt	淧
ievh	淨
ifwt	淩
iwga	淪
iyns	淭
iyce	淯
iwyn	淰
ihaw	淲
iqrn	淴
ijgg	淵
isww	淶
igmg	淸
iaay	淺
iahg	淽
qiu	淾
irmh	淿
idfa	渀
iiiy	渁
ijyy	渂
iadk	渃
ihdd	渄
iuaj	渆
ijqx	渇
iyjg	済
ihit	渉
ihiy	渋
idsk	渏
irtf	渒
iefw	渓
iudj	渕
icns	渘
iqmd	渙
idgy	減
idmd	渜
iuth	渞
iyks	渟
iwtj	渢
imnk	渦
iyuh	渧
ilge	渨
itky	渪
imjh	測
iask	渮
iwga	渰
ijag	渱
ixbg	渳
ialg	渵
iamd	渶
iywq	渷
iqyg	渹
iith	渻
iugd	渼
ifky	渽
iplh	渾
isfi	渿
iwgd	湀
irwk	湁
ikkn	湂
igli	湅
iujg	湆
iueg	湇
iafs	湈
intd	湉
idwd	湊
inkh	湋
iwye	湌
idmy	湏
isrg	湐
inhe	湑
ikbg	湒
ivgp	湕
ifff	湗
iyod	湙
itxn	湚
ijgh	湜
ixxr	湝
ihmy	湞
imdo	湠
ijmy	湡
igkl	湢
inaj	湣
iytb	湤
ipwy	湥
ijtg	湦
icee	湧
ihdy	湨
itgf	湩
ixge	湪
toiu	湬
iusg	湭
ijgr	湯
itgg	湰
idhd	湱
iegc	湲
ifmf	湳
iuog	湴
iugy	湵
iriy	湶
idwj	湷
iykw	湸
idjf	湹
iwks	湺
iykj	湻
ieag	湼
igvl	湽
iamm	満
iaps	溁
igkj	溂
imtg	溄
iovg	溇
iyto	溈
inhc	溊
ibcl	溋
iwfq	溌
igoj	溍
isff	溎
iimy	溑
ifke	溒
iuvo	溓
iugo	溔
ipfe	溕
iwyf	準
itux	溗
idwi	溙
iawk	溚
ipwy	溛
iamf	溝
icyj	溞
iuga	溠
ijff	溡
iwwa	溣
icoy	溤
imgt	溦
ifsy	溨
iwno	溩
ilwl	溫
iufc	溬
ilwt	溭
iwnh	溮
imgu	溰
ikmy	溳
irvc	溵
igxi	溸
ifpi	溹
igxf	溼
irqc	溾
ilug	溿
iyxl	滀
iwcn	滃
iwyk	滄
idgy	滅
igkh	滆
iykk	滈
ijiq	滉
irno	滊
iwhs	滌
ibhj	滍
oopi	滎
iqas	滐
iskk	滒
iyke	滖
ipwk	滘
iawy	滙
ierm	滛
irdf	滜
iujn	滝
idfk	滣
iywt	滧
icnm	滪
iwhe	滫
iync	滬
ijaf	滭
ihae	滮
iaqh	滯
iujq	滰
ipfc	滱
icce	滲
iyuk	滳
ipnm	滵
igqt	滶
ihlo	滷
iytf	滸
iwhn	滺
iutg	滻
issy	滼
iovh	滽
iywe	滾
iamy	滿
fnwi	漀
iqoy	漁
iphc	漃
imdf	漄
ivjs	漅
ithh	漇
iwfi	漈
ilvg	漊
ibtg	漋
iakg	漌
ilag	漍
itwh	漎
fufi	漐
irxq	漑
ixkj	漒
iftt	漖
itln	漗
idfe	漘
igjf	漙
iakk	漚
iudi	漛
issf	漜
inrg	漝
iehq	漞
iipf	漟
itjr	漡
iakw	漢
ilpy	漣
ipwf	漥
fiti	漦
ifjn	漧
itdp	漨
igmy	漬
iovi	漮
imee	漰
ixde	漲
impi	漴
iwgt	漵
iykb	漷
ilrh	漸
igho	漹
idrr	漺
inwe	漻
imwy	漼
inig	漽
nhdi	漿
ilwy	潀
xidm	潁
imug	潂
itte	潃
igkt	潄
irwy	潅
itle	潈
imjx	潉
iwgc	潊
ipwf	潌
iumt	潎
icnk	潏
iwyo	潐
iwxc	潑
iqke	潒
igjn	潓
idhi	潔
irlo	潕
iggc	潖
iwys	潗
ieto	潙
ivfj	潚
iaqj	潛
iwgn	潝
ieqo	潟
innw	潠
iykt	潡
iuyy	潣
iugg	潤
isoy	潥
iulj	潧
itli	潨
ilaw	潩
itdj	潪
iudi	潫
ikkl	潬
ivaf	潯
ikhm	潰
ifpu	潱
infj	潳
iaet	潵
ilfo	潶
itvg	潷
isss	潹
itwi	潻
iuoj	潽
ioqh	潾
ilnh	潿
ivyh	澀
ihhh	澁
imgt	澂
edmi	澃
ivfg	澅
iffq	澆
iooe	澇
iusf	澊
ijyi	澋
ikkm	澏
iffc	澐
igjl	澑
iadm	澒
ittt	澓
irtk	澔
iagf	澕
iusy	澖
iujg	澗
issj	澘
iego	澙
itmn	澚
iqgj	澛
ipnh	澝
ihad	澞
iylt	澟
ixg	澠
iipl	澢
ifjf	澣
ilff	澤
iqeg	澥
icnm	澦
itaw	澨
erri	澩
ifwc	澪
iajy	澫
iuqm	澬
iyxy	澭
iwgj	澮
ihqo	澯
iwgw	澰
inac	澱
iogi	澲
ilge	澴
iusr	澵
ijly	澷
idgn	澸
iujn	澺
iuep	澻
inkf	澼
ihae	澽
ifup	澾
issi	澿
ilqj	濁
imae	濃
imnp	濄
ipvc	濅
ifam	濆
ifwk	濇
ikby	濈
ihdy	濊
issh	濋
tgjj	濌
iaqn	濍
ihnn	濎
iggt	濏
ijfj	濐
iuto	濓
igwr	濔
ijxo	濕
ilfj	濖
iajh	濗
ipns	濘
iooo	濙
ioos	濚
iape	濛
ivhl	濜
iadi	濝
iyuj	濟
inyf	濢
ifjf	濣
ifnf	濤
iqpw	濥
iean	濦
iogf	濧
iuxn	濨
iawc	濩
igec	濪
iahl	濫
ihph	濬
iafl	濭
ixwy	濰
ipgm	濱
ifpc	濲
itfj	濳
iooi	濴
ipnm	濵
iutd	濶
iiay	濷
iawk	濸
ijff	濹
imaa	濺
ibkm	濻
irxs	濼
ifwm	濽
ihan	濾
iday	濿
idet	瀀
iufe	瀁
iqoj	瀂
imjr	瀃
itvb	瀄
iooy	瀅
iflm	瀆
ioaw	瀇
inpl	瀈
ipeo	瀉
itel	瀊
iptl	瀋
iono	瀌
iojf	瀍
ialy	瀎
iqyj	瀏
ifhy	瀐
iswk	瀒
itmt	瀓
ifpc	瀔
ihhm	瀕
ifwy	瀖
ipdn	瀗
ihal	瀘
iusq	瀙
igkj	瀜
idth	瀝
igeh	瀞
iavj	瀟
iooi	瀠
ibdp	瀡
ikhp	瀢
iyle	瀤
inyk	瀥
igej	瀦
iued	瀧
igkm	瀨
itwm	瀩
txti	瀪
ifpc	瀫
igkm	瀬
ilwj	瀭
ifss	瀮
iook	瀯
ixgr	瀰
ildj	瀱
iwgt	瀲
iaoo	瀳
immv	瀴
iahk	瀶
inlw	瀷
iwwg	瀸
iqky	瀺
ifly	瀻
iyke	瀼
ipah	瀽
iugi	瀾
itxi	瀿
ifsh	灀
iuri	灁
ielf	灂
imdu	灃
ibbb	灄
illf	灅
iaal	灆
iogc	灇
ihhy	灈
ivky	灉
iaqh	灊
ionc	灋
iuuw	灍
imal	灎
iooq	灐
igmx	灑
itfm	灒
yxxi	灓
imac	灔
iyry	灕
iosd	灖
ijyg	灗
iaky	灘
iipo	灙
ierq	灚
iukl	灛
iyny	灜
ijym	灝
inij	灟
iahq	灠
iaui	灡
igke	灢
iyxx	灣
iyxs	灤
riri	灥
ijxm	灦
imdc	灧
iujm	灨
imdl	灩
isre	灪
oqb	灮
ovt	灱
ojh	灲
qoi	灳
oag	灴
oaj	灷
otan	灹
obn	灺
fou	灻
vou	災
aqou	炁
owcy	炂
wvou	炃
onhf	炄
oyy	炆
oty	炇
owcy	炈
odhy	炋
owjh	炌
orcy	炍
ooy	炏
odhh	炐
osy	炑
oufh	炓
aou	炗
orh	炘
joy	炚
owxb	炛
oyhy	炞
ojgg	炟
olh	炠
oghg	炡
osyy	炢
oskg	炣
ovkg	炤
oxjh	炥
odcy	炦
otbn	炧
opxn	炨
owyc	炩
obmh	炪
qnou	炰
ockg	炲
omdy	炴
otuy	炵
ohkg	炶
ytno	為
okqn	炾
otmy	炿
oywr	烄
otlg	烅
otgs	烆
owgg	烇
qmwo	烉
wsou	烋
owsy	烌
otfq	烍
gaou	烎
wngo	烏
otey	烐
oqiy	烑
oaay	烒
offg	烓
omgk	烔
dgoy	烕
foxy	烖
oynw	烗
owgk	烚
ogjg	烜
bigo	烝
oshy	烞
odeg	烠
oawu	烡
opta	烢
odoy	烣
oahh	烥
oudy	烪
gqjo	烮
oebg	烰
omwk	烱
rrou	烲
ogey	烳
ogva	烴
oaqy	烵
otfp	烶
otxy	烸
oyve	烺
othp	烻
ogey	烼
ooff	烾
omye	烿
owwk	焀
kqwo	焁
whto	焂
ofoy	焃
vtko	焄
otfk	焅
okeg	焆
oieg	焇
ynno	焈
nhdo	焋
ocwt	焌
ouxt	焍
rrou	焎
bkco	焏
olsy	焑
okkg	焒
oqhj	焔
onnk	焗
uoi	焛
ojxx	焜
oqaj	焝
oykb	焞
oajg	焟
oywf	焠
rlgo	無
opwa	焢
bcou	焣
owfo	焤
opqb	焥
owcn	焧
ojeg	焨
oeeg	焩
opwx	焪
oamw	焫
ojqr	焬
oopw	焭
orqw	焮
oywy	焲
owyg	焳
oyce	焴
omum	焵
ortf	焷
jjou	焸
omun	焹
ojta	焺
ojjg	焻
ofaq	焼
jeou	焽
owyn	焾
oovw	焿
onbm	煀
oadn	煁
oakf	煂
odff	煃
otgf	煄
onhc	煆
oplh	煇
owtj	煈
ogli	煉
ojtg	煋
otoy	煍
ogkl	煏
oamd	煐
ftjo	煑
onkh	煒
omdj	煓
oohk	煔
ahho	煕
oegc	煖
odmd	煗
odgy	煘
osfg	煙
jano	煚
hhou	煛
onhg	煝
oleg	煟
oans	煠
ovgp	煡
oopf	煢
ocns	煣
oqmd	煥
odmy	煩
ousg	煪
ouey	煫
ojgr	煬
vgqo	煭
oxxr	煯
okkk	煰
omnk	煱
ojlg	煴
ofmf	煵
ojgh	煶
oykw	煷
oamf	煹
oovk	煻
oqbt	煼
oldn	煾
ogef	煿
ojiq	熀
oeee	熁
orno	熂
cnho	熃
olwl	熅
ofcl	熆
oykk	熇
taho	熈
okmy	熉
cexo	熋
ouwy	熌
opkk	熍
oerm	熎
opjw	熐
ouvo	熑
oopo	熒
owno	熓
oamy	熕
oeeg	熖
owyk	熗
ojaf	熚
osfi	熛
otln	熜
oonx	熝
oahf	熞
olvg	熡
otdp	熢
omwy	熣
onug	熤
ocep	熥
oiwy	熦
twwo	熧
oync	熩
otqq	熪
ooao	熫
dhdo	熭
onwe	熮
oakw	熯
oakk	熰
fwfo	熱
xodm	熲
omjx	熴
ojbc	熶
oulj	熷
oaqj	熸
ofkk	熺
owgn	熻
olaw	熼
ovfj	熽
oujy	熾
oamw	熿
okkl	燀
oagf	燁
osjf	燂
qeoo	燄
fwfo	燅
otdk	燆
ousf	燇
owgu	燈
oykt	燉
ooos	燊
owyo	燋
ofam	燌
oadr	燍
ocnk	燏
ooqh	燐
oujf	燑
offq	燒
srro	燓
ovaf	燖
oueg	燗
ouyy	燘
ijgo	燙
oooo	燚
nhao	燛
ouny	燜
ojyi	燝
wyqo	燞
oopk	營
olff	燡
erro	燢
oylt	燣
oajy	燤
ohqo	燦
ougy	燨
oryt	燩
oaqn	燪
oouo	燫
oeac	燬
olqj	燭
ofwc	燯
oept	燰
oujn	燱
oeem	燲
ojvo	燳
owgj	燴
ofup	燵
omae	燶
oyli	燷
ofdj	燸
oyks	燺
otgo	燻
ovhl	燼
ofnf	燽
fnao	燾
onwy	燿
ofoo	爀
oahl	爁
emgo	爂
ooos	爃
oday	爄
olff	爅
afwo	爇
ohan	爈
ovln	爉
oono	爊
otgo	爋
ooaw	爌
orxs	爍
opdi	爎
odth	爏
ohal	爐
oawo	爑
qodi	爒
ouqe	爓
ougy	爔
yooo	爕
oued	爖
ojaf	爗
ohqe	爘
oyke	爙
owga	爚
ougi	爛
oogc	爜
ojjj	爞
oaky	爟
ohhy	爠
oajj	爡
osso	爢
oipo	爣
oaui	爤
onij	爥
oahq	爦
ofkw	爧
osre	爩
etyt	爫
evhj	爭
rhyn	爮
emff	爯
etno	爲
etnb	爳
laky	爴
wrbb	爺
rreg	爼
gwmr	爾
nhds	牀
nhdk	牁
nhdg	牂
nhds	牃
nhdk	牄
nhdh	牅
nhdk	牆
thgg	牉
thgk	牊
thga	牋
thgn	牎
thgj	牏
thge	牐
thga	牑
thgy	牓
thgf	牔
thgn	牕
thgh	牗
thgm	牘
ipkt	牚
ttgg	牜
tet	牞
tbn	牠
tvyy	牣
tynn	牤
tyt	牥
tywn	牨
ttgh	牪
tay	牫
ttnt	牬
tlg	牭
tmg	牰
tskg	牱
txy	牳
tqay	牴
udtg	牶
twgg	牷
tpbg	牸
tdny	牻
tgva	牼
yxpg	牽
tqtg	犂
tukg	犃
tmum	犅
tfhg	犆
tgtg	犇
tudb	犈
tykb	犉
tnhc	犌
fffg	犎
ttuf	犐
thdy	犑
tqbt	犓
trno	犔
tath	犕
oopg	犖
tpdk	犗
ossg	犘
tcce	犙
nfig	犚
fitg	犛
tykt	犜
tujf	犝
ttdk	犞
tugy	犠
tday	犡
tflm	犢
tvln	犣
tlcx	犤
tono	犥
tjai	犦
tugy	犧
wywg	犨
tvrg	犩
tutt	犪
ywyg	犫
dcyi	犮
qtvy	犱
qtft	犲
qtqy	犳
qttn	犵
qtyw	犺
qtgh	犻
qtbn	犼
qtat	犽
qtdy	犾
qtyh	犿
nhdy	狀
qttf	狅
qtkh	狆
qtsy	狇
qtdg	狉
hdyu	狊
qtfi	狋
qttg	狌
qttb	狏
qtwc	狑
qthc	狓
qtnx	狔
qtxe	狕
qtpw	狖
qtgy	狘
qtjg	狚
qtrg	狛
qtdg	狜
qtqi	狝
qtgg	狟
qttk	狢
qtqi	狣
qtfk	狤
qtqj	狥
qtmf	狦
qttd	狧
qtmk	狪
qtfx	狫
qtdy	狵
qtrh	狶
qtdw	狹
qtmy	狽
qtrr	狾
qttp	狿
qtit	猀
qtjf	猂
qtyi	猄
qthd	猅
hdhy	猆
qthw	猇
qtrf	猈
qtaw	猉
dydy	猋
swwy	猌
qtsw	猍
qtye	猏
qtuq	猐
qtjx	猑
jedy	猒
qtpi	猔
qtrj	猘
qteh	猙
qtwy	猚
qtig	猟
qtmw	猠
qtrt	猣
qtwd	猤
qtwj	猦
qtmk	猧
qtec	猨
qtxe	猭
qtmj	猯
qtdd	猰
qtjn	猲
qtnc	猳
qtya	猵
qtug	猶
qtem	猺
qtbi	猻
qtgf	猼
qtpw	猽
qtec	獀
qtco	獁
qtdi	獂
mgky	獃
qtyy	獄
qtwh	獅
qtrf	獆
qtuc	獇
qtul	獈
qtdt	獉
qtwk	獊
qttf	獋
qtjc	獌
nhdy	獎
qtad	獏
qtlr	獑
qtgt	獓
qtrf	獔
qtmy	獕
qtfm	獖
umiy	獘
qtut	獙
qtaw	獚
qtow	獛
qtoh	獜
qtck	獝
qtuf	獞
qtfq	獟
qteo	獡
qttk	獢
ilgy	獣
qtyt	獤
qtrt	獥
qtan	獦
qtle	獧
qtlj	獨
qthy	獩
qtwj	獪
qtww	獫
qtgr	獮
qtps	獰
qtpm	獱
qtac	獲
qtfj	獳
qtae	獴
qtvn	獵
qtdt	獶
qtow	獷
kkly	獸
qthl	獹
qtgm	獺
hagy	獻
qtxr	獼
qtye	獽
qtdt	獿
qtly	玀
qtkt	玁
qtar	玂
qthc	玃
yxit	玅
yxyx	玆
yxte	玈
gyi	玊
gnn	玌
tff	玍
get	玏
gwy	玐
gag	玒
gqyy	玓
gkh	玔
gfh	玕
ggfh	玗
gnn	玘
ggng	玙
gnrt	玚
gwcy	玜
gtfh	玝
gfwy	玞
gwjh	玠
gaht	玡
gyhy	玣
gdhh	玤
geg	玥
gnwy	玦
gcqn	玧
ggg	玨
gwyn	玪
gmyg	玬
gxxn	玭
gwbn	玱
gann	玴
gafg	玵
gguf	玶
gqnn	玸
gyxy	玹
ghxn	玼
gqkg	玽
glh	玾
gvkg	玿
ggny	珁
gmfg	珃
gtgg	珄
gjhh	珅
gckg	珆
gegg	珇
gqtb	珋
gntt	珌
gqiy	珎
gvgh	珒
gywr	珓
gdhb	珔
geee	珕
gigq	珖
gtfq	珗
gtey	珘
gldy	珚
gdeg	珛
gugh	珜
gng	珝
gwgq	珟
ggwu	珡
gvey	珢
gqjg	珣
grmh	珤
gtmk	珦
gwgk	珨
gffg	珪
gycq	珫
gdgy	珬
gwgh	珮
gftx	珯
givg	珰
givg	珱
gyet	珳
gtry	珴
gkgg	珵
guxt	珶
gfhy	珷
ggkg	珸
gdny	珹
gvtk	珺
gtxy	珻
gmy	珼
gtfp	珽
ghqn	現
gkhy	珿
gwyk	琀
gtnh	琁
gyg	琂
gkeg	琄
gtbt	琇
gebg	琈
grdh	琋
gmwn	琌
gtjh	琍
gfjp	琎
gieg	琑
gtdh	琒
gpfq	琓
gpgh	琔
grtf	琕
gaay	琖
gywf	琗
gqaj	琘
gakg	琙
gsww	琜
gjyy	琝
jegy	琞
gwyg	琟
gmaw	琠
ghgc	琡
gukg	琣
gqvh	琤
gfgy	琧
gjjg	琩
gdwg	琫
gviy	琭
gphn	琯
gmfk	琱
ghdd	琲
gufq	琷
ghjf	琸
ggsu	琹
gifc	琺
gqg	琻
gftj	琽
glwj	琾
gplh	琿
gtky	瑀
gnhg	瑂
gdwj	瑃
gpgg	瑄
gjgh	瑅
gjtg	瑆
ggxy	瑇
gcns	瑈
gnaj	瑉
gdgy	瑊
gnkh	瑋
gdmd	瑌
gqmd	瑍
gxxr	瑎
gpwt	瑏
guej	瑐
gxge	瑑
gjgr	瑒
ggli	瑓
griy	瑔
gwdc	瑖
gbbh	瑘
grgg	瑝
gqyl	瑠
gwnh	瑡
gpwk	瑢
gimy	瑣
gqrm	瑤
gjlg	瑥
gwno	瑦
gdwt	瑧
ggoj	瑨
oopy	瑩
gcoy	瑪
geeg	瑫
iycy	瑬
gssy	瑮
gyvb	瑯
gfhw	瑱
gwyk	瑲
guga	瑳
fpgc	瑴
gcyj	瑵
gprw	瑸
gaws	瑹
giph	瑺
gxfm	瑻
ggjf	瑼
gtwh	瑽
atdy	瑿
gadf	璂
gujq	璄
gvjs	璅
gnwe	璆
ggqt	璈
glpy	璉
gamy	璊
gpgw	璌
gagf	璍
gxgx	璏
grlo	璑
gwgu	璒
gatb	璓
gulj	璔
gvaf	璕
gias	璖
ijgy	璗
goqh	璘
gdui	璙
gcnk	璚
gvfj	璛
gkhm	璝
gjyi	璟
gtol	璠
gwyp	璡
ggjl	璢
gxxy	璣
ggjn	璤
gaqt	璥
gept	璦
gkks	璪
gipl	璫
gryt	璬
gplp	璭
gylg	璮
gwgj	璯
glge	環
gggt	璱
guep	璲
grim	璳
gssh	璴
gegw	璵
gvhl	璶
gget	璷
gpgm	璸
gfnf	璹
gnyf	璻
gahl	璼
gwmy	璽
gyuj	璾
ghph	璿
gfdj	瓀
gawc	瓁
gafl	瓂
glll	瓃
gflm	瓄
grxs	瓅
grrm	瓆
gdet	瓇
gtqi	瓈
gfwm	瓉
gqmt	瓊
gyup	瓋
gyle	瓌
gbdp	瓍
ggkm	瓎
gued	瓏
ghal	瓐
gdth	瓑
gugi	瓓
gmmv	瓔
xgwy	瓕
gyke	瓖
gmwk	瓗
gaky	瓘
gfno	瓙
gtfm	瓚
ghay	瓛
rcyy	瓝
rcyn	瓟
fufy	瓡
rcyj	瓥
gnnf	瓧
agny	瓨
gnnf	瓩
gnnc	瓪
wvgy	瓫
ygny	瓬
pqgy	瓭
gnnv	瓰
gnnn	瓱
gnnn	瓲
dgny	瓳
ckgy	瓵
gnnj	瓸
kegy	瓹
dcgy	瓺
rdmy	瓻
gnnf	瓼
ipky	瓽
tvgy	瓾
tfay	甀
tgdy	甁
ynmy	甂
togy	甃
gnnf	甅
uxxy	甆
oopy	甇
thsy	甈
uvoy	甉
lvgy	甊
yumy	甋
akky	甌
gjhy	甎
oqay	甐
rlgy	甒
qdwy	甔
yxty	甕
mmgy	甖
hagy	甗
aftd	甛
hawf	甝
ipkf	甞
jtgg	甠
tgtg	甡
ydtg	產
uttg	産
getg	甤
gjrg	甦
tgte	甧
tehk	甪
qreh	甮
mhfd	甴
tld	甶
mgnb	甹
lsj	甼
lkh	甽
lynn	甿
mgjj	畁
lqyy	畂
jhqy	畃
ilf	畄
ylcy	畆
lqug	畇
lfwy	畉
lfjh	畊
lwjh	畍
gklf	畐
olg	畑
ylwy	畒
ilf	畓
llf	畕
lrcy	畖
yklf	畗
lmfg	畘
ylqy	畝
flqy	畞
lwtu	畟
rlf	畠
lynw	畡
jafk	畢
wgkl	畣
lffy	畤
ltkf	畧
olf	畨
lyey	畩
vflg	畫
wgsl	畬
lwgs	畭
ltxy	畮
lcwt	畯
lawu	異
gjal	畱
lpeg	畳
vflb	畵
ipkl	當
lccc	畷
glgg	畺
ludf	畻
ljgr	畼
ltgf	畽
lllf	畾
vlgh	疀
lnwe	疁
lipg	疂
loqh	疄
lglg	疅
lfnf	疇
gkll	疈
lllg	疉
lllg	疊
gvhi	疌
nhjg	疍
nhgi	疎
fplh	疐
ube	疓
uxv	疕
uad	疘
ufi	疛
ughi	疜
ufnv	疞
uoi	疢
unwi	疦
uqav	疧
uaht	疨
uvfk	疩
uxxv	疪
uwwi	疭
uanv	疶
uqay	疷
utpi	疺
ukwi	疻
uxjk	疿
uqkd	痀
uhkd	痁
unxv	痆
uji	痋
umgk	痌
uynw	痎
uded	痏
ulkd	痐
uqqi	痑
ugcf	痓
utxi	痗
ugva	痙
uftb	痚
utwv	痜
udny	痝
uied	痟
ucwt	痠
ugey	痡
uukq	痥
ujhc	痩
ujqr	痬
ueed	痭
udei	痮
uphn	痯
usfq	痲
ussi	痳
utbd	痵
umaw	痶
udjn	痷
urmj	痸
urtf	痺
uqaj	痻
uwyd	痽
ubsk	痾
ugfg	瘂
uajd	瘄
ucde	瘆
utgf	瘇
udhd	瘈
uwgj	瘉
uwtj	瘋
ujgr	瘍
uadn	瘎
uftj	瘏
umnk	瘑
uplk	瘒
uqmd	瘓
uadd	瘔
uujd	瘖
uubw	瘚
uthn	瘜
ulii	瘝
udwf	瘞
uwyk	瘡
urqc	瘣
uhag	瘧
ufhw	瘨
uxde	瘬
ucce	瘮
uytd	瘯
udwn	瘱
utwh	瘲
ugkw	瘶
ugkt	瘷
uqqy	瘹
unfi	瘺
ulvd	瘻
uakg	瘽
uttt	癁
udui	療
uwyo	癄
ugjl	癅
uooe	癆
uued	癇
uwxc	癈
ukkl	癉
ubwc	癊
ugfn	癋
uujd	癎
ulge	癏
uwgj	癐
umae	癑
uwgn	癒
utmt	癓
uyxy	癕
ufld	癗
uajy	癘
uenn	癙
uqdy	癚
uylt	癛
uyli	癝
utha	癟
uyuj	癠
uxth	癡
uufe	癢
utvb	癤
utmt	癥
ulff	癦
udth	癧
ufwy	癨
ugkm	癩
utgm	癪
uqog	癬
ummv	癭
uben	癮
uvky	癰
uaky	癱
ufhm	癲
ulli	癳
uyxr	癴
uyxw	癵
wnyy	癶
wfj	癷
wwcu	癹
wfqb	発
wxwc	發
rnn	癿
rxb	皀
rfj	皁
rqb	皃
rcn	皅
rhxn	皉
rwyc	皊
rgsy	皌
rxbj	皍
ruah	皏
rifj	皐
rtry	皒
rjfh	皔
djdj	皕
rmfk	皗
rgeg	皘
rmgu	皚
rrrf	皛
rykk	皜
rgiq	皝
rrdf	皞
rgmy	皟
rmwy	皠
rrif	皡
rffq	皢
ragf	皣
rthf	皥
rryt	皦
rept	皧
rrrf	皨
rgjq	皩
rrxs	皪
rono	皫
rfwy	皬
relf	皭
hcfh	皯
hcqn	皰
giyc	皳
ajhc	皵
sjgc	皶
fkuc	皷
plhc	皸
hcpl	皹
qbtc	皺
haec	皻
fpgc	皼
ylkc	皽
flmc	皾
hlf	盀
blf	盁
dhlf	盃
xhlf	盄
dylf	盇
tlf	盉
dcyl	盋
qblf	盌
igfl	盓
iwyl	盕
gehl	盙
giyl	盚
iqwl	盜
vilf	盝
aalf	盞
xgel	盠
vhgl	盡
ldyl	盢
ahnl	監
tewl	盤
wynl	盦
hall	盧
edml	盨
fufl	盩
ijgl	盪
wgkl	盫
ahnl	盬
xful	盭
hfh	盰
hynn	盳
htnn	盵
hfqn	盶
hqug	盷
hrh	盺
hwgn	盻
hdhh	盽
hyy	盿
heg	眀
hqan	眂
hfcy	眃
hrcy	眅
hyt	眆
htfn	眊
hniu	県
hfiy	眎
hmdy	眏
hghg	眐
hxet	眑
hjhh	眒
hgny	眓
liu	眔
hwet	眕
hkqn	眖
hqkg	眗
duhf	眘
hfiy	眛
hgsy	眜
hpsh	眝
xhnw	眞
hqay	眡
hrwy	眣
hnxn	眤
hxhf	眥
hvkg	眧
hgmw	眪
hugh	眫
hdxy	眬
hmgk	眮
hgcf	眰
hgxw	眱
hbg	眲
hqkg	眳
hqjg	眴
hudy	眹
hugh	眻
hrey	眽
lwwy	眾
hyni	眿
wwhh	睂
hieg	睄
hjfh	睅
hpfq	睆
hkgg	睈
hwwf	睉
hkeg	睊
htry	睋
hqkq	睌
hhqn	睍
hrdh	睎
hlsy	睏
hooy	睒
hmaw	睓
hwga	睔
hpqb	睕
hfwt	睖
hjqr	睗
lgke	睘
hyny	睙
hevh	睜
tqth	睝
hsww	睞
hywf	睟
hudb	睠
hlgj	睤
hqaj	睧
hviy	睩
lfuf	睪
hmfk	睭
hwgj	睮
nnah	睯
hadk	睰
hnhc	睱
hjtg	睲
hdff	睳
hplh	睴
hfky	睵
hdwj	睶
hvgp	睷
hnhg	睸
hwnd	睺
hpgg	睻
hjgh	睼
hhdy	瞁
rfhy	瞂
hrfh	瞃
hkhm	瞆
hopy	瞇
hwcn	瞈
fpgc	瞉
hovk	瞊
hfhw	瞋
lfke	瞏
hhhf	瞐
hykh	瞓
hgmy	瞔
hujf	瞕
atdh	瞖
hwvo	瞗
hakk	瞘
hajd	瞙
hpgw	瞚
htwh	瞛
hlvg	瞜
hyrc	瞝
hamy	瞞
hfwq	瞡
hkkn	瞣
hugg	瞤
hfkk	瞦
hogw	瞨
hsjf	瞫
hdui	瞭
hyct	瞮
hueg	瞯
hagf	瞱
hcnk	瞲
hrlo	瞴
hkhm	瞶
hujg	瞷
haas	瞸
hept	瞹
hwgj	瞺
hwgw	瞼
hhpa	瞾
htmt	矀
hton	矁
hkks	矂
hpns	矃
htgo	矄
hnwy	矅
hawc	矆
hape	矇
hrpy	矈
hpgm	矉
hxrh	矊
hday	矋
hoaw	矌
hqmt	矎
hthy	矏
hfwy	矐
hhal	矑
halh	矒
hued	矓
haky	矔
yxxh	矕
hgmx	矖
hipo	矘
hunt	矙
hnij	矚
cnhc	矝
cnhk	矞
cnhe	矟
cnhj	矠
cnhc	矡
xtdy	矤
qdtd	矦
tdtd	矨
tdte	矪
tdtk	矯
tduj	矰
tdac	矱
tdlx	矲
dsh	矴
djh	矵
dbg	矷
dgqn	矹
dtan	矺
dtnn	矻
dag	矼
dmyg	砃
dnwy	砄
diy	砅
dfwy	砆
dyy	砇
ddbn	砈
dywn	砊
dhg	砋
dwjh	砎
dwvt	砏
dbyy	砐
dwcy	砓
dvfh	砕
dgny	砙
dwyn	砛
dgsy	砞
degg	砠
dgyy	砡
dskg	砢
dtbn	砤
dynn	砨
dxy	砪
dygg	砫
vcdf	砮
dyiy	砯
dwyc	砱
dqnn	砲
ddg	砳
dsgg	砵
drg	砶
dehh	砽
docy	砿
dcag	硁
dwgg	硂
driy	硃
digq	硄
dwgk	硆
dfkg	硈
dvgh	硉
dqdb	硊
dynw	硋
dvey	硍
dgdf	硏
duah	硑
dftx	硓
dawy	硔
dlkg	硘
dmnn	硙
dtdj	硚
dyoy	硛
dgva	硜
dtfk	硞
dthp	硟
dyve	硠
dpdc	硡
dwgs	硢
dftb	硣
ddww	硤
ddny	硥
dgah	硦
dceh	硧
dlh	硨
rrdf	硩
dhqn	硯
iitd	硰
dlsy	硱
dwwk	硲
dfoy	硳
dawx	硴
dhlr	硵
dmwn	硶
dmdf	硸
dswc	硹
dgey	硺
ahnd	硻
ddjn	硽
dtfg	硾
dpwa	硿
dqvh	碀
adwd	碁
dpfi	碂
dgeg	碃
dssy	碄
dlty	碅
ihcd	碆
dqaj	碈
daay	碊
dmsk	碋
dajg	碏
dfwt	碐
dqg	碒
dfhy	碔
ddsk	碕
dwga	碖
dmum	碙
ddmd	碝
kkkd	碞
dyks	碠
dmnk	碢
damd	碤
dptk	碦
dlge	碨
ddmy	碩
dadn	碪
dwdc	碫
dnhc	碬
djgr	碭
djgh	碮
dvtr	碯
dhmy	碵
ddhd	碶
drfh	碷
dwtj	碸
dpwy	確
dykk	碻
dcoy	碼
damy	碽
dnie	碿
dubp	磀
dqyl	磂
drhw	磃
dovk	磄
dmeg	磆
dtlx	磇
drqc	磈
dfhw	磌
dpdk	磍
dexd	磎
duvo	磏
dmgu	磑
dkmy	磒
dwnp	磓
dnrg	磖
dgef	磗
derm	磘
dgjf	磚
lrdf	磛
dwfi	磜
dgqt	磝
dmee	磞
dnwe	磟
dhlo	磠
dade	磡
ddrr	磢
dcce	磣
drvc	磤
dlxi	磥
dsfi	磦
dgmy	磧
ddhy	磩
dmwy	磪
dtwh	磫
ddfe	磭
dmwa	磮
dxxy	磯
dugk	磰
dooe	磱
dulj	磳
dujg	磵
deqo	磶
dusd	磸
dsjf	磹
dtol	磻
dwys	磼
dffq	磽
dkkl	磾
dttd	磿
dueg	礀
dfkk	礂
dipr	礃
dtdk	礄
dwgw	礆
dtmd	礇
duep	礈
dryt	礉
lbwd	礊
dlff	礋
dflg	礌
dajn	礍
dssh	礎
dogi	礏
errd	礐
dipl	礑
dugy	礒
dnkf	礔
nkud	礕
degw	礖
dpgm	礗
djxo	礘
dxth	礙
dafl	礚
dahl	礛
egnd	礜
dfdj	礝
dcor	礟
duxn	礠
dagf	礡
dufe	礢
daly	礣
dahm	礥
doaw	礦
dlll	礧
llld	礨
drrm	礩
dday	礪
drxs	礫
srrd	礬
dfwy	礭
dcor	礮
dooi	礯
ddth	礰
uegd	礱
dued	礲
dosd	礳
dfsh	礵
daky	礶
daal	礷
dtfm	礸
dkkt	礹
pybt	礽
pyqy	礿
pybn	祂
pycg	祃
pywj	祄
pytd	祅
pyqa	祇
pyyt	祊
pywc	祋
pykh	祌
pytf	祍
pyfh	祎
pydg	祏
pydk	祐
pyrw	祑
pyvk	祒
pywf	祔
pynt	祕
fifi	祘
pyfi	祙
hxfi	祡
pyte	祣
pyng	祤
pykd	祦
pyri	祩
pyqb	祪
pywk	祫
pygf	祬
pyfk	祮
pytk	祰
pyuq	祱
pyvc	祲
pyde	祳
pyaa	祴
pyls	祵
pyut	祶
pyqm	祹
pyld	祻
pyjs	祼
pyyf	祽
pyft	祾
pyxi	祿
pymk	禂
pyfh	禃
pyrf	禆
pyfj	禇
pypl	禈
pyug	禉
pysf	禋
pyux	禌
pymk	禍
pyhm	禎
pyec	禐
pyjy	禑
pyxe	禒
pyjr	禓
pyjh	禔
pynh	禕
pyas	禖
pyln	禗
pyyh	禘
pyue	禙
pyfw	禛
oopi	禜
pylt	禝
pyyk	禞
pyok	禟
pyrw	禠
pyco	禡
pyjn	禢
pygf	禣
pyln	禤
pyaf	禥
trhi	禦
pyxy	禨
pylw	禩
pykl	禪
pysf	禫
pywj	禬
pyup	禭
pymu	禮
pyme	禯
pygr	禰
pyff	禱
pydy	禲
pywa	禴
pyjm	禵
pytm	禶
pyom	禷
mci	禸
hlrc	禼
tqb	禿
twu	秂
tbg	秄
ttan	秅
tvyy	秇
tmh	秈
ttfj	秊
oty	秌
twvt	秎
ttfn	秏
tfcy	秐
tfcy	秓
tywn	秔
tqan	秖
ttdy	秗
tdg	秙
tugh	秚
thcy	秛
tnxn	秜
tty	秝
tmg	秞
tdhg	秠
tdcy	秡
twyc	秢
thkg	秥
tthf	秨
tqay	秪
tang	秬
tckg	秮
tmgk	秱
tffy	秲
ttdg	秳
twgk	秴
tldy	秵
uqwt	秶
tgcf	秷
twtf	秹
tpta	秺
triy	秼
tpey	秾
tgey	秿
ykpt	稁
tcwt	稄
twkq	稅
tlsy	稇
tjfh	稈
tgjr	稉
tuxt	稊
twgs	稌
tgfg	稏
twga	稐
tfwf	稑
tldg	稒
tajg	稓
tykb	稕
tukg	稖
tadw	稘
tfhg	稙
tlty	稛
tfwt	稜
teeg	稝
ylkt	稟
tywf	稡
takg	稢
tyki	稤
tojf	稥
tnkh	稦
tdhd	稧
tyna	稨
tleg	稩
ttjt	稪
tgkl	稫
tdmd	稬
txxr	稭
ttgf	種
trbt	稯
tnhe	稰
temf	稱
tehj	稲
tuvo	稴
tuxx	稵
taky	稶
tyxl	稸
tnuf	稺
ykmt	稾
fpgc	穀
tabg	穁
tgmn	穂
tpwk	穃
twfi	穄
tovi	穅
tcce	穇
osst	穈
tnig	穉
tvcq	穊
tnwe	穋
qoty	穌
tgmy	積
xtdm	穎
tevn	穏
tqjn	穐
twvo	穒
tlaw	穓
tamw	穔
twys	穕
txxy	穖
tffq	穘
togw	穙
ttdk	穚
twyo	穛
tujf	穜
tjbc	穝
tqgj	穞
tuep	穟
tmae	穠
tfwk	穡
thdy	穢
tywe	穣
tfdj	穤
tegw	穥
tpgm	穦
tyuj	穧
twkm	穨
tean	穩
tgwr	穪
tawc	穫
toaw	穬
tqoj	穭
tono	穮
tfkk	穯
telf	穱
tgmx	穲
ttfm	穳
pwnb	穵
pwgf	穻
pwsu	穼
pwfj	穽
pwtd	穾
pwtg	窂
pwhf	窅
pwqn	窇
pwgw	窉
pwry	窊
pwbm	窋
pwqb	窌
pwqg	窎
pwif	窏
pwff	窐
pwcn	窓
pwyr	窔
pwfb	窙
pwdy	窚
pwfv	窛
pwqe	窞
pwcc	窡
pwag	窢
pwyf	窣
pwjx	窤
pwhf	窧
pwmk	窩
pwif	窪
pwdd	窫
pwtx	窮
pwuo	窯
pwem	窰
pwws	窱
pwof	窲
pwfw	窴
pwwo	窵
pwlv	窶
pwbb	窷
pwtn	窸
pwnk	窹
pwfq	窺
pwtn	窻
pwvs	窼
pwxw	窽
pwfw	窾
pwgq	竀
pwtn	竁
pwdi	竂
pwfn	竃
pwen	竄
pwrt	竅
pwtk	竆
pwfm	竇
pwfx	竈
pwud	竉
pwtc	竊
uwn	竌
ufh	竍
uaj	竎
utfh	竏
uwcy	竐
udcy	竑
ukhj	竒
utfn	竓
utah	竔
uwvt	竕
uitt	竗
uqkg	竘
upsh	竚
uwyc	竛
ujnb	竜
uug	竝
udjg	竡
uctd	竢
updc	竤
utmt	竧
uhjf	竨
upeg	竩
ahnu	竪
uqvh	竫
utky	竬
unua	竮
udjf	竰
ugjf	竱
uulj	竲
uwgu	竳
uusf	竴
ugkh	竵
ukqq	競
ujft	竷
ujqq	竸
ter	竻
twyu	竼
tbb	竾
tynb	笀
taf	笁
tvyu	笂
trru	笅
tyhu	笇
tquf	笉
taht	笌
tmwu	笍
tfqb	笎
tywb	笐
twyn	笒
txxb	笓
tnyw	笖
ttuu	笗
thkf	笘
tlj	笚
tbmj	笜
tlcu	笝
trcy	笟
tegf	笡
tnna	笢
tqnb	笣
tmmg	笧
tway	笩
twyc	笭
tvcu	笯
txjj	笰
tcaj	笲
tskf	笴
tibb	笵
ttdu	笶
tqtb	笷
tanb	笹
tabj	笻
tlf	笽
ttkf	笿
tfff	筀
tmaf	筁
tibb	筂
tldu	筃
tqiu	筄
tvgj	筆
ttdf	筈
tywr	筊
tqjf	筍
tvkf	筎
tgdf	筓
ttgs	筕
twkh	筗
tdiu	筙
tivf	筜
tpsu	筞
tebf	筟
twgs	筡
ttjj	筣
tyve	筤
tkkf	筥
tpfq	筦
thqb	筧
twyk	筨
tceh	筩
talj	筪
tmu	筫
tdny	筬
tgaj	筭
tege	筯
twtf	筰
ttfp	筳
tdww	筴
ttfk	筶
tjfj	筸
tagy	筺
tkmu	筼
tkgd	筽
ttsu	筿
tukf	箁
tsww	箂
tbcu	箃
trtf	箄
tmwx	箆
tldf	箇
tick	箈
trke	箉
tywu	箊
taau	箋
tgcj	箌
thaw	箎
tevh	箏
tgvh	箑
tvph	箒
tviu	箓
tssu	箖
tltu	箘
tebc	箙
twgj	箚
tbry	箛
tudb	箞
tjxx	箟
ttfg	箠
tgmj	箣
tywf	箤
tihc	箥
tpgg	箮
twgr	箯
tqjb	箰
titq	箲
tnua	箳
tith	箵
tdef	箶
tytb	箷
txqy	箹
tdwj	箺
ttvg	箻
tngf	箼
ttgf	箽
tiej	箾
tkbf	箿
tvcb	節
tjtg	篂
tnhf	篃
tlbb	範
tmdj	篅
tfff	篈
taws	築
tiaw	篊
tadw	篋
ttou	篍
thit	篎
tafw	篏
tsah	篐
twye	篒
tkmu	篔
tfcl	篕
tovk	篖
twyc	篗
tqbt	篘
txuu	篛
tbio	篜
tijf	篞
twge	篟
twhs	篠
tamu	篢
tyuy	篣
tcou	篤
tpwy	篧
tbwi	篨
twnh	篩
tawr	篫
twyk	篬
tujn	篭
tqfy	篯
tukb	篰
tdhv	篲
tjaf	篳
tgep	篴
ttwh	篵
tgho	篶
tcce	篸
thdb	篹
trrf	篺
tsfi	篻
ttrb	篽
tgjf	篿
tgmu	簀
tthh	簁
tlag	簂
ttqq	簃
tync	簄
tutg	簅
tpfc	簆
tntf	簈
ttfp	簉
tadf	簊
tlvf	簍
traj	簎
tlqw	簐
tyke	簑
thdc	簒
tmfe	簓
tyge	簔
take	簕
tivs	簗
tvoj	簘
tfgf	簙
tlgy	簚
tadr	簛
tijr	簜
tdui	簝
tkkl	簞
tgel	簠
tujf	簡
tuyu	簢
tkhm	簣
tlmu	簤
ttdk	簥
tnnw	簨
tooe	簩
tvfj	簫
tkhk	簬
tawk	簭
tfwj	簮
tsaw	簯
tthf	簰
tyaw	簱
terf	簲
tfjf	簳
thaw	簴
tltk	簵
tpyi	簶
tqdy	簷
tipl	簹
tpaf	簺
tmnp	簻
traf	簼
twgw	簽
touo	簾
twyh	籂
tahl	籃
takm	籄
tegw	籅
tawc	籆
tyke	籇
tsfy	籈
tfkf	籉
tnwy	籊
tgwr	籋
tfnf	籌
txth	籎
tytw	籏
teui	籐
thde	籑
trgl	籒
titl	籓
tlvt	籔
tsql	籕
tfhy	籖
tfwy	籗
teui	籘
tqvi	籙
thal	籚
tqaa	籛
trlf	籜
tyny	籝
ttri	籞
tgkm	籟
tued	籠
trww	籡
twgt	籢
tugi	籣
twwy	籤
twga	籥
tqtf	籦
thap	籧
twgw	籨
tthp	籩
txxr	籪
ttfm	籫
tyry	籬
tgmx	籭
tlxy	籮
tyny	籯
thhc	籰
tfwy	籱
twgm	籲
ofh	籵
own	籶
otan	籷
onfh	籸
ovg	籹
otnn	籺
ovyy	籾
ofy	籿
odyy	粀
otfh	粁
qyou	粂
oxxn	粃
orcy	粄
oqrt	粅
oitt	粆
oywn	粇
onhf	粈
xxou	粊
ovfh	粋
oxhh	粌
otfn	粍
onyy	粎
odyy	粏
oynt	粐
oafg	粓
oang	粔
ogsy	粖
omg	粙
otbn	粚
vojk	粛
oawy	粠
omgk	粡
ommg	粣
oqah	粦
oofg	粧
odjg	粨
oftx	粩
odmj	粫
omag	粬
owgk	粭
ohqn	粯
oebg	粰
ojfg	粴
tmtn	粵
oviy	粶
oqoy	粷
oadw	粸
ortf	粺
odey	粻
ojsy	粿
oawx	糀
oadn	糂
ojgr	糃
oyna	糄
odmd	糆
orbt	糉
ouej	糋
odjf	糎
onie	糏
ogef	糐
oxuu	糑
oath	糒
fpgc	糓
ocyj	糔
opge	糘
oanf	糚
oipf	糛
occe	糝
olaw	糞
oujq	糡
oajd	糢
oaqj	糣
oaet	糤
odmj	糥
ofkk	糦
ojgf	糧
owgj	糩
nkuo	糪
olge	糫
olfj	糬
oobt	糭
oahl	糮
olgf	糰
btwo	糱
oday	糲
oguo	糳
tyoy	糴
awno	糵
bmoy	糶
oaui	糷
xnny	糹
xnn	糺
xet	糼
xsh	糽
xnhh	糾
xvt	糿
xnn	紀
xcyy	紁
xfy	紂
xkh	紃
xqyy	約
xag	紅
xgfh	紆
xtnn	紇
xvyy	紈
xvyy	紉
xyy	紋
xdny	紌
xmwy	納
xdyy	紎
xufh	紏
xnhf	紐
xdhy	紑
xwjh	紒
xcnh	紓
xgbn	純
xxxn	紕
xxhh	紖
xitt	紗
xdcy	紘
xqan	紙
xbyy	級
xwvt	紛
xfcy	紜
xtfg	紝
xpqn	紞
xwyn	紟
xyt	紡
xvfh	紣
xrh	紤
rnxi	紥
xcn	紦
xwfy	紨
xrwy	紩
xhxn	紪
xmg	紬
xxcy	紭
snxi	紮
xlg	細
xdcy	紱
xann	紲
xjhh	紳
xhcy	紴
xpsh	紵
xfcy	紶
xwyc	紷
xygg	紸
xvkg	紹
xafg	紺
xmdy	紻
xxjh	紼
xpxn	紽
xwet	紾
xckg	紿
xbmh	絀
xtbn	絁
xtuy	終
xyxy	絃
xegg	組
xmkg	絅
xugh	絆
xqkg	絇
xrg	絈
xsyy	絉
xsgg	絊
xocy	絋
xcfg	経
xwtf	絍
xtgs	絎
xjxt	絏
xfkg	結
xriy	絑
xyth	絒
xffg	絓
xdjg	絔
xvcn	絕
xigq	絖
xlkg	絗
xuqw	絘
xgjg	絙
xghg	絚
whti	絛
dhvi	絜
xdfn	絝
xywr	絞
xwgg	絟
xdeg	絠
xtkg	絡
xqjg	絢
xuah	絣
xsg	絤
xwdy	絥
xwgk	給
xmgk	絧
xadt	絨
xqiy	絩
xldy	絪
ccci	絫
xtdg	絬
udxi	絭
xynw	絯
xgcf	絰
xycq	統
xxiy	絲
xtah	絳
xugh	絴
xwfc	絵
xqcn	絶
xhqn	絸
xkeg	絹
xrdh	絺
xqkq	絻
xet	絼
xkkg	絽
xdny	絾
xgiy	絿
xgki	綀
xdtb	綁
xykq	綂
xieg	綃
xpfq	綄
xvpc	綅
xgjr	綆
xsgg	綇
xuxt	綈
xtbt	綉
xdww	綊
xpdc	綋
xwwk	綌
xfpb	綍
xtfp	綎
xevg	綏
xukq	綐
xlsy	綑
xebg	綒
xgva	經
dfni	綔
xfny	綕
xthp	綖
xmwk	綗
xtdh	綘
xonn	継
xfpq	続
xvyn	綛
xpfi	綜
xssy	綝
xtfg	綞
xyny	綟
xxgi	綠
xyki	綡
xmfk	綢
xudb	綣
vkbi	綤
xlgj	綥
xykb	綧
xadw	綨
xpqb	綩
xgeg	綪
xaay	綫
xepc	綬
xwyg	維
xqrm	綯
xphn	綰
xmum	綱
xmun	網
xeeg	綳
xccc	綴
xesy	綵
xjsy	綶
xywf	綷
xwga	綸
xthk	綹
xdsk	綺
xpgh	綻
xrtf	綼
xhjf	綽
xfwt	綾
xrmh	綿
xgvv	緀
xgvh	緁
xooy	緂
xwwh	緃
xjxx	緄
xbcy	緅
xjqr	緆
xvlg	緇
xfuf	緈
xgmy	緉
ahni	緊
xhdd	緋
xtvg	緌
xqaj	緍
xakg	緎
xwcn	総
txti	緐
xviy	緑
xftj	緒
xamd	緓
ximk	緔
xyjg	緕
xftj	緖
xshg	緗
xdgy	緘
xakf	緙
xriy	線
xdmd	緛
rmhi	緜
xkbg	緝
xwdc	緞
xtgf	緟
xyuh	締
xnaj	緡
xalg	緢
xxge	緣
xans	緤
xwks	緥
xlny	緦
xusg	緧
xyna	編
xegc	緩
xngg	緪
xqrn	緫
xdmd	緬
xleg	緭
xtjt	緮
xnkh	緯
xwgj	緰
xwnd	緱
xhit	緲
odhi	緳
xgli	練
xrbt	緵
xwgr	緶
xplh	緷
xsfg	緸
xjgh	緹
xmnk	緺
xgct	緻
xjlg	緼
xhmy	緽
xdjf	緾
xckn	緿
xnhc	縀
xvey	縁
xukn	縂
xnhe	縃
xjjn	縄
xdgy	縅
xngg	縆
xpgg	縇
oopi	縈
xgoj	縉
xuwl	縊
xwnp	縋
xubp	縌
xyuy	縍
xmeg	縎
tewi	縏
xqbt	縐
xuvo	縑
xuga	縒
xdri	縓
xccs	縔
xlwl	縕
xpdk	縖
xyke	縗
xexd	縘
xabg	縙
xeeg	縚
xgef	縛
xkmy	縜
xfhw	縝
xykk	縞
xdff	縟
fpgc	縠
xpuf	縡
eudi	縢
hiti	縣
xgxi	縤
xdwt	縥
xtuh	縦
xwhs	縧
xjiq	縨
xwfi	縩
xjaf	縪
xtdp	縫
xdhy	縬
xyrc	縭
xpwj	縮
xpgw	縯
xthh	縰
xtwh	縱
xlxi	縲
xgjf	縳
xyxg	縴
xjlc	縵
fufi	縶
xlvg	縷
xajd	縸
xsfi	縹
xlpy	縺
xyth	縼
xtln	總
xgmy	績
xcce	縿
xmwy	繀
xyxf	繂
xmee	繃
atdi	繄
xvjs	繅
xnwe	繆
xxcj	繈
xhqi	繉
xfoy	繊
lwci	繋
xtlt	繌
xvoj	繍
xqdo	繎
xnnw	繏
xgjn	繐
xtdk	繑
xulj	繒
xjbc	繓
xujy	織
xugk	繕
xaet	繖
xoqh	繗
xcnk	繘
xtol	繙
xdui	繚
gxif	繛
xusf	繜
xueg	繝
xffq	繞
xkkl	繟
nnni	繠
xvfj	繡
xkhm	繢
xvfg	繣
ahdi	繤
xfkk	繥
xxkj	繦
xffc	繧
xfup	繨
xxg	繩
xwgj	繪
lbwi	繫
xfwk	繬
amhj	繭
xglg	繮
xlge	繯
xkks	繰
xaqn	繱
xqeg	繲
xryt	繳
nkui	繴
xylg	繵
xujn	繶
xmae	繷
xuep	繸
xlff	繹
xqvo	繺
xfdj	繻
xxxn	繼
xpgm	繽
xkhp	繾
xahl	繿
xwow	纀
xtgo	纁
xyuj	纃
xatp	纄
xrxs	纅
xlff	纆
oxim	纇
xfkm	纈
xfwm	纉
xoaw	纊
xdet	纋
xflm	續
llli	纍
xfhy	纎
xojf	纏
xywm	纐
xhal	纑
xojf	纒
xmmv	纓
xqky	纔
xyke	纕
xwwy	纖
xmwk	纗
xtfm	纘
xlxy	纙
xgmx	纚
xahq	纜
xlli	纝
xyxn	纞
xdcy	纮
xtfg	纴
xpgg	纻
xxhh	纼
xgcf	绖
xwwk	绤
xamd	绬
xqrm	绹
xjlg	缊
xriy	缐
xyke	缞
rmbh	缷
rmou	缹
rmgy	缻
rmqw	缼
rmsg	缽
rmua	缾
rmrk	缿
rmqi	罀
rmmm	罁
oopm	罃
rmxm	罆
rmuf	罇
rmsf	罈
rmir	罉
lbwm	罊
yxtm	罋
mmrm	罌
lllm	罍
rmjc	罎
rmhl	罏
lhng	罒
mri	罓
lwyu	罖
pwsu	罙
lrcy	罛
lygf	罜
legf	罝
lcnt	罞
lnna	罠
lfff	罣
luxt	罤
lkef	罥
lebf	罦
lssu	罧
lffh	罫
lccc	罬
lakg	罭
lujf	罯
lyjj	罰
llnu	罳
lcou	罵
lqyl	罶
lcex	罷
lyfu	罸
lvjs	罺
lnff	罻
ljaf	罼
ldoj	罽
lujf	罿
mrrl	羀
lxke	羂
lajh	羃
lxhf	羄
lxwy	羅
lceo	羆
lakk	羇
lako	羈
lyxi	羉
hghg	羋
dugj	羍
uget	羏
hghy	羐
ugqy	羑
ugwv	羒
ugcn	羓
ugyi	羕
ugwc	羖
ufqc	羗
eugh	羘
ugou	羙
ugxj	羛
ugps	羜
uggw	羠
ugad	羢
vtkg	羣
ugga	羥
ugpq	羦
ugiw	羨
ugty	義
ugye	羪
ugpa	羫
ugdy	羬
ugwj	羭
ugow	羮
ugdi	羱
ugtl	羳
ugug	羴
ugfm	羵
ugyg	羶
ugww	羷
ugfj	羺
ugot	羻
nag	羾
nkhh	翀
nwvt	翂
dcng	翃
nfcy	翄
nvfj	翆
ndcy	翇
lng	翈
sgng	翉
nug	翋
nhcy	翍
nwer	翏
nrwy	翐
nqkg	翑
nrf	習
fkng	翓
wgkn	翖
qqng	翗
mqng	翙
nplj	翚
whtn	翛
ndww	翜
pdcn	翝
nyki	翞
mfkn	翢
nuvf	翣
kman	翤
pgjn	翧
njgh	翨
nrbt	翪
nrfq	翫
nplj	翬
nwnd	翭
nykk	翯
sfin	翲
nlpy	翴
nwvo	翵
rifn	翶
oqan	翷
famn	翸
fffn	翹
thin	翺
hdgn	翽
lgkn	翾
fnan	翿
fte	耂
ftqk	耇
ftxk	耈
fttk	耉
ftgf	耊
dmjd	耎
dmje	耏
mdmj	耑
dish	耓
dihc	耚
dick	耛
dieg	耝
diek	耞
dian	耟
diee	耡
diwa	耣
diaj	耤
digm	耫
dilv	耬
dixw	耭
dioe	耮
diac	耯
didt	耰
diye	耲
bnn	耴
bwyn	耹
bfcy	耺
bmfg	耼
bdcy	耾
bay	聀
bwvt	聁
bwet	聄
btdy	聅
bghg	聇
bxet	聈
bbmh	聉
bqiy	聎
bdmj	聏
bfkg	聐
bbg	聑
awyb	聓
btfk	聕
bkgf	聖
bdww	聗
bgeg	聙
brtf	聛
bpwa	聜
bakg	聝
ubd	聞
tdkb	聟
buah	聠
bwcn	聡
bpgh	聢
beqn	聣
byks	聤
btky	聥
bqrn	聦
bwgd	聧
bxxa	聨
bxxd	聫
bwcn	聬
brqc	聭
bxxo	聮
bxxg	聯
btln	聰
fnwb	聲
twwb	聳
bfln	聴
bkhm	聵
bbbf	聶
bujy	職
bqdy	聸
bpns	聹
bpwi	聺
ilrb	聻
nbfn	聼
bgfn	聽
uegb	聾
ynvg	肁
gqvg	肂
vfjk	肅
ynag	肈
enn	肊
evn	肍
pef	肎
tymw	肏
etnn	肐
eqyy	肑
evyy	肒
ebn	肔
evyy	肕
evg	肗
kef	肙
ecyy	肞
ewyn	肣
muwv	肦
edhy	肧
edhh	肨
edny	肬
edyy	肰
eqrt	肳
erh	肵
exxn	肶
ewfh	肸
ewgn	肹
hpef	肻
erwy	胅
exjh	胇
edcy	胈
erg	胉
muqk	胊
ehkg	胋
etnt	胏
mubm	胐
ekwy	胑
enxn	胒
eguf	胓
hxmw	胔
ewfy	胕
eyxy	胘
exy	胟
efcy	胠
eskg	胢
etbn	胣
emdy	胦
etah	胮
egcf	胵
qrbe	胷
edmj	胹
etgs	胻
fmwy	胾
effg	胿
bige	脀
muqi	脁
eqcn	脃
edoy	脄
eeee	脅
eeee	脇
erey	脈
vvve	脋
erhf	脌
eqkq	脕
eqrk	脗
egiy	脙
egva	脛
edhg	脜
eykb	脝
eefy	脟
ethp	脠
etfp	脡
etxy	脢
dfee	脣
edfe	脤
edww	脥
eany	脦
muct	脧
egki	脨
whte	脩
erdh	脪
ewkq	脫
ekgg	脭
eevg	脮
egku	脰
eirb	脳
edhk	脴
ekgd	脵
etjh	脷
edey	脹
eywf	脺
egvh	脻
egmy	脼
ewyg	脽
egey	脿
ewga	腀
etgf	腁
ejsy	腂
eudb	腃
etfg	腄
eooy	腅
etvg	腇
eeqn	腉
ewyn	腍
ahne	腎
eccc	腏
endg	腒
egji	腖
emgj	腗
elgy	腘
engf	腛
eafs	腜
edmd	腝
exge	腞
epgf	腟
emnk	腡
ejmy	腢
eyuh	腣
eujg	腤
evtr	腦
emdj	腨
eplh	腪
etgf	腫
ecns	腬
erfh	腯
elge	腲
ewwb	腳
enhc	腵
ewdc	腶
egkl	腷
ejgr	腸
euvo	膁
elwl	膃
eehc	膄
eovk	膅
egxi	膆
ewnp	膇
euwl	膉
oope	膋
eiwe	膌
etlx	膍
eexd	膎
ytew	膐
eakk	膒
etjr	膓
eonx	膔
elag	膕
etdp	膖
emwy	膗
exkj	膙
hale	膚
egjf	膞
eyxf	膟
enwe	膠
eudh	膡
elvg	膢
efvg	膤
gsdw	膥
muuf	膧
eafy	膩
edui	膫
etfn	膬
ekhm	膭
effq	膮
ewgu	膯
etol	膰
eujy	膱
ewyo	膲
erlo	膴
eayf	膵
eugg	膶
extb	膷
edap	膸
efam	膹
emnp	膼
eqdy	膽
ewgj	膾
emae	膿
ehae	臄
elqj	臅
ewym	臇
eajn	臈
ewgw	臉
naww	臋
eyuj	臍
enyf	臎
epgm	臏
etgo	臐
efdj	臑
eawc	臒
eady	臓
eahm	臔
eono	臕
emge	臖
epay	臗
evln	臘
eako	臙
ehal	臚
efwy	臛
etfm	臜
ynky	臝
ehhy	臞
eady	臟
yxxw	臠
akfw	臡
etfm	臢
ahnc	臤
ahnw	臥
nhah	臦
ahnk	臨
nhaj	臩
thnn	臫
thwy	臮
thif	臯
thgx	臰
thpy	臱
thsb	臲
gcfk	臵
gcfb	臶
fgcy	臷
gcff	臸
gcfy	臹
fkpf	臺
qef	臽
tfed	臿
egno	舃
egnw	與
emgw	興
egng	舉
awye	舊
emgg	舋
wfkf	舎
tdnh	舏
tdmf	舑
tdjr	舓
tdoo	舕
wfky	舖
wfky	舗
wfkn	舘
tdtd	舙
tdqy	舚
nvph	舝
tevt	舠
tewy	舤
tecn	舥
tedy	舦
tety	舧
tewc	舩
teyn	舮
tewc	舲
telh	舺
teaw	舼
teth	舽
tedn	舿
teeb	艀
tetk	艁
teth	艂
tejf	艃
tews	艅
teye	艆
teyk	艈
terh	艊
tewn	艌
tend	艍
terg	艎
tert	艐
teya	艑
tejh	艒
teas	艓
teoc	艔
teyy	艕
teua	艖
teul	艗
tewk	艙
telv	艛
teah	艜
tefv	艝
teti	艞
tewu	艠
teil	艡
tefk	艢
tehe	艣
teuy	艤
teky	艥
teal	艦
teac	艧
teyj	艩
teqj	艪
tehl	艫
teqy	艬
tewc	艭
akfe	艱
uaqc	艵
magc	艶
mdhc	艷
btbh	艸
aer	艻
asj	艼
avr	芀
awb	芁
awyu	芃
aayu	芅
acyu	芆
amhj	芇
afj	芉
afnb	芌
aghu	芐
abf	芓
bhbh	芔
aqu	芕
adu	芖
agbn	芚
avtr	芛
arnb	芞
ayu	芠
awff	芢
adhu	芣
acnh	芧
awxb	芲
anwu	芵
aqcu	芶
atdu	芺
qbtt	芻
atfn	芼
awbr	芿
aywb	苀
aou	苂
adcu	苃
arjj	苅
aavr	苆
aaqb	苉
axht	苐
amf	苖
auf	苙
aehj	苚
auxb	苝
ahnn	苢
apsj	苧
anxb	苨
arf	苩
agmw	苪
alwu	苬
axer	苭
awmj	苮
axcu	苰
athf	苲
atuu	苳
arwu	苵
awiu	苶
atuf	苸
axu	苺
atgf	苼
arcy	苽
antr	苾
afiu	苿
axjj	茀
argf	茊
aqay	茋
hghk	茍
aqry	茐
aqbj	茒
apwu	茓
atkf	茖
avvv	茘
aadr	茙
aahh	茝
aahh	茞
avgj	茟
awsu	茠
apbf	茡
agqj	茢
akgd	茣
aqqu	茤
afff	茥
agmi	茦
argk	茩
aigq	茪
ahgi	茮
ajru	茰
axxu	茲
awau	茷
btbh	茻
awkh	茽
agaj	茾
aawy	茿
agjg	荁
adfn	荂
aynw	荄
awgk	荅
aqah	荈
agaj	荊
admj	荋
apvf	荌
anht	荍
agcf	荎
auaj	荓
aeer	荕
aftx	荖
adyy	荗
auff	荘
adpu	荙
amjj	荝
apgf	荢
asff	荰
antn	荱
ajff	荲
agku	荳
arfw	荴
avyn	荵
akwn	荶
ahhr	荹
afqu	荺
acwt	荾
adny	荿
adfe	莀
aaww	莁
akej	莂
ardh	莃
agjr	莄
aege	莇
aiwc	莈
anhf	莊
awtf	莋
aukq	莌
agiy	莍
arit	莏
aipq	莐
atdh	莑
amwg	莔
askf	莕
agva	莖
alj	莗
avtk	莙
athp	莚
awwf	莝
awyk	莟
akhu	莡
adww	莢
aynn	莣
asgf	莤
aqtf	莥
aief	莦
ahqb	莧
aqkq	莬
avcb	莭
aler	莮
aisu	莯
atky	莵
abkx	莻
adfa	莾
agmj	莿
arqy	菂
aian	菃
agji	菄
abcu	菆
aruf	菈
aviu	菉
akfi	菋
awyn	菍
ajxx	菎
oguw	菐
avlf	菑
ajsu	菒
ajsu	菓
awga	菕
armf	菗
atfg	菙
aaau	菚
auf	菛
atqt	菞
arqn	菢
aahc	菣
audb	菤
arpu	菦
aoqy	菧
auvf	菨
agkg	菫
aivk	菬
aick	菭
aovw	菮
agaf	華
aqf	菳
adjn	菴
amun	菵
adwg	菶
avph	菷
ayne	菺
assu	菻
aoou	菼
agdn	菾
agcj	菿
ahaw	萀
atkf	萂
agbj	萅
adeu	萇
ahqy	萈
aecb	萉
asww	萊
agvh	萐
aywq	萒
apeg	萓
arvk	萔
ayjf	萕
aeqb	萖
apfi	萗
aspq	萙
arcg	萚
ahaj	萛
amwx	萞
atvy	萟
aeef	萠
airf	萡
aiqn	萢
apgh	萣
atou	萩
atuf	萪
atjf	萫
ajmy	萬
atky	萭
awgj	萮
aqmu	萯
agli	萰
aegc	萲
afmf	萳
amjj	萴
amnk	萵
adwj	萶
aiej	萷
ayna	萹
ajhf	萺
aujf	萻
abcl	萾
aitd	萿
artd	葀
augv	葁
aqke	葂
ajtf	葃
aetf	葄
awwg	葅
acns	葇
acks	葈
aans	葉
awga	葊
aeqk	葋
avvv	葌
agkl	葍
atvg	葎
aivg	葏
awvl	葐
axaf	葒
aiaw	葓
awnd	葔
atis	葕
apwy	葖
agvl	葘
agve	葝
axbf	葞
argf	葟
awvc	葠
adyl	葢
axfu	葤
auej	葥
ankh	葦
afpe	葧
alge	葨
aqej	葪
awdc	葮
axqy	葯
awct	葰
ariu	葲
adgy	葴
aplj	葷
aytb	葹
awtj	葻
arbt	葼
asvf	葽
aqbn	葾
anhf	葿
ajlf	蒀
asyp	蒁
axge	蒃
apff	蒄
aivs	蒅
aawv	蒆
awxx	蒊
ayto	蒍
apsg	蒏
arqc	蒐
arvc	蒑
awnh	蒒
axgn	蒓
ajff	蒔
alwl	蒕
afhw	蒖
avkr	蒘
agkh	蒚
armw	蒛
adri	蒝
aiwu	蒞
auqk	蒟
athn	蒠
abws	蒢
atws	蒣
aiws	蒤
aqyl	蒥
awyc	蒦
adhy	蒧
awge	蒨
ateg	蒩
agef	蒪
auga	蒫
apqy	蒬
aqbt	蒭
apwy	蒮
atec	蒰
argy	蒱
axmw	蒳
aexd	蒵
axwv	蒶
akmu	蒷
axuu	蒻
awyk	蒼
aopu	蒾
abti	蓀
apjw	蓂
aehc	蓃
aiyk	蓅
aoah	蓆
amef	蓇
ayvb	蓈
afcl	蓋
awwt	蓌
aovk	蓎
arcy	蓏
alfj	蓒
augo	蓔
asff	蓕
atfh	蓗
aywe	蓘
aowf	蓙
awhe	蓚
agmt	蓛
asgn	蓜
aeef	蓞
aivc	蓡
ayve	蓢
auft	蓤
awhs	蓧
awhe	蓨
acne	蓩
acep	蓪
agep	蓫
aodn	蓭
alpu	蓮
atwh	蓯
aiua	蓱
aakk	蓲
aakg	蓳
agjf	蓴
argh	蓵
akwy	蓶
arwy	蓷
agmj	蓸
atrb	蓹
afwy	蓺
afuy	蓻
ajaf	蓽
ahlo	蓾
aukb	蔀
aujf	蔁
alxi	蔂
axkj	蔃
aukf	蔄
auvf	蔅
aift	蔆
avcq	蔇
asfi	蔈
aywe	蔉
aojf	蔊
aihc	蔋
aonx	蔍
aywc	蔎
ayuk	蔏
ayud	蔐
avto	蔒
aqgl	蔔
aaqh	蔕
ahag	蔖
acce	蔘
ayth	蔙
aqef	蔛
agqt	蔜
ahou	蔝
alvf	蔞
axtu	蔠
aihv	蔢
anhf	蔣
apnm	蔤
atln	蔥
awvo	蔦
adhv	蔧
alub	蔨
apgw	蔩
alrj	蔪
abwc	蔭
alag	蔮
abgi	蔯
aync	蔰
arsc	蔱
apft	蔲
aige	蔳
aoss	蔴
aday	蔵
agmu	蔶
atqs	蔾
aeto	蔿
agmi	蕀
avaf	蕁
aeue	蕂
aunu	蕄
aijy	蕅
admy	蕆
akkl	蕇
ahhh	蕋
ajjj	蕌
aiwj	蕍
atdk	蕎
aqtj	蕏
agwg	蕐
auef	蕑
almu	蕒
affc	蕓
afuc	蕔
aqtg	蕕
akhk	蕗
affq	蕘
akkn	蕚
atut	蕛
ahdn	蕜
axqc	蕝
awxc	蕟
avki	蕠
afam	蕡
akhm	蕢
aeph	蕣
aahy	蕥
aedm	蕦
attt	蕧
aijr	蕩
arlo	蕪
aujf	蕫
axxi	蕬
avfj	蕭
aeqo	蕮
abtg	蕯
aijl	蕰
atie	蕱
aujf	蕳
aqwe	蕵
afwc	蕶
acnm	蕷
anhp	蕸
adcg	蕼
amae	蕽
aoec	蕿
aill	薀
atmd	薁
aryt	薂
aiyk	薃
aept	薆
awgj	薈
ahdy	薉
aqoj	薊
auqm	薋
axtb	薌
aecn	薍
alpa	薎
atft	薐
aglg	薑
ahqo	薒
aivc	薓
afwk	薔
aouo	薕
amnp	薖
alfy	薗
afup	薘
atdy	薙
agqr	薚
aqdy	薝
agqe	薞
awgw	薟
aodm	薠
ahnn	薡
aqeg	薢
afkc	薣
alqj	薥
aono	薦
aykx	薧
abug	薩
atgo	薫
aris	薬
atrf	薭
aogf	薱
apgm	薲
afkp	薳
apns	薴
afnf	薵
aejf	薶
aisi	薸
ayuj	薺
aivs	薻
aonf	薼
asfy	薽
agwr	薾
axth	薿
aooo	藀
abci	藂
aykw	藃
aadi	藄
alyj	藅
apar	藆
aegw	藇
ahwd	藈
atya	藊
anwy	藋
apnj	藌
aahl	藍
avhl	藎
aqmt	藑
atjn	藒
apdi	藔
aahm	藖
agkp	藗
ahan	藘
auec	藙
aflm	藚
apeo	藛
afwc	藝
addd	藞
alll	藟
arrr	藠
ayup	藡
atmt	藢
alcx	藣
arxs	藥
aosr	藦
axec	藧
aono	藨
alvt	藪
aisf	藫
abkm	藬
apwx	藭
aswo	藮
anfn	藯
aqyj	藰
aurc	藱
asak	藲
aykt	藳
axjl	藴
awke	藵
adth	藶
ayfj	藷
agej	藸
ayjn	藹
auwy	藺
apgn	藼
ausq	藽
agkm	藾
arlf	蘀
agkk	蘁
anns	蘂
ahhs	蘃
akkr	蘄
ahal	蘆
aqot	蘇
atwm	蘈
alpc	蘉
axll	蘊
ahhm	蘋
atri	蘌
atge	蘍
afec	蘎
axfm	蘏
ayec	蘐
atqn	蘒
atqo	蘓
axtm	蘔
axtp	蘕
anks	蘗
ayke	蘘
aatn	蘙
aqog	蘚
aade	蘛
aako	蘜
awgw	蘝
awgt	蘞
aben	蘟
anhk	蘠
ammv	蘡
aued	蘢
aamg	蘣
areo	蘤
awga	蘥
afkk	蘦
aeri	蘨
aono	蘪
aial	蘫
awnh	蘬
augi	蘭
aldj	蘮
aijl	蘯
axjc	蘰
aodm	蘱
allf	蘲
aamf	蘳
amdu	蘴
abuy	蘵
atvc	蘶
hght	蘷
anye	蘹
ayry	蘺
albi	蘻
alls	蘽
afye	蘾
alxy	蘿
ayug	虀
autt	虁
afkk	虂
aiwy	虃
ajtg	虄
aeuo	虅
alli	虆
axay	虇
akkk	虈
agko	虉
ayxs	虊
aemv	虋
aumx	虌
rhaw	虒
vhaw	虓
hatw	處
hatf	虖
harg	虗
haeg	虘
hant	虙
hajg	虛
hale	虜
hawr	虝
kgnw	號
ywrw	虠
haow	虡
fhnw	虣
haww	虤
hawa	虥
aahw	虦
hawn	虧
hase	虨
ijiw	虩
hawo	虪
jvt	虭
jnhh	虯
jsh	虰
jhy	虲
jqyy	虳
jtan	虴
jbn	虵
jgfh	虶
jfh	虷
jbg	虸
xtju	蚃
jyt	蚄
jdbn	蚅
jcn	蚆
jnyy	蚇
jgah	蚈
yju	蚉
jjg	蚎
jeg	蚏
jqug	蚐
jfcy	蚑
jmyg	蚒
jqan	蚔
jfqn	蚖
jnwy	蚗
jdny	蚘
jwyn	蚙
jrh	蚚
jkhh	蚛
jsy	蚞
jgg	蚟
wvju	蚠
jwvt	蚡
jywn	蚢
jwry	蚥
jmfg	蚦
jqnn	蚫
jnxn	蚭
jway	蚮
jguf	蚲
jqay	蚳
jang	蚷
jryy	蚸
jwfy	蚹
snju	蚻
jqkg	蚼
jdhg	蚽
jhcy	蚾
jyxy	蚿
jvkg	蛁
jdcy	蛂
jgmw	蛃
jhkg	蛅
jrwy	蛈
jrcy	蛌
ipju	蛍
jtkg	蛒
fjxy	蛓
jdeg	蛕
jdny	蛖
wnnj	蛗
jgqj	蛚
jwvt	蛜
jvey	蛝
jeee	蛠
jng	蛡
juah	蛢
jfkg	蛣
jqqy	蛥
jgxw	蛦
jmrr	蛧
jdjg	蛨
dhvj	蛪
jqdb	蛫
awju	蛬
jftx	蛯
jgva	蛵
jefy	蛶
jgiy	蛷
jdww	蛺
jwkq	蛻
jlh	蛼
jmy	蛽
jwyk	蛿
jtnh	蜁
jdfe	蜄
jgey	蜅
jhqn	蜆
jyve	蜋
jxxf	蜌
jkeg	蜎
jtbt	蜏
jfce	蜐
thnj	蜑
jqlg	蜔
jmjd	蜖
jswc	蜙
jndg	蜛
adwj	蜝
jyce	蜟
jlty	蜠
srju	蜤
jwga	蜦
jyny	蜧
jgvh	蜨
jqrm	蜪
jjxx	蜫
jbib	蜬
jqeg	蜭
jdwg	蜯
ecju	蜰
jtvg	蜲
jykb	蜳
jjgg	蜵
jywf	蜶
ahnj	蜸
jamw	蜹
jeqn	蜺
jwyg	蜼
jgmy	蜽
jgji	蝀
gfgj	蝁
jthc	蝂
jccc	蝃
jmun	蝄
gdgj	蝅
jhgf	蝆
jpgh	蝊
jiwg	蝋
jvcb	蝍
jyks	蝏
jjhg	蝐
jnhe	蝑
jdmd	蝒
jxxr	蝔
wyjy	蝕
jpgg	蝖
jajv	蝘
jcns	蝚
jdgy	蝛
jqmy	蝜
jxge	蝝
jnhg	蝞
jleg	蝟
jdmd	蝡
jdmy	蝢
jnhc	蝦
jamd	蝧
nfjj	蝨
jtgf	蝩
jjgr	蝪
jftj	蝫
jrbt	蝬
jjgh	蝭
jegc	蝯
ynjj	蝱
jgkj	蝲
jgxy	蝳
toju	蝵
jout	蝷
jmnk	蝸
jjlg	蝹
jtky	蝺
jjjn	蝿
uqfj	螀
jvep	螁
jwnh	螄
juxx	螆
jexd	螇
jwcn	螉
juvo	螊
tewj	螌
jgkh	螎
jutd	螏
jwno	螐
jthy	螑
fjfj	螒
jrhw	螔
jtlx	螕
jmeg	螖
jmgu	螘
sjju	螙
cexj	螚
jpdk	螛
fpgj	螜
jrqc	螝
jcoy	螞
juwl	螠
yjju	螡
oopj	螢
eudj	螣
yjjw	螤
jwyk	螥
jgxi	螦
jftj	螧
jwhs	螩
jyuk	螪
jaqh	螮
jonx	螰
nfij	螱
jpwf	螲
bgjj	螴
anjj	螶
ortj	螷
wwkj	螸
jlrh	螹
jlvg	螻
jakg	螼
jpgw	螾
nhdj	螿
nnaj	蟁
jwvs	蟂
jjlc	蟃
fufj	蟄
joao	蟅
ajdj	蟇
jlag	蟈
jnwe	蟉
jtln	蟌
jtjs	蟍
jamy	蟎
javj	蟏
jiph	蟐
jlfo	蟔
jhxh	蟕
jadr	蟖
gkhj	蟗
jwam	蟘
jujy	蟙
fkuj	蟚
jtdk	蟜
jias	蟝
umij	蟞
jdui	蟟
jeto	蟡
jfkk	蟢
jxxy	蟣
jnnw	蟤
jfam	蟦
jooe	蟧
dubj	蟨
jduw	蟩
jsjf	蟫
jkkl	蟬
jwyo	蟭
jffq	蟯
jvfj	蟰
jrlo	蟱
jjju	蟲
jvaf	蟳
adwj	蟴
jdgf	蟵
jbkg	蟶
jipl	蟷
gejj	蟸
jylg	蟺
jugy	蟻
aqkj	蟼
jfup	蟽
lbwj	蟿
juqm	蠀
xtyj	蠁
jaas	蠂
jwyc	蠄
jxg	蠅
ajmj	蠆
jajy	蠇
madj	蠈
jlge	蠉
jlqj	蠋
jlff	蠌
jjqw	蠍
jada	蠎
jqeg	蠏
jyuj	蠐
joos	蠑
gwmj	蠒
jyke	蠔
jnwy	蠗
jfwy	蠘
jpgm	蠙
adkj	蠚
srrj	蠜
jlll	蠝
tvcj	蠞
jvln	蠟
dmjj	蠠
jday	蠣
usgj	蠤
btwj	蠥
jhal	蠦
fpdj	蠧
javj	蠨
jyfj	蠩
uegj	蠪
ejjj	蠫
jued	蠬
tdhj	蠭
jatn	蠮
ortj	蠯
jyke	蠰
jjjl	蠱
jmmv	蠳
jalj	蠴
jmwk	蠵
aqaj	蠶
jhhy	蠷
jaky	蠸
gdgj	蠺
yxxj	蠻
iwyj	蠽
jnij	蠾
vxxj	蠿
yntl	衁
tlvy	衂
tldh	衃
tliu	衆
tlre	衇
tlbg	衈
tltk	衉
tlay	衊
vgdl	衋
tfgs	衎
tfqs	衏
tans	衐
twys	衑
tyxs	衒
tsys	術
tmgs	衕
taws	衖
trhs	衘
tdes	衚
tnks	衛
tuts	衜
ttgs	衝
tnks	衞
tvds	衟
tfhs	衠
pufh	衦
pugf	衧
pubn	衪
pufw	衭
puwv	衯
puby	衱
puwc	衳
pupq	衴
pujg	衵
pukh	衶
puwj	衸
puqa	衹
yahe	衺
pumf	衻
pufc	衼
puqu	袀
avye	袃
pufh	袆
pumy	袇
pupx	袉
puwc	袊
yqne	袌
puxe	袎
puda	袏
punt	袐
puvk	袑
pueg	袓
pusk	袔
pupw	袕
puwe	袗
putb	袘
purg	袙
pudy	袚
puqy	袛
puwf	袝
ywke	袞
purw	袟
yrwe	袠
pumf	袡
puan	袣
pudg	袥
pubm	袦
puqk	袧
puyx	袨
puhk	袩
pufc	袪
ycke	袬
puti	袮
puny	袯
xyeu	袰
yqqe	袲
puqq	袳
pudn	袴
puwf	袵
puth	袶
pudb	袸
pudj	袹
pufk	袺
pudj	袻
puvk	袽
puri	袾
puff	袿
puld	裀
puhh	裃
puts	裄
putl	裇
pupl	裈
wvge	裊
pugu	裋
pudw	裌
puls	裍
yjfe	裏
puke	裐
putt	裑
puaa	裓
pude	裖
puyk	裗
rrye	裚
ykce	裛
pugy	補
nhde	裝
puuq	裞
vtke	裠
pujf	裡
yqge	裦
puoo	裧
pujx	裩
puqm	裪
pujg	裫
puft	裬
puhw	裭
pujj	裮
pumk	裯
pugy	裲
yhde	裵
puhd	裶
puub	裷
pudn	裺
hgie	裻
rmhe	製
pudk	裿
puaw	褀
jseu	褁
puhe	褃
pugv	褄
puyh	褅
pujh	褆
putt	複
putf	褈
pudd	褉
puas	褋
pupl	褌
pumj	褍
yqge	褎
yqge	褏
puec	褑
pugl	褔
puwj	褕
puxe	褖
puav	褗
punh	褘
eqne	褜
puil	褝
pujl	褞
pujn	褟
puaf	褠
yrqe	褢
pupk	褣
pufe	褤
pucx	褦
boye	褧
puua	褨
tewe	褩
pucs	褬
ycoe	褭
oope	褮
puoh	褯
ylie	褱
puol	褲
pulp	褳
puyc	褵
puth	褷
pulv	褸
pufy	褹
fufe	褺
yfwe	褻
pusn	褼
nfie	褽
pusi	褾
pugj	褿
pugm	襀
puce	襂
yqge	襃
pujf	襅
puow	襆
puuj	襇
punw	襈
puue	襉
pujc	襊
pugi	襋
pukl	襌
puws	襍
putl	襎
puwc	襏
puqe	襐
puvf	襑
puut	襒
pufq	襓
puay	襔
puui	襕
putd	襖
pulf	襗
puwj	襘
puks	襙
puup	襚
pume	襛
puqy	襜
puww	襝
puil	襠
pulj	襡
puyg	襢
putj	襣
pual	襤
puww	襥
pugr	襧
puof	襨
pufm	襩
puay	襪
pudj	襫
pulx	襬
pufm	襭
puji	襮
puuq	襯
pugm	襰
puud	襱
uege	襲
puwy	襳
puui	襴
pubb	襵
pufy	襶
puer	襷
putm	襸
pugx	襹
puaj	襺
puac	襼
puai	襽
gmjg	襾
sghg	覀
stpu	覂
swdy	覄
svqr	覅
sake	覇
sryt	覈
sakk	覉
sako	覊
hqb	見
chqn	覌
ihqb	覍
hqbd	覎
fwhq	規
hqrr	覐
thgq	覑
tfnq	覒
ehqb	覓
dhhq	覔
nthq	覕
pyhq	視
ngkq	覗
hkhq	覘
qihq	覙
iphq	覚
rehq	覛
qihq	覜
fohq	覝
hqhq	覞
fnhq	覟
vtkq	覠
awwq	覡
oohq	覢
tvhq	覣
hawq	覤
mawq	覥
wgeq	覦
ahnq	覧
kkfq	覨
ftjq	覩
ushq	親
yupq	覫
mgkq	覬
pjyq	覭
oopq	覮
amfq	覯
haeq	覰
lrhq	覱
akgq	覲
rwyq	観
wgkq	覴
uehq	覵
ecmq	覶
haoq	覷
ujhq	覸
hqtt	覹
errq	覺
hagq	覻
gwmq	覼
ahnq	覽
ptoq	覾
flmq	覿
akkq	觀
mqbd	觃
mawq	觍
qehh	觓
qehe	觔
tqeh	觕
qeha	觗
qeht	觘
qehy	觙
qehg	觛
qehy	觝
qehf	觟
udqh	觠
qehk	觡
dhvh	觢
qehb	觤
qehg	觧
qehi	觨
qehy	觩
qehf	觪
qehq	觬
qehk	觭
qehi	觮
qehj	觰
dgkh	觱
qehg	觲
qehr	觴
qehw	觵
qehl	觶
errh	觷
qehj	觸
qehm	觹
xtdh	觺
qehs	觻
qeht	觼
qehm	觽
qeho	觾
qehk	觿
yygg	訁
ysh	訂
yhy	訃
vyd	訄
yvn	訅
ynhh	訆
yfh	計
ywyy	訉
ynfh	訊
yqyy	訋
yag	訌
ycyy	訍
yfy	討
ygfh	訏
yfh	訐
ybn	訑
yvyy	訒
ykh	訓
myf	訔
ymh	訕
ytnn	訖
ytan	託
ynn	記
yvyy	訙
uyd	訚
ywxn	訛
ywvt	訜
yaht	訝
ytdy	訞
ywcy	訟
yxhh	訠
ywyn	訡
yrh	訢
ynwy	訣
yrry	訤
ymwy	訥
ypqn	訦
ydny	訧
yhg	訨
yrbh	訩
yyt	訪
yny	訫
yitt	訬
ywcy	設
ygah	訮
ybyy	訯
ygbn	訰
ytfh	許
ykhh	訲
ynyy	訳
yryy	訴
ylg	訵
yskg	訶
yjhh	訷
yty	訸
ysyy	訹
ywet	診
yygg	註
yghg	証
yqkg	訽
yhxn	訿
yhkg	詀
ydg	詁
ywfy	詂
yyxy	詃
yrwy	詄
ywyc	詅
yqay	詆
ymdy	詇
yvcy	詉
yugh	詊
ykqn	詋
yafg	詌
yann	詍
yang	詎
yxet	詏
ythf	詐
ypxn	詑
yckg	詒
yfcy	詓
yvkg	詔
yguf	評
yhcy	詖
ymkg	詗
ybmh	詘
ydcy	詙
yjgg	詚
yegg	詛
ybhc	詜
ypsh	詝
yngk	詞
dxyy	詟
yyni	詠
yng	詡
yqjg	詢
yxjg	詣
ywnk	詤
ywgk	詥
yaay	試
wyf	詧
yywr	詨
yffy	詩
yvey	詪
ypta	詫
yrgk	詬
yqdb	詭
ywgg	詮
ythg	詯
yfkg	詰
ytdg	話
yynw	該
yugh	詳
ydeg	詴
ytfq	詵
yyth	詶
ymgk	詷
yoy	詸
yqkg	詺
ytkg	詻
ydoy	詼
ygdf	詽
yqrb	詾
yffg	詿
ybg	誀
yuah	誁
yqiy	誂
yqqy	誃
ydiy	誄
yriy	誅
yagg	誆
ydfn	誇
ygcf	誈
ynny	誋
yfny	誌
yvyn	認
ygki	誎
yyve	誏
ytry	誐
yqtg	誑
yctd	誒
ytfp	誔
ythp	誕
yfpb	誖
ytjh	誗
ytbt	誘
ygva	誙
yieg	誚
yvpc	誛
ycwt	誜
ywyk	誝
ygkg	語
yftb	誟
ydny	誠
yaah	誡
yhqn	誢
yaww	誣
ykgd	誤
ytfk	誥
yceh	誦
ygey	誧
ytxy	誨
yyg	誩
ywkq	說
ydfe	誫
yukq	説
yfpq	読
yawx	誮
yjjg	誯
ywyg	誰
ygvh	誱
yjsy	課
ynbm	誳
ypfi	誴
yrde	誵
yywf	誶
ymun	誷
yxyx	誸
yhdd	誹
ysww	誺
yijg	誻
ypeg	誼
yeqn	誽
uyd	誾
ymfk	調
yrtf	諀
yccc	諁
yqeg	諂
yssy	諃
yykb	諄
adwy	諅
yadw	諆
yooy	談
ytfg	諈
ytvg	諉
yqoy	諊
ygeg	請
ygji	諌
yqvh	諍
yajg	諎
ybcy	諏
wkky	諐
ygey	諑
yyki	諒
yaay	諓
yhgc	諔
yhaw	諕
ywga	論
ywyn	諗
ygey	諘
yqaj	諙
ypgh	諚
yewy	諛
yans	諜
ynhe	諝
yyna	諞
yjgh	諟
ypgg	諠
ywgl	諡
yplh	諢
ymnk	諣
ykkn	諤
ytgf	諥
yyuh	諦
yxxr	諧
ygkl	諨
yuog	諩
yyks	諪
ygli	諫
tdny	諬
ywgj	諭
yuqk	諮
ymdj	諯
ylny	諰
ynkh	諱
ysfg	諲
yujg	諳
ydgy	諴
yfmf	諵
yadn	諶
ywtj	諷
yftj	諸
yjgr	諹
yute	諺
yrgg	諻
yegc	諼
yakf	諽
yadk	諾
ykbg	諿
yafs	謀
yjqn	謁
yleg	謂
yjtg	謃
eudy	謄
yqbt	謅
yynn	謆
jawy	謈
yrqc	謉
yayk	謊
yqas	謋
yskk	謌
oopy	謍
yopy	謎
yehc	謏
yntl	謐
yexd	謑
ywyk	謒
yfhw	謓
yhag	謔
yrhw	謕
ylwt	謖
yyuy	謗
ynuf	謘
yuvo	謙
yuwl	謚
yamf	講
ydri	謜
ytmf	謝
yykk	謞
yeeg	謟
yqrm	謠
yerm	謡
ywyc	謢
yffn	謣
ysfi	謤
ytln	謥
yyrc	謧
yajd	謨
ajdy	謩
yyuk	謪
yyud	謫
ynwe	謬
yuev	謭
ygmy	謮
yhag	謯
ylpy	謰
ylvg	謱
ycce	謲
yakk	謳
yxfm	謴
ynrg	謵
yoao	謶
gqty	謷
ygqt	謸
yakg	謹
fufy	謺
ytqq	謻
yhaf	謼
xkjy	謽
yjlc	謾
yfje	謿
ynbt	譀
yagf	譁
ykkl	譂
yhag	譃
yulj	譄
yvyh	譅
yfkk	譆
ydfj	譇
yykt	譈
ywgu	證
yffq	譊
yueg	譋
yeto	譌
owwy	譍
ycnk	譎
yxxy	譏
yusf	譐
ytdk	譑
ytol	譒
ygjn	譓
ynnw	譔
yrlo	譕
yaqj	譖
ytwk	譗
yujy	識
ywyo	譙
ysjf	譚
yfwj	譛
yuoj	譜
yxg	譝
ylge	譞
ykks	譟
yylg	譠
yipl	譡
yuep	譢
ywgw	譣
yryt	譤
ryty	譥
youo	譧
ymae	譨
yujn	譩
yajn	譪
yqdy	譫
yeac	譭
ywgj	譮
ylff	譯
yugy	議
ugyy	譱
yywe	譲
yfdj	譳
ykhp	譴
yogf	譵
yyyf	譶
yawc	護
yfnf	譸
yyke	譹
yxth	譺
mmyf	譻
ahny	譼
egny	譽
yuen	譾
ydhn	譿
yflm	讀
yyup	讁
yqmt	讂
yfwm	讃
ylll	讄
yptl	讅
tnky	讆
yuqe	讇
ydth	讈
ykhp	讉
yxxt	變
uegy	讋
yako	讌
ygkk	讍
wyyy	讎
tnky	讏
wywy	讐
ywga	讑
yqky	讒
yyke	讓
yben	讔
yugi	讕
ywwg	讖
ymwk	讗
ybbb	讘
yaky	讙
ytfm	讚
yafc	讛
yipo	讜
ykkt	讝
yhay	讞
yfly	讟
ytan	讬
yvyy	讱
yrbh	讻
ymkg	诇
yhcy	诐
ydtf	诪
ypjh	谉
ynhe	谞
tdwk	谸
wwkc	谹
wwkt	谺
wwkg	谻
wwkw	谼
wwkk	谽
wwka	谾
exdk	谿
wwkd	豀
wwke	豂
wwkt	豃
wwkm	豄
wwkd	豅
mgku	豈
magu	豊
wgku	豋
gkuf	豍
ahnu	豎
gkuo	豏
mdhu	豐
magt	豑
mdht	豒
mdhl	豓
mdhl	豔
geyi	豖
gqge	豗
gegn	豘
ueu	豙
gewc	豛
gega	豜
gecn	豝
geqk	豞
geyn	豟
geeg	豠
gegf	豣
geve	豤
geyw	豥
hage	豦
gegy	豧
gerh	豨
gege	豩
gefj	豬
genc	豭
gefm	豮
geed	豯
fpfc	豰
gejl	豱
gedi	豲
geyd	豴
geth	豵
gefm	豶
gefu	豷
efh	豻
exxn	豼
emwy	豽
edhg	豾
eqkg	豿
ebmh	貀
epwy	貁
erg	貃
evgh	貄
egjg	貆
evey	貇
etey	貈
ejfh	貋
ejfg	貍
eeqn	貎
ertf	貏
ewgj	貐
enhc	貑
emdj	貒
ealg	貓
eexd	貕
euwl	貖
elvg	貗
eakk	貙
ekkl	貚
eaky	貛
ehhc	貜
mhny	貝
hmu	貞
cmu	貟
qmu	負
mftt	財
amu	貢
aymu	貣
mbn	貤
mywn	貥
mfqn	貦
wvmu	貧
wxmu	貨
mrcy	販
wynm	貪
xfmu	貫
gmu	責
rfmi	貭
fmny	貮
mpsh	貯
anmu	貰
mhcy	貱
hxmu	貲
afmy	貳
khgm	貴
cdmu	貵
mtpy	貶
lmu	買
waym	貸
mtgg	貹
mkqn	貺
xjmu	費
mhkg	貼
mckg	貽
mqay	貾
qyvm	貿
ekmu	賀
famu	賁
mtkg	賂
wtfm	賃
mdeg	賄
mynw	賅
muah	賆
uqwm	資
smu	賈
mtlg	賉
madt	賊
mywr	賋
yntm	賌
mofg	賍
mdxy	賎
mmy	賏
mcwt	賐
mdfe	賑
mwfi	賒
pghm	賓
pnmu	賔
mgiy	賕
mwgs	賖
mkkh	賗
mofy	賘
mmfk	賙
swwm	賚
fwfm	賛
mjqr	賜
mpws	賝
ipkm	賞
mmaw	賟
mukg	賠
ovwm	賡
ahnm	賢
flmu	賣
maay	賤
mywf	賥
mfhy	賦
mooy	賧
pfim	賨
mpfi	賩
rrmu	質
fwwm	賫
mdey	賬
mftj	賭
vhgm	賮
mqjb	賯
mdwj	賰
mplh	賱
wksm	賲
mfky	賳
gkim	賴
mjhg	賵
mwyk	賶
fkkm	賷
eudm	賸
muwl	賹
muvo	賺
mgef	賻
mamf	購
pawm	賽
ahkm	賾
mnwe	賿
atdm	贀
mmty	贁
mcce	贂
mkkn	贃
fufm	贄
gqtm	贅
mdyy	贆
yfhm	贇
mulj	贈
msjf	贉
tfqm	贊
dwwm	贋
mogw	贌
mqdy	贍
majy	贎
ynky	贏
mvhl	贐
ujfm	贑
ahnm	贒
mdny	贓
mmmu	贔
qytm	贕
mflm	贖
dwwm	贗
mipm	贘
hawm	贙
mued	贚
ujfm	贛
mady	贜
cmu	贠
mmmu	赑
mmfk	赒
mjhg	赗
yfhm	赟
foqw	赥
fojy	赨
foqc	赩
fohm	赪
fohm	赬
fonc	赮
fook	赯
fuyu	赱
fhee	赲
fhmk	赸
fhqu	赹
fhwn	赺
fhit	赻
fhqw	赼
fhnw	赽
fhrk	赾
fhqa	赿
fhtt	趀
fhqi	趂
fhrw	趃
fhqy	趆
fhud	趇
fhhk	趈
fhbm	趉
fhfk	趌
fhqq	趍
fhri	趎
fhtd	趏
fhnd	趐
fhqi	趒
fhws	趓
fhjf	趕
fhwf	趖
fhkh	趗
fhnn	趘
fhie	趙
fhgi	趚
fhqd	趛
fhqo	趜
fhwn	趝
fhaj	趞
fhhf	趠
fhwy	趡
fhvi	趢
fhpd	趤
fhug	趥
fhuk	趦
fhjh	趧
fhqt	趨
fhlw	趩
fhaw	趪
fhtk	趫
fhfq	趬
fhwo	趭
fhks	趮
fhny	趯
fhgr	趰
fhtm	趲
khgf	趶
khtn	趷
khnw	趹
khwn	趻
khyt	趽
kheg	跀
khcn	跁
khfc	跂
khry	跅
khan	跇
khwe	跈
khwc	跉
khfi	跊
khdg	跍
khhx	跐
khsk	跒
khyg	跓
khqk	跔
khhk	跕
khug	跘
kheg	跙
khnx	跜
khgw	跠
khyo	跡
khqq	跢
khbs	跥
khri	跦
khwg	跧
khjx	跩
khth	跭
khgf	跮
khua	跰
khff	跱
khwk	跲
khsg	跴
khdp	跶
khnk	跼
whth	跾
khfh	跿
khkh	踀
khga	踁
khbn	踂
khie	踃
khhh	踄
khct	踆
khtx	踇
khgi	踈
khfb	踋
khfb	踍
khdk	踎
khaa	踐
khaw	踑
khtv	踒
khwy	踓
khgh	踕
khaj	踖
khwn	踗
khqo	踘
khbc	踙
khwa	踚
khff	踛
khft	踜
khpb	踠
khub	踡
khyf	踤
khuv	踥
khdk	踦
khhc	踧
khwh	踨
khug	踫
khqh	踭
khwj	踰
khrh	踲
khdj	踳
khce	踴
khjh	踶
khfj	踷
khan	踸
khmk	踻
khjr	踼
khgl	踾
khto	踿
khak	蹃
khsg	蹅
khvp	蹆
khwk	蹌
khne	蹍
khfw	蹎
khrw	蹏
khie	蹐
khql	蹓
lrkh	蹔
khjf	蹕
khde	蹖
khox	蹗
khne	蹘
khif	蹚
khah	蹛
khpj	蹜
khth	蹝
khxm	蹞
khgm	蹟
khoo	蹠
khnf	蹡
khyd	蹢
khay	蹣
khth	蹤
khlp	蹥
khgj	蹧
khqo	蹨
khkm	蹪
khck	蹫
khsn	蹮
khuf	蹱
khwc	蹳
ykih	蹵
dubh	蹷
khoh	蹸
khwn	蹹
khfq	蹺
khtk	蹻
khdi	蹽
khyt	蹾
khxm	躀
khfp	躂
khnf	躃
nkuh	躄
khhe	躆
khrt	躈
ajmh	躉
khff	躊
khyj	躋
khrh	躌
khny	躍
khgr	躎
khub	躑
khrs	躒
khrm	躓
khof	躕
khxg	躖
tnkh	躗
khud	躘
khuy	躙
khsp	躚
tnkh	躛
khui	躝
khye	躟
awnh	躠
khbb	躡
khun	躢
khhy	躣
khaj	躤
khpn	躥
khtm	躦
khgx	躧
khut	躨
khhc	躩
khay	躪
tmdq	躭
tmdv	躮
tmdg	躰
tmds	躱
tmdk	躳
tmde	躴
tmdn	躵
tmds	躶
tmdv	躷
tmdk	躸
tmdo	躹
tmda	躻
tmde	躼
tmdv	躽
tmdd	躾
tmdi	躿
tmdk	軀
tmdv	軁
tmde	軂
tmdl	軃
tmdy	軄
tmdy	軅
tmdu	軆
tmdf	軇
tmdn	軈
tmdm	軉
lghh	車
lnn	軋
lvn	軌
plj	軍
lgqn	軏
lnfh	軐
ldy	軑
lfh	軒
lwyy	軓
lvyy	軔
lmh	軕
lgg	軖
lwcy	軗
lgbn	軘
lhcy	軙
ldyy	軚
ldbn	軛
lmwy	軜
lqan	軝
ltfn	軞
lqwy	軟
ltfg	軠
lwyn	軡
lfcy	転
liu	軣
ltuf	軤
lqkg	軥
lkqn	軦
lqay	軧
lwyc	軨
lckg	軩
lxet	軪
lwet	軫
cdlj	軬
lagg	軭
lmdy	軮
lguf	軯
uxlj	軰
lrcy	軱
ldg	軲
lqnn	軳
lygg	軴
lwfy	軵
lynn	軶
ldcy	軷
lmg	軸
lkwy	軹
lvkg	軺
lskg	軻
lrwy	軼
lcfg	軽
laay	軾
luah	軿
ldmj	輀
lawy	輁
awlj	輂
lywr	較
ligq	輄
ltkg	輅
lynw	輆
lwgg	輇
ltey	輈
flxy	載
lgcf	輊
mdlj	輋
lgmm	輌
lwwk	輍
lieg	輎
lsgg	輏
lpfq	輐
lvtk	輑
lbnn	輒
lqkq	輓
lgey	輔
lgva	輕
lmfk	輖
leqn	輗
lfwt	輘
lbcy	輙
laay	輚
lgmy	輛
lvlg	輜
igql	輝
lmun	輞
lccc	輟
ljsy	輠
lqeg	輡
ldsk	輢
leeg	輣
lgeg	輤
ljxx	輥
fwfl	輦
ltgf	輧
lphn	輨
hdhl	輩
lwga	輪
lhdd	輫
lyki	輬
ldmd	輭
lcns	輮
lkbg	輯
ljgr	輰
ldgy	輱
lmdj	輲
ldwd	輳
lrfh	輴
ljqn	輵
lusg	輶
lqyg	輷
lwgj	輸
ltjt	輹
lgvl	輺
lgkl	輻
ljlg	輼
lcdl	輽
lnae	輾
elgw	輿
llwl	轀
leeg	轁
fpgc	轂
ldwt	轃
lpdk	轄
lfke	轅
lonx	轆
lnwe	轇
lvjs	轈
lgjf	轉
ldhv	轊
llpy	轋
lfvg	轌
lyct	轍
ltdk	轎
lnbb	轏
logw	轐
ldui	轑
lfam	轒
ltol	轓
loqh	轔
lajn	轕
lfwk	轖
ldgn	轗
llge	轘
lugy	轙
lbwl	轚
logf	轛
lfdj	轜
egnl	轝
lahl	轞
lllj	轟
llll	轠
lxxk	轡
lrxs	轢
ldth	轣
lhal	轤
lauy	轥
ldy	轪
ltey	辀
lyki	辌
ljlg	辒
ckuf	辝
thuf	辠
uduf	辡
gkif	辢
epcf	辤
btwf	辥
udef	辦
udvf	辧
hwnf	辪
udyf	辬
ecmf	辭
udxf	辮
udyf	辯
made	農
ssde	辳
kkle	辴
ehu	辵
gpd	辷
bpe	辸
vpe	辺
fpk	辻
typi	込
mpk	辿
fpk	迀
fnpv	迃
bpv	迆
npe	迉
gmhp	迊
gpd	迋
epd	迌
gbnp	迍
dypi	迏
ywpv	迒
dypi	迖
gdpi	迗
khpk	迚
hkpd	迠
nxpv	迡
anpv	迣
jhpk	迧
ygpd	迬
qhpi	迯
pxpv	迱
fcpi	迲
lkpd	迴
mgkp	迵
depd	迶
spd	迺
qqpi	迻
fkpd	迼
gqjp	迾
qjpd	迿
fbpv	逇
tmkp	逈
hmnp	逌
sgpd	逎
rfmp	逓
gvap	逕
ctdp	逘
ypd	這
gkpd	逜
lpk	連
iitp	逤
mjdp	逥
wwkp	逧
swwp	逨
dfap	逩
ajpd	逪
cccp	逫
tgdp	逬
rtbp	逰
mfkp	週
wypd	進
ycep	逳
hjfp	逴
jqrp	逷
fufp	逹
fnwp	逺
adkp	逽
jgqp	逿
daep	遀
utep	遃
nugp	遅
yupp	遆
jghp	遈
hmpi	遉
ytbp	遊
plpk	運
kkfp	遌
mnmp	過
fugp	達
nkap	違
fmup	遖
qrmp	遙
ehcp	遚
btxp	遜
lipi	遝
rhap	遞
nufp	遟
fkwp	遠
ubtp	遡
copi	遤
xfmp	遦
ujfp	遧
yump	適
cccp	遪
gkip	遫
gkip	遬
egep	遯
aqpp	遰
lvpd	遱
nitp	遲
awwp	遳
fffp	遶
sdnp	遷
nnap	選
cnhp	遹
khgp	遺
kkup	遻
dujp	遼
tawp	遾
ajmp	邁
lgkp	還
ylkp	邅
wgkp	邆
gwmp	邇
thpp	邉
thpp	邊
tqtp	邌
tlvp	邍
qytp	邎
lxwp	邏
gmyp	邐
sbh	邒
nbh	邔
mbh	邖
gfbh	邘
vbh	邚
qbh	邜
fwbh	邞
ywbh	邟
wvbh	邠
rbh	邤
pqbh	邥
fqbh	邧
gbnb	邨
obh	邩
dtkc	邫
qkbh	邭
ntbh	邲
gnnb	邷
agbh	邼
ffbh	邽
ffbh	邿
dfnb	郀
yntb	郂
wgkb	郃
fkbh	郆
rgkb	郈
gdfb	郉
thbh	郋
ffkc	郌
tebh	郍
yvcc	郒
thnb	郔
dnxb	郕
gkub	郖
kkbh	郘
gehb	郙
gkbh	郚
yveb	郞
dwwb	郟
gjrb	郠
fpbb	郣
wwkb	郤
mbh	郥
rdeb	郩
gvhb	郪
gebh	郬
mfkb	郮
bcbh	郰
uabh	郱
swwb	郲
eqbh	郳
tfab	郵
ukkc	郶
xtvb	郷
hdyb	郹
qqvc	郺
hnvb	郻
nkab	郼
nhbh	郿
adkb	鄀
uxeb	鄁
wgeb	鄃
tkmb	鄅
plbh	鄆
wntb	鄇
wgdb	鄈
xtyb	鄉
xtbb	鄊
ehcb	鄋
ovhb	鄌
pjyb	鄍
thnb	鄎
dfeb	鄏
yxlb	鄐
gogb	鄑
qbtb	鄒
thdb	鄓
wngb	鄔
xtrb	鄕
kmbh	鄖
ykmb	鄗
oveb	鄘
ajdb	鄚
vjsb	鄛
onjb	鄜
nweb	鄝
gjhb	鄟
ffnb	鄠
wvgb	鄡
jlcb	鄤
wvgb	鄥
rlgb	鄦
wgkb	鄧
umic	鄨
vakb	鄩
xjmb	鄪
uljb	鄫
etnb	鄬
usgb	鄭
qyvb	鄮
oqab	鄰
kklb	鄲
xbh	鄳
ogub	鄴
kkkb	鄵
wglb	鄶
magb	鄷
alpb	鄸
oamb	鄺
fwfb	鄻
fwfb	鄼
ojfb	鄽
depb	鄾
akkb	鄿
akub	酀
qkxb	酁
tfqb	酂
akkb	酄
mwyb	酅
tfqb	酇
gmyb	酈
sggf	酑
wyng	酓
sgvf	酔
sgtn	酕
sgpq	酖
sgwc	酘
sguf	酙
sgfq	酛
sgfw	酜
sghk	酟
sgsk	酠
sgny	酦
sgpf	酧
fsgy	酨
sgwg	酫
sgde	酭
sgxe	酳
sggy	酺
sgeb	酻
sgyk	酼
sgwy	醀
sgvi	醁
sgss	醂
sgdn	醃
sgqm	醄
sgaa	醆
sgoo	醈
sgcc	醊
sgdy	醎
sgfj	醏
sgpl	醓
tosg	醔
sgyj	醕
sgjl	醖
sgwq	醗
sgfl	醘
sgec	醙
sgrc	醜
sgua	醝
sgll	醞
oopg	醟
sgml	醠
sgpf	醡
uefg	醤
sgsi	醥
sgce	醦
sgak	醧
sgyc	醨
sggj	醩
atdg	醫
nhdg	醬
sgsf	醰
sgwc	醱
sgme	醲
sglf	醳
sgww	醶
sgun	醷
sgye	醸
sgfj	醹
sgff	醻
sgao	醼
sgfk	醽
sgoo	醾
sgoi	醿
sgye	釀
emgv	釁
sgef	釂
sggx	釃
sgod	釄
sgkt	釅
toi	釆
tony	釈
tolf	釋
fitf	釐
qtyg	釒
qnn	釓
qnn	釔
qbh	釕
qvt	釖
qjh	釗
qsh	釘
qhy	釙
qvn	釚
qet	釛
qfh	針
qtyy	釞
qwy	釟
qwn	釠
wqf	釡
qbt	釢
qqyy	釣
qet	釤
qiy	釥
qkg	釦
qkh	釧
qbg	釨
qwyy	釩
qgfh	釪
qfnn	釫
qfh	釬
qag	釭
qftt	釮
qynn	釯
qvyy	釰
qdy	釱
qnn	釲
qtnn	釳
qayy	釴
qcyy	釵
qbn	釶
qfg	釷
qqy	釸
qvg	釹
qtfh	釺
qvyy	釻
qvyy	釼
qrhy	釽
qaht	釾
qrh	釿
qcn	鈀
qyt	鈁
qpqn	鈂
qgah	鈃
qufh	鈄
qeg	鈅
qwcy	鈆
qfwy	鈇
qdhy	鈈
qmwy	鈉
qny	鈊
qwxn	鈋
qnwy	鈌
qgbn	鈍
qqcy	鈎
qxhh	鈏
qwyn	鈐
qrcy	鈑
qbyy	鈒
qtfg	鈓
qitt	鈔
qnhf	鈕
qwvt	鈖
qcqn	鈗
qfcy	鈘
qhcy	鈙
qxxn	鈚
qay	鈛
qdcy	鈜
qtgh	鈝
qqug	鈞
qxhh	鈟
qwcy	鈠
qkhh	鈡
qsy	鈢
qghn	鈣
qjg	鈤
qoy	鈥
qdyy	鈦
qywn	鈧
qfqn	鈨
qynt	鈩
qdbn	鈪
qyy	鈫
qnyy	鈬
hxqf	鈭
qnxn	鈮
qbmh	鈯
qymh	鈰
qnna	鈱
qrcy	鈲
qskg	鈳
qwyc	鈴
qgmw	鈵
qckg	鈶
qdg	鈷
qdcy	鈸
qhcy	鈹
qgyy	鈺
qhnn	鈻
qthf	鈼
qdmh	鈽
qmg	鈾
qlg	鈿
qlh	鉀
qwet	鉁
qkry	鉂
qtdy	鉃
qrwy	鉄
qang	鉅
qhkg	鉆
qtbn	鉇
qpxn	鉈
qyxy	鉉
qvkg	鉊
qqnn	鉋
qty	鉌
qntt	鉍
qtgg	鉎
qegg	鉏
qdg	鉐
qrg	鉑
qygg	鉒
qtmh	鉓
qamh	鉔
qakg	鉕
qtuy	鉖
qafg	鉗
qxjh	鉘
qkwy	鉙
qqtb	鉚
qwkg	鉛
qwfy	鉜
qug	鉝
qgny	鉞
qdhg	鉟
qmdy	鉠
qugh	鉡
qsgg	鉢
qfcy	鉣
qqkg	鉤
qsyy	鉥
qghg	鉦
qxy	鉧
qqiy	鉨
qwiy	鉩
qann	鉪
qekg	鉫
qhg	鉬
qjgg	鉭
qjhh	鉮
qnyw	鉯
qngk	鉰
qocy	鉱
qhgh	鉲
quxn	鉳
qjy	鉵
qgaj	鉶
qawy	鉷
qywr	鉸
qqqy	鉹
qbg	鉺
qtkg	鉻
quah	鉼
qaay	鉽
qctg	鉾
qwgk	鉿
qvey	銀
qqjg	銁
qyth	銂
qycq	銃
qtmk	銄
qmgk	銅
qdjg	銆
qdiy	銇
qffg	銈
qvgh	銉
qdgy	銊
qwtf	銋
qdhb	銌
qgcf	銍
qmmg	銏
gqjq	銐
qtfq	銑
qgdf	銒
qwgg	銓
qdhf	銔
qgxw	銕
qriy	銖
qrgk	銗
qqkg	銘
qdfn	銙
qqiy	銚
qtdg	銛
tqgs	銜
qwsy	銝
qjqf	銞
qmmh	銟
qftx	銠
qfkg	銡
qfiy	銢
qvkg	銣
qoy	銤
qyey	銥
qldy	銦
qigq	銧
qpvg	銨
qtfc	銩
qdeg	銪
qqcn	銫
qftn	銬
qdxy	銭
qxiy	銯
qary	銰
qkmh	銱
qjfh	銲
qwkq	銳
rrqf	銴
qtmt	銵
qgiy	銶
qieg	銷
qbnn	銸
qtbt	銹
nhdq	銺
quxt	銻
qwwf	銼
qqak	銽
qaiy	銾
qceh	銿
qgku	鋀
qkkg	鋁
qtxy	鋂
qyve	鋃
qgoc	鋄
qufh	鋅
fquq	鋆
qmy	鋇
qgki	鋉
qwwk	鋊
qthp	鋋
qtfp	鋌
qfpb	鋍
qpfq	鋎
qdww	鋏
qpdc	鋐
qcwt	鋑
qtdh	鋒
qtjh	鋓
qqkq	鋔
qfny	鋕
qevg	鋖
qkeg	鋗
qkgd	鋘
qgkg	鋙
whtq	鋚
qkkh	鋛
qkhy	鋜
qefy	鋝
qgva	鋞
qvpc	鋟
qdfe	鋠
qwyk	鋡
qebg	鋢
qahb	鋣
qege	鋤
qkgg	鋥
qnnk	鋦
qhqn	鋧
qtry	鋨
qayn	鋩
qgey	鋪
tjqf	鋫
rrcq	鋬
qukq	鋭
qdny	鋮
qtfk	鋯
qjfg	鋰
qany	鋱
qrgw	鋲
qdtf	鋳
qdqn	鋴
qtwn	鋵
qyck	鋶
qbcy	鋷
qndg	鋸
qdey	鋹
qpqb	鋺
ahnq	鋻
qmum	鋼
qhjf	鋽
qqrm	鋾
qimk	鋿
qwga	錀
qjsy	錁
qfwt	錂
ihcq	錃
qxgi	錄
tqtq	錅
qgeg	錆
qukg	錇
qudb	錈
qqaj	錉
qywf	錊
qeeg	錋
qmdf	錌
qrtf	錍
qqeg	錎
qgfg	錏
qwyg	錐
qyny	錑
qbsk	錒
qufq	錓
qijg	錔
qjxx	錕
hgiq	錖
qtvg	錗
qtfg	錘
qvlg	錙
qqvh	錚
qdfa	錛
qwyn	錜
qpfi	錝
qykb	錞
qooy	錟
qpgh	錠
qdsk	錡
qaay	錢
qccc	錣
qadw	錤
qyce	錥
qrmh	錦
qphn	錧
qalg	錨
qjjg	錩
qmaw	錪
qjqr	錫
qgji	錬
qmfk	錭
qldg	錮
qajg	錯
qsoy	錰
qggf	錱
qviy	録
qblg	錳
qfwf	錴
qawx	錵
qgey	錶
qlnn	錷
qsww	錸
qheg	錹
qayt	錺
qfhy	錻
qdfi	錼
qgot	錽
qhaw	錿
qjgf	鍀
qrqw	鍁
qqg	鍂
qqrn	鍃
qyki	鍄
qifc	鍅
qug	鍆
qxxr	鍇
qamd	鍈
qjgh	鍉
qgli	鍊
qmnk	鍋
itfq	鍌
qoac	鍍
qrfh	鍎
qnkh	鍏
qrbt	鍐
qtjt	鍑
qcns	鍒
qkbg	鍓
qkkn	鍔
qplh	鍕
qadn	鍖
qyuh	鍗
qmjh	鍘
iawq	鍙
qjgr	鍚
qwdc	鍛
qnhc	鍜
qjmy	鍝
qhmy	鍞
qjtg	鍟
qrgg	鍠
qlge	鍡
qgkl	鍢
qavk	鍣
qtfe	鍤
qdhd	鍥
qytb	鍦
qqyg	鍧
qwgd	鍨
qadk	鍩
toqf	鍫
qtoy	鍬
qwnd	鍭
qwgj	鍮
qqrn	鍯
qegc	鍰
qans	鍱
qnaj	鍲
ahnq	鍳
qmdj	鍴
qvgp	鍵
qlny	鍶
qdff	鍷
qdeg	鍸
qpgg	鍹
qftj	鍺
qjqn	鍻
qdgy	鍼
qyna	鍽
qtgf	鍾
qgvl	鍿
qwhe	鎀
qbbh	鎁
qugd	鎂
qire	鎃
qyke	鎄
qlwj	鎅
quej	鎆
qnhg	鎇
quga	鎈
qjng	鎉
qyuy	鎊
qpdk	鎋
quvo	鎌
qfpi	鎍
qrno	鎎
qerm	鎐
qfcl	鎑
qdff	鎒
qwcn	鎓
qpwk	鎔
qovk	鎕
qimy	鎖
qwyk	鎗
qgkh	鎘
qube	鎙
qwnp	鎚
qgef	鎛
tewq	鎜
qawk	鎝
qtlx	鎞
qccs	鎟
qlgh	鎠
quxx	鎡
qwno	鎢
oopq	鎣
qjiq	鎤
whtq	鎥
qqyl	鎦
qmgu	鎧
qwyf	鎨
qrsc	鎩
qehc	鎪
qtmt	鎫
qykk	鎬
qxhw	鎭
qfhw	鎮
qyvb	鎯
quwl	鎰
qfke	鎱
qipq	鎲
qths	鎳
qthn	鎴
qpge	鎵
qskk	鎶
qcoy	鎷
qwyb	鎸
qudp	鎹
qpyg	鎺
qvmy	鎻
qhar	鎼
qmth	鎽
qjlg	鎾
qwgr	鎿
qhlo	鏀
qvjs	鏁
qakk	鏂
qytd	鏃
qgjf	鏄
qwhe	鏅
qxfm	鏆
qyth	鏇
qlpy	鏈
qgkw	鏉
qamy	鏋
qajd	鏌
qlxi	鏍
qjaf	鏎
qdhv	鏏
qnwe	鏐
qyud	鏑
qcce	鏒
qtln	鏓
qpgw	鏔
qonx	鏕
qahf	鏗
qnhf	鏘
qmwy	鏙
qdhy	鏚
qiph	鏛
qipf	鏜
qjlc	鏝
qovh	鏞
qutg	鏟
qtdp	鏠
qujq	鏡
qsfi	鏢
qoao	鏣
qlvg	鏤
qpwj	鏥
qtwh	鏦
fnwq	鏧
lrqf	鏨
qlrh	鏩
qgmj	鏪
qtjs	鏫
qhaf	鏬
qton	鏭
qovi	鏮
qdrr	鏯
qmee	鏰
qujf	鏱
qyxg	鏲
qulj	鏳
qkhk	鏴
qagf	鏵
qwys	鏶
qogw	鏷
qgjn	鏸
qxkj	鏹
qwxc	鏺
qoqh	鏻
qtgi	鏼
qvfj	鏽
qaet	鏾
qips	鏿
qkhm	鐀
qadr	鐁
qgjl	鐂
qffq	鐃
qamw	鐄
umiq	鐅
bueq	鐆
qtol	鐇
qtdk	鐈
qnnw	鐉
qbjr	鐊
qijr	鐋
qqke	鐌
qcnk	鐍
qwyo	鐎
qusf	鐏
qdui	鐐
qxfk	鐑
qooe	鐒
qykt	鐓
qsjf	鐔
qaqj	鐕
qxxy	鐖
queg	鐗
qujf	鐘
qwgu	鐙
qgfn	鐚
qjyi	鐛
ykbq	鐜
qduw	鐝
qvaf	鐞
qfwj	鐟
quoj	鐠
qfky	鐡
srrq	鐢
qipr	鐣
qhnn	鐤
qugk	鐥
quga	鐦
qujg	鐧
qxjm	鐨
quep	鐩
qhae	鐪
qwym	鐫
qhdy	鐬
qtmd	鐭
qouo	鐮
qafj	鐯
qkks	鐰
qwgw	鐱
qlqj	鐲
qflg	鐳
qnkf	鐴
qfky	鐵
qlge	鐶
qaas	鐷
qlff	鐸
qmnp	鐹
qipl	鐺
qhae	鐻
qfam	鐼
qfup	鐽
qujn	鐿
qept	鑀
qobt	鑁
qtgo	鑂
qnwy	鑃
qfnf	鑄
qoos	鑅
qogf	鑆
qyuj	鑇
qgwr	鑈
qafl	鑉
qawc	鑊
lgvq	鑋
qpgm	鑌
mmqf	鑍
qakm	鑎
qpns	鑏
qfdj	鑐
qahl	鑑
ahnq	鑒
qkhp	鑓
qpwi	鑔
qrrm	鑕
qaly	鑖
qtqi	鑗
qlll	鑘
qtdj	鑙
qfwm	鑚
qoaw	鑛
qipm	鑜
qatp	鑝
qvln	鑞
qflm	鑟
qrxs	鑠
qhbh	鑡
qhan	鑢
qono	鑣
qjai	鑤
qqoj	鑥
qahm	鑦
qpay	鑧
qued	鑨
qgkk	鑩
qhal	鑪
qahq	鑬
qugi	鑭
qaif	鑮
qwwy	鑯
qwga	鑰
qqky	鑱
qyke	鑲
qpah	鑳
qmwk	鑴
qaky	鑵
qady	鑶
qbbb	鑷
qllf	鑸
qpwn	鑹
qhhy	鑺
qsrr	鑻
qlxy	鑼
qtfm	鑽
yxxq	鑾
oguq	鑿
qhay	钀
qhhc	钁
qipo	钂
qnij	钃
qaui	钄
qbyy	钑
qnrt	钖
qgah	钘
qqnn	铇
qgaj	铏
qayn	铓
qgog	铔
qgcf	铚
qtdg	铦
qgkg	铻
qdsk	锜
qjjg	锠
qrfm	锧
qamd	锳
qrgg	锽
quxx	镃
qgef	镈
qipq	镋
qpwk	镕
qmee	镚
qnwe	镠
qlge	镮
qvln	镴
qqky	镵
deu	長
dcu	镸
dcqy	镹
dctd	镺
dcrw	镻
dcnm	镼
dcdi	镽
dcgr	镾
uhng	門
ute	閁
ugd	閂
uwi	閃
uwy	閄
usk	閅
udd	閆
ughi	閇
ufk	閈
ufte	閉
umk	閊
ugak	開
uywv	閌
uye	閍
udci	閎
ugd	閏
utfn	閐
usi	閑
ued	閒
ujd	間
uyi	閔
uaht	閕
uii	閖
uufk	閗
ulk	閘
uymh	閙
uud	閚
uguf	閛
uskd	閜
uwyc	閝
ucak	閞
unte	閟
ugyi	閠
uynw	閡
uudi	関
utkd	閣
uwgk	閤
uwai	閥
uwww	閦
uawi	閧
uffd	閨
uji	閩
usd	閪
ulsi	閫
uyve	閬
ukkd	閭
utfp	閮
uiit	閯
ued	閰
uwkq	閱
uukq	閲
ulk	閳
umi	閴
uwyd	閵
ujjd	閶
rsuw	閷
ugfg	閸
udjn	閹
ujyi	閺
uqed	閻
uywu	閼
uqaj	閽
uakg	閾
uepc	閿
uawn	闀
uud	闁
uudb	闂
uhdy	闃
usvd	闄
uhhc	闅
ukkk	闆
uujd	闇
unkh	闈
usfd	闉
uitd	闊
uwgd	闋
ugli	闌
uftj	闍
urii	闎
uwtj	闏
ufhw	闐
uths	闑
ujnd	闒
umgu	闓
ufcl	闔
uubw	闕
ucoi	闖
uxxo	闗
ugkf	闘
uynk	闙
ufwq	闚
uipf	闛
uxxg	關
umti	闝
unbt	闞
uwgn	闟
ukhm	闠
ukkl	闡
unkf	闢
uipl	闣
ulge	闤
ufup	闥
umau	闦
ufkp	闧
ufk	闬
umnv	闿
uftj	阇
ukhm	阓
ujnd	阘
ulge	阛
bet	阞
bnfh	阠
btnn	阣
bbn	阤
biy	阥
boy	阦
bufh	阧
bdbn	阨
btah	阩
bdhy	阫
bywn	阬
bcqn	阭
bhg	阯
bxxn	阰
bghg	阷
bynn	阸
bfcy	阹
bqay	阺
bwyc	阾
btbn	陁
bgmw	陃
bqqy	陊
briy	陎
bdeg	陏
bdmj	陑
bqdb	陒
bdfn	陓
bcwt	陖
bieg	陗
bgva	陘
bdfe	陙
bfhy	陚
bdww	陜
bdty	陝
btaf	陞
bgey	陠
blh	陣
bqhj	陥
bdtf	陦
bhdd	陫
bdsk	陭
bwyg	陮
bwga	陯
bwyc	陰
bqoy	陱
bgji	陳
bfwf	陸
btaj	陹
bwgw	険
bsfg	陻
bftj	陼
bjgr	陽
bdmd	陾
badw	陿
btgf	隀
bajv	隁
bwdc	隂
bwgj	隃
bjgh	隄
bdgy	隇
beag	隉
buey	隊
bujg	隌
bxxr	階
bmgu	隑
buvo	隒
bdaa	隓
bkmy	隕
bwno	隖
bipf	隚
bwfi	際
bwvo	隝
bgqt	隞
bvjs	隟
bevn	隠
butg	隡
bffq	隢
boqh	隣
bkhm	隤
bwgu	隥
bnkf	隦
bdap	隨
btmd	隩
bwgw	險
bfam	隫
bgwr	隬
bfdj	隭
byuj	隮
bfnf	隯
bean	隱
bito	隲
bued	隴
bhaa	隵
ffii	隷
sfii	隸
pwyd	隺
wycu	隻
aywy	隿
wyny	雂
gawy	雃
hghy	雈
qkwy	雊
wyhm	雋
hawy	雐
vswy	雑
wgsy	雓
wywy	雔
kjwy	雖
fjfy	雗
myac	雘
wywc	雙
akky	雚
qbty	雛
ywwy	雜
vkcy	雝
exdy	雞
btwk	雟
nwey	雡
yrby	離
akfy	難
erry	雤
wywy	雥
wywy	雦
wyws	雧
fghu	雫
fsu	雬
fbyu	雭
ftfn	雮
fwvr	雰
fyr	雱
ffcu	雲
fuf	雴
fmdu	雵
faff	雸
fcnt	雺
fjnb	電
fdf	雼
ftuf	雽
fqiu	雿
fisu	霂
fipq	霃
fyf	霅
ffog	霊
fgvv	霋
fmfk	霌
fixc	霐
fihk	霑
ffcn	霒
fiyg	霔
ffcn	霕
fiwc	霗
fimk	霘
famd	霙
fcnt	霚
fxxx	霛
fkkk	霝
fiaw	霟
fuwn	霠
feyi	霡
fere	霢
fkmu	霣
fqyl	霤
fpfe	霥
fsse	霦
fcne	霧
fnff	霨
fykb	霩
fnrf	霫
flaw	霬
fian	霮
fwgu	霯
fcnk	霱
fbtg	霳
ffci	霴
fkby	霵
fiyy	霶
fjjr	霷
ftmt	霺
fmau	霻
ffco	霼
fyuj	霽
fcnh	霿
fape	靀
flll	靁
fdth	靂
fwyy	靃
fyjn	靄
ffcm	靅
ffcp	靆
fued	靇
fkkw	靈
ffct	靉
fmdu	靊
fidh	靋
fpgm	靌
fwyo	靍
fqwo	靎
fpwo	靏
flfl	靐
gmhg	靑
gern	靔
ghge	靕
geiq	靗
geqc	靘
gehq	靚
geeh	靜
gero	靝
hdhn	靟
dlkf	靣
dmjn	靤
dmjq	靦
dmjm	靧
djed	靨
akfs	靪
akfy	靫
akff	靬
akfy	靭
akfy	靮
akff	靯
akfq	靰
akfy	靱
akfn	靲
akff	靵
akfh	靷
akfy	靸
akfw	靹
akfs	靺
akfg	靻
akfg	靽
akfn	靾
akfe	靿
akfk	鞀
akfc	鞁
akft	鞂
akfc	鞃
akfn	鞄
akfw	鞆
akfd	鞇
akfk	鞈
akfi	鞉
akfk	鞊
pvaf	鞌
akfe	鞎
awyf	鞏
akfh	鞐
akfg	鞓
akfr	鞕
akfv	鞖
whtf	鞗
akfe	鞙
akfa	鞚
akfk	鞛
akfj	鞜
akfk	鞝
akff	鞞
akfb	鞟
akfu	鞡
akfs	鞢
ffff	鞤
akfa	鞥
akfo	鞦
akfg	鞧
akfn	鞨
akfj	鞩
cnhf	鞪
akfp	鞬
akfh	鞮
akfl	鞰
akfe	鞱
akfk	鞳
akfd	鞵
tewf	鞶
gkmf	鞷
akff	鞸
akfb	鞹
akff	鞺
akfv	鞻
akfm	鞼
akfk	鞽
akff	鞾
akfy	鞿
akfo	韀
akfg	韁
akfy	韂
akfp	韃
akfc	韄
akfo	韅
akfp	韆
akfm	韇
akfy	韈
akfo	韉
akfi	韊
nkah	韋
nkay	韌
nkay	韍
nkas	韎
udnh	韏
nkak	韐
igqh	韑
nkae	韒
fjfh	韓
nkae	韔
nkab	韕
nkas	韖
nkal	韗
nkas	韘
jghh	韙
nkaf	韚
nkah	韛
nkae	韜
nkaf	韝
nkal	韞
nkaf	韟
nkaf	韠
nkaf	韡
nkan	韢
nkaj	韣
nkay	韤
nkam	韥
fnhy	韨
ahdg	韮
fhdy	韯
hqcg	韰
wwgy	韱
yuhg	韲
ujgh	韴
ujbm	韷
ujth	韸
ujrg	韹
ujad	韺
ujkm	韻
ujtp	韼
wynj	韽
fnwj	韾
xtyj	響
ujac	頀
dmu	頁
sdmy	頂
xdmy	頃
vdmy	頄
admy	項
kdmy	順
fdmy	頇
edmy	須
hdmy	頉
gdmy	頊
dbdm	頋
wcdm	頌
fcdm	頍
rdmy	頎
ywdm	頏
cnhm	預
fqdm	頑
wvdm	頒
gbnm	頓
mdmy	頔
hkdm	頕
ugdm	頖
hcdm	頗
wycm	領
ghdm	頙
cfdm	頚
didm	頛
wgkm	頜
ywrm	頝
pvdm	頞
tkdm	頟
qdbm	頠
fkdm	頡
tddm	頢
ahnm	頣
ahkm	頤
hahm	頥
yntm	頦
wnnm	頧
ndmy	頨
uadm	頩
odmy	頪
qidm	頫
gudm	頬
gkum	頭
iadm	頮
qadm	頯
dwwm	頰
efdm	頱
tfpm	頲
fodm	頳
xfim	頴
vtkm	頵
tfkm	頶
wynm	頷
gvam	頸
tqdm	頹
tbdm	頺
hhdm	頻
gkim	頼
twdm	頽
edmx	頾
ehxm	頿
wydm	顀
pghm	顁
swwm	顂
oodm	顃
bibm	顄
ynem	顅
jsdm	顆
ywwm	顇
xxim	顈
qdmy	顉
wnnm	顊
lndm	顋
jghm	題
ptkm	額
kkfm	顎
ydem	顏
pldm	顐
dgkm	顑
jmhm	顒
mdmm	顓
utem	顔
jogm	顕
tlrm	顖
mgkm	顗
drim	願
cccm	顙
xhnm	顚
fhwm	顛
amfm	顜
medm	顝
odym	類
nwem	顟
sfim	顠
uedm	顡
amhm	顢
dhgm	顣
fffm	顤
jykm	顥
wyom	顦
ynwm	顧
dmdj	顨
wgkm	顩
hdgm	顪
ylkm	顫
fdmm	顬
alpm	顭
pghm	顮
jxxm	顯
hhdf	顰
halm	顱
ooym	顲
bbbm	顳
akkm	顴
tfpm	颋
xodm	颎
iadm	颒
xfim	颕
jmhm	颙
oxim	颣
wtji	風
wtje	颩
ghwj	颪
wtjw	颫
wtjt	颬
wtjk	颭
wtjn	颮
uwtj	颯
wtjy	颰
wtjk	颱
wtjj	颲
wtjd	颳
wtjh	颴
wtje	颵
wtjw	颶
wtjo	颷
wtjn	颸
wtjh	颹
wtjr	颺
ermj	颻
wtjc	颼
mgkj	颽
wtjj	颾
cowj	颿
wtjl	飀
nrwj	飁
wtje	飂
wtji	飃
sfij	飄
wtjl	飅
dydj	飆
wtjy	飇
wtjo	飈
wtji	飉
oooj	飊
wtjt	飋
akkj	飌
wtjj	飍
wrnr	飏
wrhk	飐
wrln	飔
ermr	飖
wrql	飗
nuth	飛
tolh	飜
nuth	飝
wyty	飠
uwye	飡
wywn	飢
wysh	飣
wywy	飤
wyta	飥
wyfh	飦
wygn	飩
wytf	飪
wytd	飫
udye	飬
wyte	飭
wyvw	飮
wyrc	飯
wyyh	飰
gqwe	飱
wyqw	飲
wyyg	飳
wyck	飴
wytf	飵
wynt	飶
wyeg	飷
kgne	飸
wyqb	飹
hxwe	飺
wywe	飻
wynk	飼
wyqn	飽
wyth	飾
wybm	飿
wyar	餀
wywf	餁
wytd	餂
wyyr	餃
wywk	餄
wyua	餅
wyqi	餆
wymk	餇
uqwe	餈
wytk	餉
ufwe	養
udwe	餋
wybg	餌
wytk	餎
wyye	餏
wyfb	餑
wyev	餒
wyty	餓
wygy	餔
wyct	餕
wygu	餖
wygi	餗
wyws	餘
wyrh	餙
wyre	餚
wyjx	餛
wyjs	餜
wyay	餝
wyaa	餞
wycc	餟
wytf	餠
wyqe	餡
wyuk	餢
wydn	餣
wyoo	餤
hdhe	餥
wyde	餦
wytv	餧
wypn	館
wyww	餩
wydd	餪
wypl	餫
wyde	餬
wyrg	餭
wyxe	餯
wyts	餰
wywd	餱
wyjn	餲
wyjr	餳
wyda	餴
wyle	餵
wyme	餶
wysg	餷
wyup	餸
wyok	餹
wygf	餺
wyuo	餻
wyro	餼
wyrc	餽
wyql	餾
wyec	餿
wyee	饀
wyfl	饁
wyjl	饂
wyad	饃
wyif	饄
wyjc	饅
wyjf	饆
wyak	饇
wyuf	饈
wyag	饉
wyat	饊
wykm	饋
wynw	饌
wyuk	饍
wyfk	饎
nbte	饏
wyfu	饐
wyxy	饑
wyfq	饒
wyis	饓
wyhy	饖
xtye	饗
wyyg	饘
wyfm	饙
wyal	饚
wyae	饛
djee	饜
wyod	饝
wyqy	饞
wyye	饟
wyly	饠
wytm	饡
wyge	饢
qnsh	饤
qnta	饦
qnbm	饳
qnwk	饸
qntk	饹
qnye	饻
qngu	饾
qnct	馂
qnjs	馃
qnme	馉
qnfl	馌
qngf	馎
tjwv	馚
tjdy	馛
tjnx	馜
tjnt	馝
tjfb	馞
tjeb	馟
tjwk	馠
tjhd	馡
tjaa	馢
tjdn	馣
tjjn	馤
tjuo	馦
tjjl	馧
tjfm	馩
tjpm	馪
tjtj	馫
coi	馬
cocy	馭
ucoy	馮
cofh	馯
coqy	馰
cody	馱
cota	馲
cobn	馳
cokh	馴
coaj	馵
cofc	馶
cogh	馷
corh	馸
cojg	馹
coby	馺
cocq	馻
coyy	馼
cokh	馽
copq	馾
coyn	馿
cody	駀
corr	駁
xfco	駂
conw	駃
cody	駄
cony	駅
coar	駆
coty	駇
corg	駈
comk	駉
cohc	駊
covk	駋
qbco	駌
cogf	駍
comg	駎
coan	駏
coyg	駐
vcco	駑
coqk	駒
codg	駓
coeg	駔
ekco	駕
cowc	駖
cowe	駗
cock	駘
cowf	駙
comd	駚
cokr	駛
cont	駜
copx	駝
cotb	駞
colg	駟
coqb	駠
kkco	駡
coua	駢
coqi	駣
cogf	駤
coad	駥
udco	駦
comk	駧
coqj	駨
cowg	駩
cotq	駪
coiq	駫
cobg	駬
coyw	駭
coyr	駮
cori	駯
cold	駰
cotk	駱
coyh	駲
cotp	駳
coaa	駴
cogn	駵
conk	駶
cogi	駷
covc	駸
cody	駹
coye	駺
cojf	駻
cows	駼
coke	駽
couq	駾
coct	駿
coty	騀
comn	騁
couf	騂
cocd	騃
covi	騄
cowy	騅
comk	騆
cowk	騇
cotf	騈
cojx	騉
coqm	騊
cosw	騋
copi	騌
cojs	騍
codk	騎
coaw	騏
cown	騐
cohd	騑
cocj	騒
coww	験
cojn	騔
cosv	騕
cnho	騖
ynmo	騗
coqn	騘
coya	騙
couj	騚
conh	騛
corg	騜
covp	騝
codd	騞
cowj	騟
cojh	騠
cori	騡
conc	騢
cort	騣
cowd	騤
cocs	騥
coln	騦
comk	騧
coil	騨
corc	騩
coec	騪
pawo	騫
cotx	騬
bhho	騭
coql	騮
coyy	騯
eudo	騰
coed	騱
coaf	騲
coco	騳
cojv	騴
codi	騵
coqt	騶
cocj	騷
coyn	騸
coag	騹
fufo	騺
codr	騻
coox	騼
conr	騽
coli	騾
couf	騿
ajdo	驀
gqto	驁
coce	驂
cosi	驃
cotn	驄
coak	驅
cojf	驆
fwfo	驇
cock	驈
cohg	驉
coaf	驊
cowc	驋
covj	驌
cofq	驍
cooh	驎
conb	驏
coyt	驐
cogl	驑
cokl	驒
couj	驓
cosf	驔
cotk	驕
cofy	驖
coww	驗
ynky	驘
coyg	驙
aqko	驚
colf	驛
cooi	驜
cofs	驝
copm	驞
cobi	驟
coao	驠
uego	驡
cohl	驢
couo	驣
coye	驤
couw	驥
cofh	驦
coao	驧
comk	驨
coay	驩
cogx	驪
coco	驫
cgjg	驲
cgld	骃
cgcg	骉
cguf	骍
cgvc	骎
cgpi	骔
cgvj	骕
cgwd	骙
cgfh	骦
mevn	骩
mewy	骪
mevy	骫
megf	骬
mefh	骭
meay	骮
meyw	骯
meqn	骲
mehc	骳
mehx	骴
mesg	骵
meyr	骹
medn	骻
meev	骽
megr	骾
meua	骿
mejy	髃
medp	髄
megf	髆
meyk	髇
meyy	髈
mepy	髉
meua	髊
meos	髍
mene	髎
melv	髏
mefq	髐
meaa	髒
memu	體
mepm	髕
mepy	髖
mehl	髗
yjfk	髙
ykmw	髚
ykmv	髛
ykma	髜
ykme	髝
ykms	髞
dcew	髠
dceb	髢
dcey	髣
dces	髤
dcef	髥
dceq	髧
dceq	髨
dcen	髩
dcec	髪
dceg	髬
dcey	髮
dcen	髰
dcen	髱
dcec	髲
dcet	髳
dcej	髴
dcej	髵
dceb	髶
dcea	髷
dcew	髸
dced	髺
dceh	髼
dcef	髽
dcee	髾
dcet	髿
dcet	鬀
dcej	鬁
dcew	鬂
dcer	鬄
dcee	鬅
dcec	鬆
dceh	鬇
dcet	鬉
dcej	鬊
dcej	鬋
dcee	鬌
dcee	鬍
dcej	鬎
dcej	鬐
dceo	鬑
dcew	鬒
dcep	鬔
dced	鬕
dcee	鬖
dcey	鬗
dcec	鬘
dcej	鬙
dcem	鬚
dcen	鬛
dcee	鬜
dcej	鬝
dcee	鬞
dcej	鬠
dces	鬡
dcem	鬢
dcee	鬤
hggh	鬥
hggf	鬦
hggh	鬧
hggw	鬨
hggq	鬩
hggf	鬪
hggt	鬫
hggr	鬬
hggr	鬭
hggx	鬮
srre	鬰
srme	鬱
hagh	鬳
gkmy	鬴
aqah	鬵
fwmh	鬶
gkmt	鬷
gkml	鬸
fwhh	鬹
gkmr	鬺
rqce	鬽
rqcc	鬾
rqcr	鬿
rqcj	魀
rqcy	魆
rqcg	魊
rqcy	魋
rqcw	魌
rqcy	魎
rqco	魐
rqci	魒
rqcf	魓
rqcy	魕
rqcg	魖
fnac	魗
djec	魘
ilrc	魙
qou	魚
qovt	魛
qowy	魜
qojh	魝
qoty	魞
qoag	魟
qota	魠
qoqy	魡
qonn	魢
qoch	魣
qowx	魤
qoby	魥
qoit	魦
qoyw	魧
qogn	魨
qoqr	魩
qowj	魪
qopq	魫
qorc	魬
qofq	魭
qoxx	魮
qojf	魯
qoyy	魰
qogg	魱
qoyn	魲
qogh	魳
qoyt	魴
qowv	魵
qomw	魶
qody	魷
qotn	魸
qotn	魹
qosk	魺
qolh	魻
qofc	魼
qoaf	魽
qodg	魾
qowc	魿
qopx	鮀
qody	鮁
qolw	鮂
qogf	鮃
qoxj	鮄
qont	鮅
hxqo	鮆
qofi	鮇
qoqk	鮈
qovk	鮉
qorg	鮊
qomg	鮋
qoyx	鮌
qohc	鮍
qohk	鮎
qotg	鮏
qock	鮐
qoqn	鮑
qowf	鮒
qotf	鮓
qoan	鮔
qodg	鮕
qodg	鮖
qotu	鮗
qowy	鮘
qong	鮙
qofk	鮚
qohi	鮛
qork	鮜
udqo	鮝
qodj	鮞
qopv	鮟
qoqb	鮠
qoqi	鮡
qori	鮢
qoqb	鮣
gqjo	鮤
qotk	鮥
qomk	鮦
qogw	鮧
qoxj	鮨
qoua	鮩
qode	鮪
qoyr	鮫
qodn	鮬
qoff	鮭
qoug	鮮
qowk	鮯
qolk	鮰
qofx	鮱
qowy	鮲
qofn	鮳
qows	鮴
qouq	鮵
qovk	鮶
qout	鮷
qoqq	鮸
qoie	鮹
ugqo	鮺
qoct	鮻
qovc	鮼
qows	鮽
qoev	鮾
qobn	鮿
qoti	鯀
qogr	鯁
qosg	鯂
qogk	鯃
qogy	鯄
qotp	鯅
qogy	鯆
qopq	鯇
whto	鯈
qojf	鯉
iito	鯊
qoit	鯋
qotk	鯌
qoyk	鯍
qody	鯎
qotj	鯏
qofh	鯐
qorh	鯑
qoch	鯒
qott	鯓
qovl	鯔
qoaw	鯕
qoge	鯖
ufwo	鯗
qotv	鯘
qoyb	鯙
qotb	鯚
qomk	鯛
qouv	鯜
qold	鯝
qovh	鯞
qogi	鯟
qosw	鯠
qohd	鯡
qoeq	鯢
qojr	鯣
qojx	鯤
qoff	鯥
qotk	鯦
qojj	鯧
qoyi	鯨
qowa	鯩
qoft	鯪
qobc	鯫
tqto	鯬
qobl	鯭
qopi	鯮
qorj	鯯
qown	鯰
qohw	鯱
qoyu	鯲
qooy	鯳
qonj	鯴
qoce	鯵
qopl	鯶
qojh	鯷
qowd	鯸
qojg	鯹
qofj	鯺
qogj	鯻
qort	鯼
qovb	鯽
qowr	鯾
qoya	鯿
qoec	鰀
qori	鰁
qomj	鰂
qole	鰃
qody	鰄
qojy	鰅
qodj	鰆
qocs	鰇
qoas	鰈
qorg	鰉
qogi	鰊
qoav	鰋
qoug	鰌
qoto	鰍
qovp	鰎
qogl	鰏
qokn	鰐
qojr	鰑
qott	鰒
qoln	鰓
qody	鰔
qonc	鰕
qode	鰖
qode	鰗
qopf	鰘
qoak	鰙
qopg	鰚
qojl	鰛
qouo	鰜
qoyk	鰝
qowo	鰞
qoyy	鰟
qocj	鰠
qoql	鰡
qoco	鰢
qojf	鰣
qowh	鰤
qoli	鰥
qoux	鰦
eudo	鰧
qojn	鰨
qoem	鰩
qofl	鰪
qopk	鰫
qohy	鰬
qofj	鰭
qoll	鰮
qoxu	鰯
qoph	鰰
qolp	鰱
gqto	鰲
qoae	鰳
qomt	鰴
txto	鰵
qowi	鰶
qows	鰷
qoak	鰸
qoaf	鰹
qoce	鰺
qojc	鰻
qonr	鰼
qogj	鰽
qosi	鰾
qogm	鰿
vcao	鱀
qogp	鱁
qonf	鱂
qouf	鱃
qogf	鱄
qooh	鱅
qouf	鱆
qooi	鱇
qofv	鱈
umio	鱉
qock	鱊
qohg	鱋
qoqe	鱌
qowc	鱍
qotk	鱎
qosf	鱏
qovj	鱐
qoaw	鱑
qouf	鱒
qokl	鱓
qouk	鱔
qotl	鱕
qodw	鱖
qooh	鱗
qovf	鱘
qofq	鱙
qofk	鱚
qouj	鱛
qoxb	鱜
qofm	鱝
qole	鱞
erro	鱟
qowj	鱠
qomd	鱡
qoks	鱢
qoyg	鱣
qodn	鱤
qohy	鱥
qoxg	鱦
qomu	鱧
qoij	鱨
qofl	鱩
qojj	鱪
qoet	鱫
qofj	鱬
qoyj	鱭
qoew	鱮
qoac	鱯
qolj	鱰
qody	鱱
qovn	鱲
qors	鱳
qoay	鱴
qoty	鱵
qoue	鱶
qogk	鱷
qohl	鱸
qoay	鱹
qogx	鱺
qoqo	鱻
qgvt	鱽
qgnn	鱾
qggn	鲀
qgcn	鲃
qgsk	鲄
qgmg	鲉
qgtf	鲊
qgrg	鲌
qghc	鲏
qgfn	鲓
qgmk	鲖
qgmj	鲗
qgrk	鲘
qgwc	鲙
ugqg	鲝
qgvk	鲪
qgch	鲬
qgaw	鲯
qgce	鲹
qggl	鲾
qgic	鲿
qgjh	鳀
qgjl	鳁
qgle	鳂
qgri	鳈
qguf	鳉
qgyy	鳑
qguo	鳒
qgnf	鳚
qgnr	鳛
qgac	鳠
qgdn	鳡
qgyg	鳣
qgtn	鳤
wvgo	鳥
wvgn	鳦
wvgw	鳧
wvge	鳨
vwvo	鳩
hwvo	鳪
dwvo	鳫
wvgw	鳬
vwvo	鳭
cwvo	鳮
wwvo	鳯
tywo	鳰
fwvo	鳱
nwvo	鳲
wdho	鳳
kwvo	鳴
nfwo	鳵
aywo	鳶
fcwo	鳷
ynwo	鳸
wyno	鳹
fwwo	鳺
wvwo	鳻
ywvo	鳼
gawo	鳽
gmho	鳾
gwvo	鳿
dhwo	鴀
tdwo	鴁
nwwo	鴂
wvgw	鴃
aqwo	鴄
mywo	鴅
pqwo	鴆
xfwo	鴇
dwwo	鴈
ahto	鴉
ghwo	鴊
ywvo	鴋
gdwo	鴌
ywvo	鴍
arwo	鴎
wvgy	鴏
ekwo	鴐
vcwo	鴑
wyco	鴒
ntwo	鴓
tpwo	鴔
wvgx	鴕
nnao	鴖
uwvo	鴗
cawo	鴘
tdwo	鴙
wvgk	鴚
qbwo	鴛
hxwo	鴜
qkwo	鴝
kgno	鴞
qayo	鴟
jgwo	鴠
egwo	鴡
xewo	鴢
dwvo	鴣
wvgu	鴤
wvgw	鴥
mdwo	鴦
pwwo	鴧
lwvo	鴨
rwwo	鴩
pwwo	鴪
lwvo	鴫
ipwo	鴬
wnno	鴭
dfno	鴮
dmjo	鴯
tdwo	鴰
arwo	鴱
xjwo	鴲
pvwo	鴳
tgso	鴴
qiwo	鴵
fkwo	鴶
gqjo	鴷
riwo	鴸
ugwo	鴹
gxwo	鴺
iawo	鴻
wvgk	鴼
vkwo	鴽
ctgo	鴾
wgko	鴿
wtfo	鵀
ywro	鵁
wswo	鵂
tewo	鵃
gcfo	鵄
tkwo	鵅
twvs	鵆
rhfo	鵇
bwvo	鵈
yowo	鵉
dwwo	鵊
nnwo	鵋
wvgs	鵌
pfqo	鵍
evwo	鵎
geho	鵏
awwo	鵐
kewo	鵑
wwko	鵒
fpbo	鵓
wvgt	鵔
cwto	鵕
vcwo	鵖
rdmo	鵗
vtko	鵘
mwvo	鵙
twwo	鵚
gvao	鵛
uxho	鵜
trxo	鵝
trxo	鵞
qtgo	鵟
tfko	鵠
fhno	鵡
tmdo	鵢
gkio	鵣
qeho	鵤
ugjo	鵥
wvgi	鵦
uawo	鵧
wgdo	鵨
ebco	鵩
djno	鵪
hjfo	鵫
eewo	鵬
qwvo	鵭
qewo	鵮
rtfo	鵯
mfko	鵰
fwfo	鵱
ajwo	鵲
yneo	鵳
qowo	鵴
qkqo	鵵
gfgo	鵶
pqbo	鵷
dsko	鵸
tqto	鵹
ywto	鵺
wvgy	鵻
pwao	鵼
ccco	鵽
jxxo	鵾
wvga	鵿
wvgw	鶀
ykio	鶁
eqwo	鶂
wvgq	鶃
gewo	鶄
vlwo	鶅
swwo	鶆
gjio	鶇
gvho	鶈
ykbo	鶉
ovwo	鶊
ndwo	鶋
nbmo	鶌
jqro	鶍
pfio	鶎
efwo	鶏
sypo	鶐
oowo	鶑
gkio	鶒
alwo	鶓
cnho	鶔
ujwo	鶕
towo	鶖
jgho	鶗
dewo	鶘
yupo	鶙
kkfo	鶚
xxro	鶛
acno	鶜
gklo	鶝
rfho	鶞
pwdo	鶟
ajvo	鶠
jqwo	鶡
egdo	鶢
ynmo	鶣
plwo	鶤
nhwo	鶥
dewo	鶦
amdo	鶧
xgeo	鶨
cnho	鶩
hdyo	鶪
glio	鶫
wyvo	鶬
xywo	鶭
ykmo	鶮
oopo	鶯
kmwo	鶰
pawo	鶱
wcno	鶲
wvgh	鶳
pwyo	鶴
qbto	鶵
ovho	鶶
pdho	鶷
xuxo	鶸
qyvo	鶹
iweo	鶺
mewo	鶻
uvoo	鶼
wyfo	鶽
fjfo	鶾
uxxo	鶿
uxxo	鷀
uwlo	鷁
ermo	鷂
jpvo	鷃
exdo	鷄
sswo	鷅
xhno	鷆
fpdc	鷇
wvgw	鷈
rhao	鷉
gkmo	鷊
awgo	鷋
wvgo	鷌
thso	鷍
rdfo	鷎
fhwo	鷏
jdfo	鷐
tuwo	鷑
gjho	鷒
oaoo	鷓
gqto	鷔
kwyo	鷕
atdo	鷖
akko	鷗
gkio	鷘
fufo	鷙
nweo	鷚
oveo	鷛
lvwo	鷜
jafo	鷝
drro	鷞
ytto	鷟
qowo	鷠
rlgo	鷡
dubo	鷢
sjfo	鷣
kklo	鷤
xxio	鷥
wyoo	鷦
fpgo	鷧
agao	鷨
umio	鷩
hhpo	鷪
vfjo	鷫
amwo	鷬
tolo	鷭
tdko	鷮
dujo	鷯
akuo	鷰
thio	鷱
ykio	鷲
uewo	鷳
uswo	鷴
nfto	鷵
lmwo	鷶
usgo	鷷
cnho	鷸
owwo	鷹
khto	鷺
wvgt	鷻
ujwo	鷼
erro	鷽
ujno	鷾
nkuo	鷿
lqjo	鸀
ynky	鸁
iexo	鸂
wvgy	鸃
ryto	鸄
lfuo	鸅
hako	鸆
ylko	鸇
oguo	鸈
sjgo	鸉
nkuo	鸊
pnlo	鸋
wvgc	鸌
gwmo	鸍
mmwo	鸎
apfo	鸏
nwyo	鸐
qtyo	鸑
egno	鸒
lllo	鸓
wvgi	鸔
halo	鸕
fwyo	鸖
uego	鸗
fsho	鸘
wgko	鸙
mmvo	鸚
akko	鸛
hhwo	鸜
gmyo	鸝
yxxo	鸞
nqyg	鸤
wbqg	鸧
kgng	鸮
wycg	鸰
ipqg	鸴
tgsg	鸻
teqg	鸼
awwg	鹀
jxxg	鹍
qeqg	鹐
ovwg	鹒
pqbg	鹓
vijg	鹔
jqwg	鹖
toqg	鹙
gkmg	鹝
wcng	鹟
qyvg	鹠
iweg	鹡
uwlg	鹢
atdg	鹥
lgkg	鹮
ylkg	鹯
apfg	鹲
fshg	鹴
hlou	鹵
hlon	鹶
hloc	鹷
hlow	鹸
hloy	鹹
hloa	鹺
hloo	鹻
hlow	鹼
ahnl	鹽
onjx	麀
qonx	麁
onjo	麃
wvox	麄
onjn	麅
onjg	麆
ffox	麉
oonx	麊
onjd	麌
onjk	麍
onje	麎
onjk	麏
onjk	麐
onjq	麑
onjk	麔
onjt	麕
onji	麖
gmyx	麗
onjj	麘
onjy	麙
onjc	麚
onjb	麛
onjs	麜
onjf	麞
onjg	麠
onjj	麡
onjk	麢
onjt	麣
onjx	麤
swwq	麥
swwn	麧
swwt	麨
swww	麩
swwn	麪
swwn	麫
swwc	麬
swwn	麭
swwc	麮
swwa	麯
swwg	麰
swwy	麱
swwq	麲
swww	麳
swwd	麵
swwc	麶
swwu	麷
gqqo	麹
gqdd	麺
ossx	麼
ossk	麿
ossc	黀
ossj	黁
ossm	黂
agmw	黃
amwn	黅
amwq	黆
amwk	黇
amwg	黈
amwf	黊
igqw	黋
errw	黌
twic	黐
jfou	黒
lfoy	黓
lfoq	黕
lfoq	黖
lfon	黗
jfdo	黙
lfof	黚
lfok	點
ddyo	黡
lfox	黣
lfon	黤
lfob	黦
ipko	黨
lfof	黫
lfoy	黬
lfoa	黭
lfon	黮
lfow	黰
eudo	黱
lfoe	黲
atdo	黳
tmgt	黴
lfoy	黵
djeo	黶
lfom	黷
lfol	黸
oguv	黺
xhng	黽
fqxf	黿
fwxf	鼀
fcxf	鼁
jgxf	鼂
ffxf	鼃
rixf	鼄
tdkx	鼅
pjyx	鼆
gqtx	鼇
umix	鼈
kklx	鼉
nkux	鼊
jgkn	鼌
phnn	鼏
hhnn	鼑
fthn	鼒
fkuc	鼔
fkuu	鼕
fafc	鼖
fkug	鼘
fkue	鼚
fkuk	鼛
fkuj	鼜
ijgc	鼝
fkuf	鼞
fkuu	鼟
iwgj	鼡
enuy	鼣
enuy	鼤
enuy	鼥
enuk	鼦
enux	鼧
enuu	鼨
enuk	鼩
enug	鼪
enud	鼫
enuf	鼭
enup	鼮
enum	鼰
enue	鼱
enul	鼲
enuy	鼳
enuv	鼴
enuy	鼵
enuw	鼶
enuo	鼸
enul	鼺
thlh	鼼
thlq	鼿
thly	齀
thlk	齁
thli	齂
thln	齃
thly	齅
thlc	齆
thlg	齇
thle	齈
thle	齉
yuhj	齊
yuhi	齋
yuho	齌
yuhl	齍
yuhm	齎
yuhg	齏
hbj	齒
hbnn	齓
hbxn	齔
hbtn	齕
hbat	齖
hbrh	齗
hbwj	齘
hbqn	齙
hbtf	齚
hban	齛
hbhx	齜
hbck	齝
hbkw	齞
hbeg	齟
hbvk	齠
hbwc	齡
hobc	齢
hbqk	齣
udhb	齤
hbjx	齥
hbve	齦
dhvb	齧
hbeg	齨
hbyr	齩
hbkh	齪
hbls	齫
hbgk	齬
hbrr	齭
hbdk	齮
hbeq	齯
hbaj	齰
hbbc	齱
hbty	齲
hbpl	齳
hbue	齴
hbjy	齵
hbkn	齶
hbnf	齷
hbul	齸
ugab	齹
hbqt	齺
hbfw	齻
hbsh	齼
hbsi	齽
hagb	齾
hwbn	龁
hwbr	龂
uegd	龍
dued	龎
uega	龏
oued	龐
uegd	龑
uegi	龒
deud	龓
uegw	龔
wgkd	龕
uegd	龖
fkkd	龗
uegd	龘
txd	龜
ttxg	龝
umix	龞
wgkw	龡
wgkt	龢
wgki	龣
wgkr	龤
wgkm	龥
