aa	式
ab	蒸
ac	茅
ad	基
ae	苏
af	某
ag	巧
ah	臣
ai	落
aj	草
ak	革
al	菌
am	英
an	艺
ao	蘑
ap	营
aq	警
ar	欧
as	苯
at	医
au	蔽
av	萧
aw	花
ax	蕴
ay	荒
ba	陈旧
bb	耶
bc	聚
bd	承
be	阻
bf	陵
bg	陆
bh	陂
bi	函
bj	隅
bk	亟
bl	孟
bm	祟
bn	了
bo	出席了
bp	辽
bq	陷
br	阪
bs	耵
bt	隆
bu	障
bv	限制
bw	阶
bx	联络小组
by	防
ca	劲
cb	欢聚一堂
cc	双
cd	畚
ce	通
cf	圣
cg	验
ch	双目失明
ci	邓小平理论
cj	巴里坤
ck	邰
cl	驳回上诉
cm	观念
cn	预
co	观摩演出
cp	观察到
cq	欢
cr	马拉松
cs	欢歌笑语
ct	牟
cu	对症下药
cv	艰苦
cw	皴
cx	又红又专
cy	蚤
da	砌
db	础
dc	雄
dd	套
de	有
df	压
dg	研
dh	在
di	耕
dj	厚
dk	夼
dl	厍
dm	而
dn	盛
do	灰
dp	碗
dq	确
dr	愿
ds	奇
dt	帮
du	碰
dv	厩
dw	秦
dx	袭
dy	态
ea	膜
eb	乳
ec	胎
ed	胚
ee	朋
ef	肚
eg	县
eh	胪
ei	盥
ej	腥
ek	架
el	舆
em	腆
en	肠
eo	腑
ep	受
eq	胞
er	遥
es	彩
et	胀
eu	腾
ev	腿
ew	脸
ex	奚
ey	胶
fa	塔
fb	圾
fc	动
fd	需
fe	霓
ff	封
fg	十
fh	直
fi	未
fj	朝
fk	露
fl	雷
fm	献
fn	场
fo	赫
fp	索
fq	元
fr	坂
fs	栽
ft	都
fu	境
fv	垠
fw	规
fx	戋
fy	壤
ga	形
gb	顿
gc	至
gd	环
ge	青
gf	玩
gg	一
gh	政
gi	救
gj	更
gk	带
gl	柬
gm	两
gn	瓦
go	严
gp	琬
gq	列
gr	碧
gs	琳
gt	玫
gu	夹
gv	瑙
gw	玲
gx	素
gy	班
ha	彪
hb	＄
hc	颇
hd	悲
he	瞬
hf	睹
hg	督
hh	目
hi	眇
hj	桌
hk	点
hl	鹾
hm	卣
hn	鼎
ho	瞵
hp	壑
hq	睁
hr	目的地
hs	瞟
ht	瞅
hu	睇
hv	眼睛
hw	齿
hx	些
hy	上市公司
ia	满
ib	涵
ic	治
id	源
ie	削
if	渤
ig	清
ih	波
ii	消
ij	混
ik	澡
il	渭
im	测
in	汤
io	渡
ip	党
iq	泡
ir	激
is	酒
it	活
iu	润
iv	染
iw	沿
ix	沸
iy	济
ja	晓
jb	蜢
jc	坚
jd	蝴
je	盟
jf	里
jg	是
jh	虫
ji	螳
jj	晶
jk	蜗
jl	螺
jm	映
jn	暇
jo	旷
jp	蛇
jq	易
jr	蛛
js	颗
jt	星
ju	蜕
jv	照
jw	暹
jx	曳
jy	影
ka	哎
kb	吸
kc	吗
kd	喊
ke	别
kf	味
kg	吴
kh	路
ki	哨
kj	唱
kk	品
kl	咽
km	吊
kn	呢
ko	咪
kp	喀
kq	吹
kr	史
ks	呵
kt	响
ku	嗟
kv	唧
kw	哈
kx	吆
ky	嚷
la	轼
lb	囝
lc	轰
ld	固
le	胃
lf	转
lg	国
lh	罪
li	圆满完成
lj	回归祖国
lk	圆
ll	圜
lm	辋
ln	轧
lo	辚
lp	辖
lq	软
lr	暂
ls	轲
lt	略
lu	畔
lv	辎
lw	输
lx	毗
ly	罚
ma	典
mb	岌
mc	贻
md	岸
me	崩
mf	财
mg	同
mh	幅
mi	嵴
mj	赐
mk	贶
ml	崽
mm	岗
mn	凯
mo	嶙
mp	贮
mq	岁
mr	网
ms	崧
mt	峰
mu	赔
mv	由始至终
mw	肉
mx	嶷
my	嵩
na	民
nb	屈
nc	惨
nd	剧
ne	必须坚持
nf	层
ng	情
nh	蛋
ni	悄
nj	惕
nk	壁
nl	翼
nm	刷
nn	书
no	慷
np	惋
nq	惚
nr	愧
ns	憷
nt	发
nu	买
nv	慨
nw	恰
nx	尼
ny	以
oa	席
ob	邝
oc	烃
od	庆
oe	庾
of	烤
og	精
oh	粘
oi	炒
oj	爆
ok	炽
ol	库
om	灿
on	废
oo	糖
op	熔
oq	燃
or	烯
os	床
ot	炸
ou	粒
ov	康
ow	粉
ox	糨
oy	米
pa	寨
pb	实际上
pc	宏观调控
pd	割
pe	宜
pf	完
pg	家
ph	寂
pi	被誉为
pj	宴
pk	实践证明
pl	郓
pm	初见成效
pn	蜜
po	灾区
pp	之间
pq	宛
pr	之所以
ps	宋
pt	额
pu	被
pv	案
pw	究
px	它的
py	神
qa	氏
qb	怨
qc	勾
qd	危
qe	角
qf	针
qg	鲜
qh	钻
qi	尔
qj	锡
qk	象
ql	链
qm	钢
qn	包
qo	镀
qp	铵
qq	金
qr	忽
qs	钵
qt	犯
qu	镜
qv	银
qw	铅
qx	镄
qy	留
ra	措
rb	摄
rc	反
rd	希
re	援
rf	持
rg	兵
rh	看
ri	泉
rj	担
rk	操
rl	舞
rm	缺
rn	所
ro	搪
rp	按
rq	的
rr	白
rs	杀
rt	括
ru	接
rv	势
rw	推
rx	批
ry	抗
sa	械
sb	极
sc	树
sd	杯
se	杉
sf	标
sg	西
sh	想
si	梢
sj	棍
sk	哥
sl	柙
sm	桐
sn	栩
so	楼
sp	榨
sq	柳
sr	板
ss	木
st	桥
su	梯
sv	要
sw	检
sx	枇
sy	述
ta	升
tb	季
tc	径
td	适
te	般
tf	特
tg	行
th	自
ti	稍
tj	利
tk	和
tl	血
tm	身
tn	秘
to	翻
tp	乏
tq	称
tr	我
ts	箱
tt	笑
tu	简
tv	律
tw	符
tx	系
ty	往
ua	瓶
ub	塑
uc	冶
ud	关
ue	剪
uf	装
ug	美
uh	疲
ui	阔
uj	意
uk	部
ul	曾
um	弊
un	闷
uo	痰
up	兼容性
uq	资
ur	总投资
us	新
ut	产
uu	阅
uv	痕
uw	益
ux	背
uy	闹
va	姬
vb	她
vc	始
vd	娠
ve	姐
vf	妹
vg	嫩
vh	如虎添翼
vi	剥
vj	巢
vk	召
vl	甾
vm	妯
vn	妃
vo	嬷
vp	巡
vq	姚
vr	姝
vs	嫖
vt	群
vu	嫉
vv	女
vw	即使是
vx	妣
vy	忍
wa	供
wb	创
wc	仅
wd	段
we	俘
wf	什
wg	使
wh	候
wi	倘
wj	但
wk	促
wl	儡
wm	侧
wn	似
wo	俯
wp	倌
wq	低
wr	父
ws	何
wt	作
wu	们
wv	侵
ww	人
wx	华
wy	领
xa	练
xb	弛
xc	缀
xd	缅
xe	缓
xf	结
xg	绩
xh	绰
xi	绡
xj	旨
xk	织
xl	缧
xm	纳
xn	母
xo	缠
xp	综
xq	绝
xr	弧
xs	缃
xt	终
xu	弹
xv	绍
xw	维
xx	丝
xy	编
ya	试
yb	邡
yc	育
yd	斋
ye	谣
yf	讲
yg	主
yh	诽
yi	谠
yj	剂
yk	高
yl	亩
ym	调
yn	望
yo	谈
yp	谊
yq	诡
yr	离
ys	谭
yt	为
yu	商
yv	朗
yw	设
yx	畜
yy	文
