uyg	丬
thf	乍
tuf	乎
xnn	乣
ufn	乧
ckn	乨
nud	买
fcu	云
ykb	享
ylk	亶
utv	亷
wdy	仗
wrc	仮
wdh	仹
wwy	伶
wgh	佂
wyg	住
wdg	佦
wqn	佨
wwg	佩
wug	佯
wfk	佶
wqi	佻
wvk	侞
wgi	俅
wkc	俋
www	俗
wmg	俜
wgm	俪
waa	俴
wpf	倧
wjx	倱
wfh	值
wue	偂
wdm	偄
wlg	偎
wkk	偔
wnh	偦
whx	偨
whv	偼
wam	傋
wdw	傣
wme	傦
wuj	傹
wwf	傺
wus	僔
wyk	僦
wsq	僲
wep	僾
wrl	儛
woo	儝
ukq	兑
mfd	冄
mwk	冏
jkg	冔
pss	冧
peq	冩
uvg	冿
uwy	准
uss	凓
ulf	凙
wmh	凧
bkc	凾
vyi	刄
gaj	刑
vkj	刟
mmg	删
ffj	刲
dfn	刳
fcv	刼
wfc	刽
yjj	剂
uxh	剃
yvc	剆
pqb	剜
dsk	剞
ngc	剭
mee	剻
wyo	劁
nil	劚
gqe	劢
eee	劦
ret	劰
dqe	勀
qkq	勉
uke	勏
anm	勚
hal	勴
qwn	匃
qrm	匋
jgh	匙
afl	匵
ahh	匷
agn	匸
ajv	匽
rtf	卑
fnu	卖
yxx	卛
hmn	卨
byi	卪
vkb	卲
rxb	卽
dgk	厨
idn	厳
dcu	厺
gmc	叀
nhc	叏
poc	叜
ccc	叠
knh	吜
kxx	吡
kwj	吤
kwx	吪
kwc	吺
tfk	告
kfc	呍
kmw	呙
ksg	呠
kan	呭
khx	呲
kdh	呸
wgk	命
kth	咋
kgn	咓
kdj	咟
kug	咩
kqi	咷
kde	哊
kwf	哙
kft	哮
kpt	哰
kke	哵
ktj	唎
kgk	唔
kfh	唗
kuw	唥
kwy	唯
kyn	唳
kaj	唶
kqr	唿
khe	啃
kyw	啐
kgv	啑
klq	啰
kmd	啱
kud	啳
kul	啴
yup	啻
kju	喅
kmn	喎
kng	喔
kdm	喕
keg	喛
krg	喤
kut	喭
kdg	喴
krh	嗁
kam	嗊
kaw	嗒
kuv	嗛
kuf	嗴
kvc	嘅
kjf	嘢
kqd	嘫
kfk	嘭
ktd	嘺
knn	噀
kuj	噇
knb	噉
kwg	噔
kdu	噘
kkk	噪
kyx	噰
kyk	嚎
kfp	嚏
koa	嚝
kkd	嚣
kos	嚤
kxg	嚩
krm	嚹
kah	囕
ldh	囨
mjd	囬
lgh	囸
lnn	囻
lge	圃
lud	圏
lly	圐
lyx	圝
fff	土
fnn	圠
fwv	坋
fmy	坍
gvf	坙
fjh	坤
feg	坥
fmd	坱
fxj	坲
fqk	坸
fps	坾
fvg	垏
fbs	垜
fdf	垮
fjf	埋
fvp	埐
fef	埓
fpq	埦
fqv	埩
fim	埫
fes	埰
ffh	埴
fnb	堀
fyc	堉
fwk	堢
vcb	堲
flg	堽
vca	塈
paw	塞
agq	塟
fjl	塭
fme	塴
fak	塸
faj	塻
jfc	墅
faq	墆
ajd	墓
fwx	墢
fkh	墤
nda	墯
fsj	墰
frl	墲
err	壆
fyl	壈
ilr	壍
gwm	壐
fyk	壕
qyi	夊
qbh	夘
wgq	夙
qhk	夞
ycl	夣
qpg	夤
ddd	大
dff	夳
nhd	奘
cdj	奙
usg	奠
vfw	妋
vkh	妕
vnw	妜
vnh	妞
vcn	妤
vnn	姄
vwt	姙
vmg	姛
vfk	姞
vce	姢
vqk	姳
vdn	娍
rrv	娎
vtx	娒
vgk	娕
vgv	娙
vdh	娝
vev	娞
vrg	娦
vjf	娨
vth	娫
vkn	娯
vcc	娺
vgj	娻
vds	婍
vjs	婐
vqv	婙
vpg	婝
vsw	婡
vjg	婣
vmf	婤
vnd	婮
vsv	婹
vad	婼
vus	媇
vdw	媋
vmd	媏
vgl	媡
vde	媩
edm	媭
eud	媵
vfh	嫃
vpj	嫇
oop	嫈
vyv	嫏
vle	嫐
vyt	嫙
vov	嫞
vgm	嫧
vam	嫹
vdu	嫽
vag	嬅
aku	嬊
vto	嬏
vuj	嬑
vlf	嬕
vue	嬘
vat	嬞
vyw	嬢
vux	嬨
vgw	嬭
dje	嬮
vfl	嬻
vak	嬿
vos	孊
vkk	孍
qyt	孵
pwb	宂
pfj	宑
pnt	宓
pah	宧
pou	宩
pdf	宸
pgv	寁
pfq	寇
pjg	寔
pdl	寕
pnl	寜
puv	寝
pxt	寲
nfi	尉
wqq	尦
dne	尨
dnb	尮
mvy	岃
mwy	岑
mth	岞
man	岠
mtk	峈
mgc	峌
myn	峐
myj	峕
mwh	峜
mde	峟
myw	峧
mfq	崁
mnd	崌
mdf	崖
mnb	崛
mjg	崵
mtv	嵂
tdn	嵇
meg	嵈
mrb	嵏
mjq	嵑
mkk	嵓
mlg	嵔
muk	嵜
mqa	嵥
myu	嵭
muv	嵰
mxu	嵶
mov	嵻
mut	嵼
mwv	嶌
mnf	嶎
mbt	嶐
mul	嶒
mdu	嶛
maq	嶜
mqe	嶰
tmo	嶴
mtm	嶶
miw	巀
mfh	巅
mqk	巉
gva	巠
nnn	已
nng	巳
jmh	帅
mhc	帊
mhh	帔
mhk	帜
ytv	帰
mhp	帵
mhj	幔
oyn	庐
otu	庝
odn	庬
osg	庮
oan	庹
ofc	廅
orx	廐
oaq	廗
ola	廙
owg	廥
onk	廦
ofw	廧
oen	廫
xvk	弨
xyk	弴
fpg	彀
xak	彄
xgi	彔
xge	彖
dhd	彗
fku	彭
tby	彶
tfh	徒
tex	徯
ntf	忏
ncn	忬
wyn	念
nqn	怉
nmd	怏
neg	怚
nxe	怮
wbn	怹
nct	恈
nxj	恉
ugn	恙
nfc	恸
ceh	恿
nce	悀
nke	悁
nxx	悂
nqk	悗
nkg	悜
ngk	悟
npf	悰
hdh	悲
nyw	悴
npw	悾
nss	惏
akg	惑
nqa	惛
naj	惜
nxy	惤
nqj	惸
nrb	惾
npg	愃
tig	愆
ndm	愐
njg	愓
nad	愖
ptk	愙
nam	愩
nkm	愪
btx	愻
nwc	慃
ncy	慅
nee	慆
uxx	慈
ngm	慒
nsf	慓
ngq	慠
ndr	慡
gus	慭
nov	慵
umi	憋
naq	憯
nry	憿
nlg	懁
iag	懑
npn	懧
nrr	懫
oam	懬
nip	戃
fxy	戋
mgk	戙
dhg	戚
dep	戞
fwy	截
hao	戯
nwy	戳
ynu	戽
ynn	扇
ynk	扈
rvy	执
rdh	抔
rdc	抜
rmd	抰
rkq	拀
rdo	拻
dhv	挈
rgj	挭
rgv	挳
rhq	挸
rev	挼
reb	捊
rke	捌
rah	捓
rwg	捡
ryn	捩
rwc	捴
rdf	捺
ipk	掌
rmh	掣
rbc	掫
ruo	掽
rcn	揉
rjg	提
raj	揠
iej	揱
ran	揲
rqk	搀
rug	搓
rcy	搔
rfh	搷
rwy	携
raw	搽
rnu	摒
raq	摕
rvc	摡
oss	摩
rjl	摱
rnr	摺
lwc	撃
rdu	撅
rxq	撧
rnn	撰
rlg	擐
rov	擞
rnw	擢
rpw	擦
rtv	擳
rak	擹
rfw	攉
ryk	攘
wht	攸
wjh	敒
maw	敟
aet	散
ryt	敫
bgj	敶
lqj	斀
yfh	斌
yug	斓
yem	斖
wgs	斜
ewu	斞
rrh	斦
rlq	斶
ytt	旄
ytn	旎
aqv	旡
jgm	昁
jwc	昖
jan	昛
jgq	昜
jxj	昲
jqi	晀
gog	晋
jdn	晠
jge	晡
jrr	晣
jmf	晭
jyk	晾
jnk	暐
jeg	暖
jrn	暣
jjp	暥
jam	暪
jdh	暳
joq	暽
rxa	曁
jvi	曃
jep	曌
jbm	曓
jog	曗
jlf	曙
jap	曚
jtg	曛
jda	曞
jha	曥
jgk	曧
jue	曨
jlx	曪
jhn	曰
jqw	曷
gmj	曺
jbe	朂
fcj	朅
ubt	朔
mwm	朙
adw	期
swy	朳
svy	杒
gki	束
snh	杻
wcs	枀
svf	枠
sdy	枤
sck	枱
stp	柉
sjg	柦
sdm	柨
srg	栃
sah	栕
sdj	栢
suq	栨
sxj	栺
swd	栿
sgj	桓
stl	桖
siv	桜
sqa	桝
sqb	桞
sdx	桟
skg	桯
scd	桳
syv	桹
ske	梋
stf	梏
sqk	梚
smw	梤
pwc	梥
svp	梫
sth	梴
snt	梶
sdt	梼
shd	棑
gmi	棘
smu	棢
sak	棫
bcs	棸
ssp	棾
syk	椁
smf	椆
yqa	椉
srt	椑
shg	椒
sug	椚
fwm	椝
slg	椢
sov	椩
stj	椱
srb	椶
stk	楀
sad	楉
sde	楜
san	楪
sft	楮
sri	楾
spg	榁
spy	榊
sxu	榒
spw	榕
tda	榘
sdw	榛
sot	榳
sfc	榼
sbt	槂
see	槄
saq	槆
sut	槉
syx	槒
shj	槕
ssm	槚
snr	槢
sdh	槭
scc	槮
syr	樆
sce	樋
svj	樔
sff	樗
son	樚
snw	樛
sha	樝
sjb	樶
skh	樻
sfh	樾
stq	橁
snb	橄
srl	橅
sue	橌
gkh	橐
scn	橘
swg	橙
soo	橯
sru	橷
sjj	橸
sxx	橼
smn	檛
sqv	檭
sea	檼
sal	櫗
sow	櫠
svc	櫭
spd	櫶
bea	櫽
ser	櫾
sma	欁
sbb	欇
sog	欉
sxg	欚
gng	欤
ldq	欭
fkq	欯
rdm	欷
hat	歑
fam	歕
vfj	歗
jxx	歞
hdg	歳
gqw	殁
fxd	毐
xxn	毖
xxg	毙
wcq	毤
jht	毷
dae	毻
imk	氅
hhw	氍
qay	氐
rnt	氕
rnb	氖
rny	氦
iwy	汄
iqy	汋
iqu	汮
ipw	沉
iwx	沎
ixx	沘
irh	沠
ixe	泑
iqt	泖
ign	泧
dwi	泰
ipg	泻
iqd	洈
idh	洊
idm	洏
ikg	洖
ipv	洝
ide	洧
iua	洴
igc	洷
iqk	洺
iff	洼
iwg	洽
iud	浂
irg	浜
ird	浠
ipf	浣
ith	涎
iug	润
ijs	淉
ihg	淑
irm	淛
iyw	淤
ijq	渇
icn	渘
ian	渠
ial	渵
iyt	游
ikk	湂
inh	湑
ito	湫
iuo	湴
iea	湼
igv	湽
ige	溥
ilw	溭
idf	溽
irq	溾
ilu	溿
iyx	滀
iyu	滂
iwc	滃
ifh	滇
iwh	滺
iov	滽
ila	漍
ixk	漒
igm	漕
iad	漭
iuj	漳
iap	潆
ikh	潞
iss	潸
ihh	澁
ifk	澍
iyl	澟
ink	澼
ihd	濊
igk	濑
iaj	濗
ioo	濙
iqo	瀂
iyn	瀛
iao	瀳
ifl	瀻
ill	灅
iog	灇
ota	灹
onr	炀
aqo	炁
owc	炈
owj	炌
orc	炍
omd	炴
oug	烊
otf	烍
oqi	烑
omg	烔
ogj	烜
osh	烞
owf	烩
oyv	烺
ofo	焃
oov	焿
onb	煀
oak	煂
ojt	煋
uej	煎
ooh	煔
odm	煗
ovg	煡
jqk	煦
ous	煪
ftj	煮
oxx	煯
okk	煰
wks	煲
ojg	煶
oyk	煷
oqb	煼
old	煾
oee	熁
olw	熅
ouw	熌
ouv	熑
oqy	熘
oja	熚
osf	熛
otl	熜
oah	熞
otd	熢
otq	熪
ovf	熽
olf	燡
geg	燹
opd	爎
ohq	爘
oog	爜
rhy	爪
lak	爴
thg	版
tvy	牣
tfn	犊
tyk	犒
tcc	犙
xkj	犟
dyi	犬
qtt	犭
dcy	犮
qtv	犰
qto	犷
qtc	犸
qtl	狎
qtw	狯
qtq	狰
qty	狱
qtx	猕
qtj	猖
qtg	猜
qte	猨
qtf	猿
qtd	獗
qta	獾
gnn	玘
gnr	玚
gyh	玣
gcq	玧
gyx	玹
gvg	珒
gld	珚
grm	珤
giv	珱
gvt	珺
guk	琣
ggs	琹
gjh	瑁
gnh	瑂
gcn	瑈
gue	瑐
gep	瑷
gmw	璀
emg	璺
gll	瓃
grx	瓅
gtq	瓈
ckg	瓵
ulj	甑
lyn	甿
jhq	畃
ldy	畎
ilf	畓
ltx	畮
gja	畱
wfi	畲
vlg	疀
lnw	疁
lip	疂
gvh	疌
nhj	疍
uag	疟
ugq	疠
uah	疨
usk	疴
umg	痌
ugo	痖
utx	痗
ugk	痘
uii	痧
ujh	痩
umn	瘑
upl	瘒
udh	瘛
uug	瘥
uth	瘪
uaj	瘼
uwx	癈
uen	癙
uyl	癛
rgs	皌
ryw	皎
srr	皙
rto	皤
rel	皭
flm	皾
lhn	皿
uqw	盗
hfc	眃
hgh	眄
htf	眊
hni	県
hwe	眕
tgh	眚
hfi	眛
hgs	眜
xhn	眞
hmg	眮
hyn	眿
hie	睄
hke	睊
hqk	睌
hwg	睑
hjq	睗
lgk	睘
hud	睠
hqa	睧
hvi	睩
hnh	睱
hjg	睼
hrf	瞃
hkh	瞆
hwv	瞗
hak	瞘
alp	瞢
hug	瞤
hue	瞯
haa	瞸
hep	瞹
hnw	矅
hxr	矊
hda	矋
hth	矏
hip	矘
cnh	矛
tdt	矮
dvf	砕
dhk	砧
ddg	砺
dig	硄
dlk	硘
dyv	硠
dls	硱
dwg	硷
ihc	碆
dwy	碓
dyk	碠
dam	碤
dvt	碯
dtl	磇
tew	磐
lrd	磛
dlx	磥
fnw	磬
dia	磲
dus	磸
dto	磻
dkk	磾
dll	礧
dco	礮
daa	礷
pyy	礻
pyn	祀
pyq	祢
pym	禂
pyd	禊
pyu	禚
pyo	禟
pyf	禧
oty	秌
twv	秎
tqa	秖
tnx	秜
tmg	秞
tnk	稦
tle	稩
trb	稯
tnh	稰
tuv	稴
tov	穅
twk	穨
pwa	窃
pwt	窖
pwf	窥
uhk	站
ujf	童
trh	笊
ttg	笙
tjg	笪
ttn	笫
tvc	笯
tib	笵
tlf	笽
ttf	筅
tff	等
tee	筋
tvk	筎
tiv	筜
tps	筞
tgj	筻
twg	签
tic	箈
trk	箉
tih	箥
tad	箬
trg	篁
tkh	篑
tkm	篔
thd	篡
tbw	篨
tjt	篮
tld	篾
ttq	簃
tgk	簌
ton	簏
tij	簜
too	簩
tpa	簺
tlv	籔
tqv	籙
onf	籸
otb	粚
odg	粝
oof	粧
odj	粨
oma	粬
ocn	糅
orb	糉
oat	糒
oth	糗
ouj	糡
oae	糤
ofk	糦
olg	糫
xdh	紑
xvf	紣
xhx	紪
xps	紵
xwe	紾
xqk	絇
xjx	絏
xde	絠
xua	絣
xmg	絧
xld	絪
xug	絴
xqc	絶
xet	絼
xdn	絾
xvp	綅
xmw	綗
xee	綳
xgm	緉
xwc	総
xdm	緛
xwk	緥
xle	緭
odh	緳
xjl	緼
xdj	緾
xnh	縀
xjj	縄
xcc	縔
xex	縘
xab	縙
xpu	縡
xgx	縤
xdw	縥
xja	縪
xaj	縸
xfo	繊
xtl	繌
xgj	繐
xue	繝
xkk	繟
xgl	繮
xfd	繻
xah	繿
xwo	纀
xlf	纆
xfh	纎
xlx	纙
xxh	纼
xcn	纾
xgc	绖
xam	绬
xtf	缍
xkh	缱
rmq	罀
lrc	罛
leg	罝
luj	罯
mrr	羀
ugd	美
ghh	羐
ugj	羯
nug	羼
nkh	翀
nwv	翂
atg	翘
mqn	翙
npl	翚
ynm	翩
atd	翳
ftx	耄
dih	耚
dic	耛
dii	耥
dix	耭
bnn	耴
bgh	聇
bxx	聫
bpw	聺
ynt	肇
edh	肧
yne	肩
eyw	肮
eqr	肳
exj	胇
edc	胈
muq	胊
hxm	胔
eyx	胘
efc	胠
etb	胣
egc	胵
eff	胿
egk	脨
ege	脯
eeq	腉
eaj	腊
egj	腖
eaf	腜
exg	腞
elg	腲
etd	膖
gsd	膥
muu	膧
eug	膳
oww	膺
eny	臎
efw	臛
ehh	臞
gcf	致
tdo	舕
ted	舦
tem	舳
tet	舴
tey	舷
teg	艚
mag	艶
agh	艹
ayn	芒
arn	芞
aqr	芴
aww	苁
arj	苅
ade	苈
apg	苎
aeh	苚
aux	苝
aqk	苟
any	苡
adh	苤
agm	苪
awf	茌
aqq	茤
ajf	草
adm	荋
apv	荌
aqt	荻
awg	荼
ake	莂
ard	莃
awu	莅
aeg	莇
auk	莌
akk	莒
auf	莘
akh	莡
afq	莰
apq	菀
abi	菡
agk	菫
aic	菭
aov	菮
avp	菷
ayw	菸
agb	萅
agv	萐
arc	萚
atv	萟
air	萡
aiq	萢
aqm	萯
abc	萾
aug	葁
aeq	葋
aad	葚
axf	葤
alg	葨
asv	葽
aiv	蒅
axx	蒈
arv	蒑
avk	蒘
arm	蒛
ayu	蒡
abw	蒢
ate	蒰
aig	蒲
ald	蒽
aop	蒾
apj	蓂
adf	蓐
ayv	蓢
auj	蔁
axk	蔃
auv	蔅
avc	蔇
aih	蔋
axt	蔠
alr	蔪
ars	蔱
apf	蔻
aun	蕄
awy	蕉
aue	蕑
age	蕤
ama	蕽
aec	薍
ahq	薒
awn	薛
afk	薳
aon	薼
ayk	藁
aqg	藓
atm	藢
abk	藬
aur	藱
axj	藴
afw	藿
all	蘲
axa	虇
aum	虌
vha	虓
hae	虘
efh	虢
has	虨
jqy	虳
jta	虴
jfh	虷
jqn	蚫
jth	蚱
jwy	蛉
jrc	蛌
jdg	蛎
fjx	蛓
jwv	蛜
jtd	蛞
jjg	蛳
jwg	蜍
jug	蜣
jjx	蜫
jqe	蜭
jeq	蜺
jjh	蝐
jpg	蝖
jxg	蝝
jnh	蝞
jdm	蝡
jyt	蝣
jgx	蝳
toj	蝵
jve	螁
jwn	螐
jdw	螓
jrh	螔
jtl	螕
fot	螫
jyr	螭
joa	蟅
jaj	蟆
jip	蟐
jdu	蟟
jsj	蟫
jvf	蟰
xty	蠁
jlg	蠉
jou	蠊
jav	蠨
jyf	蠩
ejj	蠫
jal	蠴
jmw	蠵
jhh	蠷
vxx	蠿
tlb	衈
tvd	衟
ywc	衮
ykh	衷
yah	衺
pun	袂
way	袋
puj	袒
puu	袢
put	袼
gqj	裂
giy	裘
iit	裟
yqg	裦
yhd	裵
puf	褂
puw	褓
eqn	褜
pui	褝
yrq	褢
svq	覅
nth	覕
reh	覛
lrh	覱
mqb	觃
amf	觏
qeh	触
yby	訯
ygb	訰
yyx	詃
yaf	詌
ymk	詗
ydc	詙
yps	詝
yqr	詾
yqi	誂
igw	誉
ygk	誎
yyv	誏
ycw	誜
yhq	誢
yyg	誩
yij	誻
yrt	諀
yha	諕
ymn	諣
ysf	諲
ysk	謌
yer	謡
ygm	謮
ycc	謲
yet	譌
yip	譡
yuq	讇
yak	讌
ynw	诀
ytf	诜
ywy	谁
ykk	谔
yeg	谖
yyn	谝
yyu	谪
pdh	豁
gku	豌
ykp	豪
ebm	貀
ete	貈
emd	貒
elv	貗
eak	貙
ekk	貚
mof	賍
mpf	賩
mqj	賯
mdw	賰
mog	贌
mue	贚
mhn	贝
wtf	赁
mjh	赗
tfq	赞
foq	赥
foh	赬
fon	赮
fhn	赳
fhf	赶
fhm	赸
fhw	趁
fhg	趔
khf	趺
khc	跆
khd	跋
khm	跚
khq	跪
khw	跺
khn	跽
khy	踉
khh	踔
khj	踝
khu	踯
kht	踽
kho	蹼
khp	蹿
kha	躇
khv	躐
tmd	躺
lgq	軏
lqa	軝
ltf	軞
lck	軩
lyg	軴
law	輁
lte	輈
lgm	輌
lww	輍
lmf	輖
laa	輚
lds	輢
ldm	輭
ljg	輰
llw	轀
lee	轁
lug	轙
ldt	轣
lau	轥
fwf	辇
igq	辉
ljl	辒
cku	辝
nku	辟
udv	辧
udy	辨
hwn	辪
dfe	辰
tfp	迕
qhp	迯
wnn	追
rgk	逅
tmk	逈
geh	逋
ctd	逘
vip	逯
wge	逾
qyv	遛
khg	遣
xfm	遦
oqa	遴
hag	遽
pwu	邃
wyc	邻
fkb	郆
ywr	郊
ffk	郌
gud	郏
kkb	郘
yve	郞
vtk	郡
mbh	郥
gmy	郦
nhb	郿
ehc	鄋
ovh	鄌
ghg	鄢
ugu	鄯
tol	鄱
bci	鄹
sgf	酐
sgv	酔
sgd	酞
sga	酣
sgt	酥
sgq	酩
sgy	酬
sgm	酮
sgw	酴
sgg	酽
sgn	醪
sgo	醭
sgh	醵
qnn	釲
qbn	釶
qpq	鈂
qfw	鈇
qwx	鈋
qby	鈒
qhc	鈙
qxx	鈚
qdc	鈜
qrc	鈲
qhn	鈻
qkr	鉂
qak	鉕
qfc	鉣
qsy	鉥
qan	鉪
jty	鉴
qdj	銆
qdi	銇
qff	銈
qgx	銕
qrg	銗
qmm	銟
qfk	銡
qxi	銯
itd	鋈
qfp	鋍
tjq	鋫
qim	鋿
qee	錋
qij	錔
qpf	錝
qad	錤
qjj	錩
qha	錿
qam	鍈
qrf	鍎
qrb	鍐
qjt	鍟
toq	鍫
qde	鍸
qjn	鎉
qrn	鎎
iyc	鎏
qwc	鎓
qov	鎕
qxh	鎭
qwh	鏅
qcc	鏒
qlr	鏩
qul	鏳
bue	鐆
qbj	鐊
qxf	鐑
que	鐗
qva	鐞
qaa	鐷
qep	鑀
mmq	鑍
qll	鑘
qoa	鑛
qai	鑮
qdy	钛
qjg	钽
qft	铑
qgu	铗
qah	铘
qld	铟
qgo	铼
qeg	锄
qtb	锈
qwy	锥
qaj	镆
qfh	镇
qgk	镉
qqy	镏
qip	镗
qyk	镦
qug	镧
qwg	镫
quj	镱
dct	镺
uip	闣
uma	闦
ufk	闬
uyw	阏
uhd	阒
ufh	阗
bnh	阝
bcq	阭
byn	阸
beg	阻
bri	陎
bdm	陑
bfh	陚
bds	陭
bwv	隝
bvj	隟
bff	隢
bfd	隭
wyf	隼
fgh	雨
ffn	雩
fte	雾
ffo	霊
fxx	霛
fkm	霣
fia	霮
fma	霻
fap	靀
dmj	面
ddy	靥
akf	鞋
nka	韎
fnh	韦
hqc	韰
ujg	韴
ujq	韵
vdm	頄
efd	頱
tbd	頺
bib	顄
qdm	顉
xod	颎
ahk	颐
xfi	颕
xtd	颖
kkf	颚
ute	颜
oxi	颣
fdm	颥
wrq	飑
wrh	飓
sfi	飘
wyu	飠
hxw	飺
nbt	饏
yxt	饔
qns	饤
qng	饨
qnt	饷
qnm	馉
qnq	馏
qnj	馒
qna	馓
tjj	馧
cof	馶
qbc	駌
coa	駏
cod	駓
cow	駖
com	駚
con	駜
cot	駞
coq	駣
cog	駤
coy	駮
cor	駯
cov	騄
coj	騉
cop	騌
coc	騒
cou	騚
coi	騨
coh	驉
cok	驒
cos	驔
coo	驜
cgd	驮
cgj	驲
cgy	驴
cgq	驺
cgc	驿
cgw	骅
cga	骐
cgt	骢
mew	骪
meq	骲
mer	骺
mey	髇
meu	髊
mep	髌
meh	髗
dce	髡
gkm	鬲
rqc	魑
qot	魠
qoq	魡
qow	魤
qoi	魦
qog	魨
qop	魫
qof	魼
qod	魾
qoh	鮛
qor	鮜
qom	鮦
qox	鮨
qol	鮰
qoc	鮻
qob	鮿
qos	鯠
qoo	鯳
qoj	鯷
qok	鱢
qoe	鱫
qgh	鲇
qgf	鲑
qgd	鲕
qgy	鲛
qgv	鲟
qgg	鲠
qgj	鲥
qgt	鲧
qgb	鲰
qgl	鲴
gqt	鳌
qge	鳐
txt	鳘
vwv	鳭
cwv	鳮
vcw	鴑
trx	鵞
eqw	鶂
oow	鶑
xux	鶸
exd	鷄
hhp	鷪
arq	鸥
aht	鸦
wbq	鸧
qyn	鸵
fpb	鹁
wwk	鹆
vij	鹔
erm	鹞
uvo	鹣
oao	鹧
yki	鹫
hlo	鹸
onj	麝
gqf	麸
lfo	默
ogu	黼
hhn	鼑
enu	鼷
thl	鼾
yjh	齑
hba	齰
hwb	龋
dxy	龙
rty	㐅
wxe	㑃
wai	㑈
woa	㑞
wvc	㑡
wpn	㑻
wcc	㒍
wll	㒦
tyq	㒱
uvp	㓎
hkj	㓠
tkj	㓢
hay	㓺
xje	㔗
bme	㔘
ebe	㔜
xjf	㔬
xjg	㔭
cyy	㕚
hma	㕟
kwr	㕮
kdn	㕱
kxw	㖎
kbi	㖤
kgj	㖦
kaq	㖴
kjg	㖷
kcn	㖻
kce	㗈
kpg	㗌
kee	㗖
vck	㗠
knr	㗩
kog	㗼
keo	㘀
kux	㘂
koo	㘇
kiw	㘍
kpa	㘔
ler	㘥
fxn	㘭
fnv	㘲
ffx	㘽
fks	㙅
fvi	㙌
fsv	㙘
foj	㙻
fll	㙼
fer	㙾
dak	㚜
vqu	㚬
vtu	㚵
vwi	㚷
vbb	㚺
vft	㛈
vwn	㛋
vct	㛌
vfp	㛘
vtm	㛛
vqm	㛟
vem	㛵
vuk	㜔
vpw	㜚
vgq	㜜
vnb	㜟
vmw	㜠
vva	㜦
vqd	㜬
vah	㜮
vyl	㜳
vyc	㜵
vyx	㜻
bwj	㜾
bcn	㜿
bqk	㝃
pqq	㝖
lqf	㝶
dnh	㝿
dnj	㞁
dnl	㞇
nvy	㞍
mng	㟃
mwx	㟆
mpt	㟉
mev	㟎
may	㟐
maj	㟙
mds	㟢
mmd	㟨
mdr	㟲
mrq	㟴
mbq	㟹
mcc	㠁
mlh	㠑
mhi	㠺
mhq	㡄
mhe	㡥
ogf	㡰
oeg	㡹
ojx	㡼
oub	㡿
owq	㢋
oha	㢚
oal	㢜
xhc	㢰
xuf	㢹
xtv	㢻
xsf	㢾
xgk	㣂
xaq	㣅
ter	㣊
tyl	㣶
nqy	㣿
nah	㤉
nsg	㤓
nwf	㤔
nbm	㤕
npt	㤞
nde	㤢
ndj	㤿
nep	㥅
nyc	㥔
njy	㥗
new	㥚
nxb	㥝
nue	㥞
nkk	㦍
nvf	㦎
njm	㦙
ejf	㦟
acg	㦯
agc	㦶
rye	㧑
rqj	㧦
ryc	㧧
reg	㧮
rij	㧺
rex	㨙
rji	㨪
rje	㩎
eaw	㩓
rxd	㩪
rll	㩸
skr	㪼
yrk	㫊
yrh	㫌
jtn	㫓
jhg	㫔
qrj	㫚
jpv	㫨
hxj	㫮
jyv	㫰
jhd	㫵
jvp	㫶
jgv	㫸
jiw	㬁
jly	㬅
jnn	㬆
jqm	㬇
jgo	㬐
jyc	㬚
jul	㬝
jfo	㬨
jel	㬭
els	㬷
eay	㬻
eyk	㬿
sdg	㭅
uas	㭍
ste	㭚
spt	㭦
sjc	㭴
sql	㭵
sxy	㭹
sap	㮠
slw	㮨
sdn	㮷
sxd	㯑
say	㯜
slf	㯰
swo	㯷
svh	㯸
svl	㯿
ssl	㰈
shh	㰋
fcq	㰦
ckq	㰧
hvp	㱕
hyw	㱖
gqh	㱜
ilg	㳑
idc	㳒
idk	㳓
ice	㳙
iws	㳜
icc	㴉
ijh	㴘
ieh	㴞
ibk	㴠
imi	㴥
iop	㴹
ijp	㵃
iek	㵑
uco	㵗
iye	㵝
ibc	㵵
iuq	㶄
fou	㶣
opq	㶩
vgo	㶳
nfo	㷉
oeh	㷔
jov	㷖
ock	㷘
oob	㷥
oyr	㷰
onn	㷷
orl	㷻
tpl	㹆
twh	㹋
gca	㺹
gjm	㻦
guv	㻩
gxx	㼄
dir	㼍
qbl	㽜
lef	㽟
lul	㽪
lmw	㽯
uck	㾂
uws	㾋
uhx	㾚
ulk	㾝
uhg	㾥
uuq	㾳
uve	㾼
uyv	㾿
uaq	㿊
uoo	㿘
dbh	㿴
nhl	㿿
pvl	䀂
gel	䀃
hqr	䀛
qrh	䀜
hxx	䀝
htd	䀱
hct	䀵
hrr	䀿
hyk	䁁
hdj	䁆
hnn	䁕
hkm	䁚
hha	䁦
hff	䁱
had	䁳
hlg	䁵
duk	䂱
dxx	䃈
dte	䃑
dyl	䃶
tyt	䄱
tdg	䄷
tsg	䄽
tjx	䄿
tev	䅑
tvl	䅔
tlc	䆉
pwo	䆦
udg	䇉
uoc	䇊
tbi	䇰
tec	䈈
tck	䈚
tbu	䉌
tlp	䉚
otx	䊈
ops	䊉
ofm	䊖
ojl	䊡
ofn	䊭
xbn	䊶
ynx	䋀
xrr	䋂
vcx	䋈
xgh	䋊
xbg	䋙
ync	䋜
xmr	䋞
xuk	䋨
xeq	䋩
xyc	䋭
hdx	䋰
xjn	䌈
xon	䌒
xss	䌝
xma	䌡
xea	䌥
xaw	䌨
xal	䌩
xfs	䌮
xng	䌻
xjt	䍀
lyr	䍠
lyu	䍤
mfn	䎃
rng	䎅
nvi	䎑
din	䎣
bfj	䎴
bgk	䎸
epq	䏙
eri	䏭
eei	䏮
efn	䏯
evy	䏰
edn	䏵
exx	䏶
euk	䏽
eto	䐐
ekb	䐕
eft	䐗
ewc	䐥
eut	䐮
elx	䐯
eam	䐵
eaq	䐶
edu	䐻
mua	䑃
egv	䑖
ejg	䑗
tej	䑵
mdq	䒋
avb	䒵
axi	䒺
akc	䓃
aql	䓒
apr	䓨
avv	䓸
aam	䔈
apy	䔗
ahx	䔝
ark	䔱
abm	䔴
aus	䔵
ack	䕂
ave	䕅
aor	䕇
aye	䕍
abt	䕖
aem	䕟
aot	䕰
jnt	䖩
jtm	䖮
jwr	䗄
jde	䗅
jqo	䗇
joo	䗊
jwh	䗛
jkk	䗭
yef	䘚
vky	䘫
sou	䙳
spe	䙶
lmh	䚑
yty	䚺
yqw	䚿
yqn	䛌
ydm	䛔
yjx	䛰
ydj	䛳
ypq	䛷
yxg	䛹
ylw	䛺
yea	䛼
ybd	䜏
yde	䜡
gec	䝌
gev	䝓
erh	䝖
ejl	䝢
etl	䝦
mwe	䝩
maf	䝸
fog	䞓
fof	䞕
ldc	䡌
lqq	䡔
lql	䡘
lyv	䡙
lnk	䡶
lfp	䡹
gjp	䢋
vgp	䢖
pfp	䢘
oap	䢠
ans	䢡
flp	䢮
ooq	䢯
egb	䢸
cob	䣕
qdn	䤞
qre	䤨
qws	䤪
qii	䤬
qmr	䤱
qda	䥄
qsw	䥑
whh	䥚
qag	䥬
dcl	䦉
dch	䦊
udd	䦒
ufo	䦝
uqd	䦦
ujm	䦸
bbg	䦻
bkh	䦿
bpg	䧑
baa	䧖
btj	䧗
bxg	䧘
byk	䧚
bbh	䧝
bco	䧞
bee	䧟
bak	䧢
bsf	䧣
bet	䧦
bog	䧨
mmv	䨉
fxc	䨎
feb	䨗
fbi	䨡
fsw	䨫
pqd	䪴
qkd	䪷
cad	䪻
vcd	䫀
emf	䫇
coe	䮑
col	䮫
men	䯌
mex	䯚
mej	䯜
mea	䯦
ykl	䯬
owv	䲴
nxw	䲿
ewv	䳎
mya	䵊
tox	䵸
hbs	䶗
hbu	䶘
hbj	䶚
hbt	䶜
hbd	䶢
hbm	䶤
hbw	䶨
hbk	䶫
oqw	䶴
