ggl	一
sgh	丁
gnv	丂
agn	七
gqe	万
dgg	三
hgd	上
ghi	下
gjk	丌
dhi	不
gng	与
ghn	丐
nhf	丑
fny	专
egd	且
anv	世
rgd	丘
ogd	业
wwg	丛
aii	东
xxg	丝
big	丞
tfc	丢
gmw	两
god	严
fue	丧
hhl	丨
nhk	丩
whj	个
uhk	丫
khk	中
dhk	丰
kkh	串
kkj	丳
jty	临
yyl	丶
uyt	丷
myd	丹
ygd	主
gmy	丽
igw	举
rty	乂
bnt	乃
qyi	久
nwi	乆
tav	乇
tcu	么
yri	义
tur	乊
ppp	之
qng	乌
tpu	乏
tni	乐
rgt	乒
rgy	乓
tdj	乔
tfu	乖
tux	乘
nnl	乙
nnv	乜
vtn	九
tnb	乞
nud	习
xte	乡
nnh	书
hkn	乩
nld	乪
dnb	乭
tdn	乱
ebn	乳
bxi	乸
bnh	了
qhj	亇
qvh	争
gkv	事
fgg	二
gsj	亍
gfk	于
fnv	亏
gxg	互
fjj	亓
ggh	五
fjk	井
gjg	亘
gog	亚
hxf	些
bkc	亟
ynv	亡
ywb	亢
ywr	交
you	亦
ute	产
ylf	亩
yki	京
ykp	亮
usu	亲
yrv	亵
wnv	亾
wnn	亿
wfh	什
wfg	仁
wet	仂
wsh	仃
dwi	仄
wcy	仅
why	仆
wvn	仇
wwn	仉
wyn	今
wjj	介
wwu	仌
wbt	仍
wwy	从
wfj	仐
wxb	仑
wuu	仒
wbb	仓
wbg	仔
wbn	他
wfy	付
wmh	仙
wag	仜
waf	仝
wvy	仞
wyc	令
wiy	仦
wyr	仪
wtc	仫
wun	们
wqb	仰
weg	仴
wtg	件
wwj	价
wtf	任
wwv	份
wyt	仿
whf	企
wxh	伄
wvt	伊
wgg	伍
wdy	伏
way	伐
wsy	休
wrh	伒
wdc	伖
www	众
wdn	优
woy	伙
wfc	会
war	伛
wuf	伞
wfn	传
wlh	伡
wah	伢
wte	伤
wta	伥
wwx	伦
wyy	伩
wpg	伫
wrg	伯
wdg	估
wnx	伲
wjh	伸
wng	伺
wny	似
wek	伽
wlg	佃
wjg	但
whc	佊
wug	位
wqa	低
wda	佐
wdk	佑
wsg	体
wsk	何
wpx	佗
wgs	余
wrw	佚
wxj	佛
wth	作
wfv	佞
wtu	佟
wqi	你
weh	佣
whg	佧
wft	佬
wff	佳
wve	佷
wyw	佼
wqq	侈
wdf	侉
wgq	例
wde	侑
wpv	侒
wmg	侗
waw	供
wye	依
wgu	侠
wkk	侣
wat	侥
whm	侦
wmj	侧
wtd	侨
wyj	侪
wpe	侬
wtx	侮
wnt	侯
wvp	侵
wgj	便
wev	俀
wkh	促
wtr	俄
wcw	俊
wwe	俎
wie	俏
wtj	俐
wce	俑
web	俘
wjf	俚
wks	保
wct	俟
wyg	信
wgo	俨
wgm	俩
wht	修
wow	俯
whw	俱
wdj	俺
wrt	俾
wpq	倇
wph	倌
wuk	倍
wgc	倒
woo	倓
wnb	倔
wee	倗
wim	倘
whn	候
wds	倚
wmf	倜
waj	借
wpw	倥
wud	倦
wnd	倨
weq	倪
wtv	倭
wjs	倮
wxd	倾
wem	偁
wnh	假
wjq	偈
wnu	偋
wad	偌
wxx	偕
wdt	做
wyk	停
wsv	偠
wvg	健
wqm	偩
wqr	偬
wjm	偶
wov	偻
wfa	偾
wip	偿
wge	傅
wss	傈
wyu	傍
wpr	傧
wyf	储
wmw	催
wtl	傻
wjl	僈
wqk	像
wdu	僚
wul	僧
wuj	僮
woq	僯
wso	僳
wgl	僵
wxg	僶
wnk	僻
waq	儆
wqd	儋
wfd	儒
wll	儡
qtn	儿
gqv	兀
cqb	允
fqb	元
kqb	兄
ycq	充
qii	兆
tfq	先
dqb	克
ipk	党
dqd	兢
tyi	入
wgf	全
wty	八
wcu	公
ywu	六
wgn	兮
ubj	兯
udf	兰
awu	共
gwu	兲
udu	关
rgw	兵
hwu	具
maw	典
uxx	兹
ufw	养
ulg	兽
uxl	冀
uln	冁
mhn	冂
mwi	内
dmb	冇
mri	冈
mfd	冉
mkd	冋
mmg	册
gmf	再
jef	冐
jhf	冒
pqv	冘
pgn	写
pmj	冚
plj	军
pei	农
pbc	冣
pqk	冤
pjy	冥
uyg	冫
tuu	冬
duu	冭
ucg	冯
uiy	冰
ugx	冱
ukh	冲
unw	决
ukq	况
uck	冶
uwy	冷
uai	冻
utf	冼
ugq	冽
uqv	净
usw	凇
uyk	凉
umf	凋
udg	减
udw	凑
upj	凕
uyl	凛
uxt	凝
wtn	几
wyi	凡
twv	凢
wci	凤
nwv	凥
wsi	凩
whd	凪
mnw	凯
rbk	凶
fbk	凷
hnm	凹
bmk	出
gbj	击
ibk	凼
bib	函
ogu	凿
vnt	刀
ngd	刁
jhh	刂
vyi	刃
vwi	刅
wvr	分
avt	切
rjh	刈
tnj	刉
fjh	刊
qvf	刍
qrj	刎
ajh	划
nwj	刔
ejh	刖
gqj	列
yjh	刘
mjh	则
mrj	刚
wbj	创
puv	初
tjh	利
kej	别
bjh	刵
rmh	制
nmh	刷
udv	券
rsj	刹
gmi	刺
ynt	刻
mnj	剀
wsj	剁
iej	削
uej	前
uav	剏
wgi	剑
ukj	剖
ooj	剡
ndj	剧
gkl	副
pdh	割
rrm	劕
ent	力
enn	劜
cet	劝
ewi	办
aet	功
ekg	加
ter	务
ret	劤
fce	动
ege	助
vce	努
det	劯
cae	劲
ape	劳
rvy	势
fpb	勃
kme	勋
ble	勐
jhe	勖
akg	勤
qvv	勼
qwi	勽
qci	勾
qre	勿
qud	匀
qri	匁
qxv	匂
qnv	包
qry	匆
qqi	匇
qrb	匈
qoi	匊
xtn	匕
wxn	化
uxn	北
abv	匜
amh	匝
ark	匠
agd	匡
alk	匣
alv	匦
akh	匮
aqv	匹
ari	区
atd	医
aad	匿
fgh	十
nfk	卂
tfk	千
gkk	卅
vfj	卆
tak	升
tfj	午
faj	卉
ugk	半
faf	卋
glk	卌
wxf	华
few	协
yww	卒
hjf	卓
ulj	单
ilj	単
fge	博
hhy	卜
yhu	卞
khy	卟
hkf	占
hgh	卡
hnr	卢
hmn	卣
hlr	卤
ahn	卧
bgd	卫
qdb	危
vcb	即
fcb	却
udb	卷
rhb	卸
dgt	厂
qdr	厃
dbv	厄
dsk	厅
dee	历
dfk	厈
dgq	厉
dfy	压
ddy	厌
dlk	厍
djb	厚
dsh	厢
dub	厥
ddh	厦
dvc	厩
dak	厪
dad	厮
cny	厶
vcu	厹
fcu	去
ciu	厼
egc	县
cdd	叁
cde	参
ccc	又
cyi	叉
byi	及
dcu	友
ccy	双
rci	反
ntc	发
hgi	叔
bcy	取
epc	受
yoc	变
ugr	叛
ehc	叟
dgh	古
qkd	句
ker	另
kvr	叧
kvt	叨
kbh	叩
kwu	只
knh	叫
vkf	召
kwy	叭
ksh	叮
skd	可
ckf	台
kxn	叱
kri	史
dkf	右
akd	叵
kfh	叶
kgn	号
ngk	司
kcy	叹
ket	叻
kwn	叽
bkf	叾
kag	叿
ktn	吃
tkf	各
kkg	吅
kxy	吆
kbg	吇
wgk	合
fkf	吉
kmh	吊
mgk	同
qkf	名
rgk	后
gkr	吏
kfg	吐
tmk	向
kgh	吓
kkf	吕
kuh	吖
kcg	吗
ykf	吝
gdk	吞
kdy	吠
nkf	吢
kny	吣
kcn	吧
kgb	吨
kwv	吩
krh	听
kyw	吭
kcq	吮
ynk	启
kdc	吰
kfc	吱
kxh	吲
kgd	吴
kit	吵
kby	吸
kqw	吹
kqr	吻
kbn	吼
gkf	吾
kah	呀
kdb	呃
bdf	呄
kyy	呅
ksu	呆
ikf	呇
kgf	呈
kfw	呋
kuf	呌
kmw	呐
kfq	呒
kan	呓
kde	呖
kmy	呗
kmu	员
kty	呚
kwb	呛
kqn	呜
knx	呢
kxe	呦
kqa	呧
hxk	呰
krc	呱
kfi	味
ksk	呵
klh	呷
kjh	呻
ktu	呼
kjg	呾
keg	咀
kaf	咁
kam	咂
kbm	咄
ukf	咅
kxj	咈
tkg	和
kck	咍
thk	咎
kkw	咒
kdg	咕
kek	咖
kda	咗
kdx	咙
kps	咛
kpx	咜
kga	咞
kbf	咠
kig	咣
kgx	咦
kgq	咧
koy	咪
ktk	咯
kqj	咰
kth	咱
kyn	咳
kdo	咴
kpv	咹
kws	咻
kld	咽
yke	哀
kkk	品
ksg	哂
kmg	哃
kaw	哄
kqq	哆
kff	哇
kwg	哈
fkx	哉
kre	哌
ktm	响
kar	哎
kve	哏
kgo	哑
kdp	哒
kat	哓
kxx	哔
kmq	哕
kwx	哗
kyj	哜
kpe	哝
kxq	哟
sks	哥
ktr	哦
kfo	哧
kie	哨
kjf	哩
kng	哪
rrk	哲
kev	哸
keb	哹
kge	哺
kgj	哽
kuk	哾
kyg	唁
kqe	唃
kcw	唆
kct	唉
kpf	唍
krd	唏
ovh	唐
kww	唑
dck	唘
kvp	唚
kgt	唛
kap	唠
kim	唢
kra	唣
kqm	唤
kvc	唧
kbe	唨
ktv	唩
kdw	唪
knm	唰
kjj	唱
kyc	唷
ksw	唻
kuv	唼
ksr	唽
ktf	唾
kmf	啁
yum	商
kbs	啊
koo	啖
kpq	啘
krt	啤
kwf	啥
kru	啦
krr	啪
krq	啲
kih	啵
kyv	啷
kvi	啸
knd	啹
kyu	啼
kto	啾
kpt	喀
kjm	喁
klg	喂
kfm	喃
ugu	善
ksv	喓
ksd	喖
kpl	喗
kmd	喘
kxg	喙
kjq	喝
krx	喞
kle	喟
koa	喥
kpg	喧
kdj	喱
ksj	喳
kal	喵
kfa	喷
kdf	喹
kov	喽
ipt	喾
kvk	嗈
kuw	嗌
kub	嗍
kcc	嗓
keh	嗖
kex	嗘
kft	嗜
kux	嗞
kug	嗟
kwc	嗡
kjl	嗢
kma	嗣
kfp	嗦
kbc	嗫
kwr	嗲
kep	嗳
kce	嗵
kgk	嗽
kgm	嘈
ksf	嘌
kdh	嘎
dnh	嘏
kos	嘛
kak	嘞
kip	嘡
kmm	嘤
kpn	嘧
kvo	嘨
kjb	嘬
knt	嘱
kfj	嘲
khx	嘴
kad	嘶
kdu	嘹
kfk	嘻
klf	嘿
kul	噌
kka	噐
koq	噒
kog	噗
kva	噚
kqg	噜
kss	噤
kkd	器
kuj	噫
kta	噬
kaj	噶
kpa	噻
knk	噼
kfd	嚅
kay	嚆
kvh	嚍
kpw	嚓
kja	嚗
kuq	嚪
kyk	嚷
kel	嚼
gkh	囊
ktl	囖
mnv	囘
lwi	囚
lci	囜
lbd	囝
lkd	回
tlr	囟
ldi	因
lvd	囡
lfi	団
lgb	囤
lii	囦
lqr	囫
lfq	园
lgd	囯
lsi	困
lur	図
lwf	囶
lti	囷
ldd	固
lgy	国
ltu	图
lde	囿
lyd	圁
clu	圅
lkm	圆
lud	圈
lfu	圉
llg	圜
fyi	圡
cff	圣
fhy	圤
dfd	圧
dhf	在
fgf	圩
ftn	圪
fff	圭
fnn	圯
fbn	地
fkh	圳
fmh	圸
fot	圹
frh	圻
fby	圾
fhg	址
frc	坂
fty	坆
fqu	均
fyt	坊
wvf	坌
fqw	坎
fdh	坏
wwf	坐
fyw	坑
fnw	块
jcf	坚
ffc	坛
fmy	坝
fyy	坟
fhc	坡
fjg	坦
fdg	坧
fgu	坪
fhk	坫
fnx	坭
fxe	坳
fxy	坶
fsk	坷
fqa	坻
fry	坼
tfa	垂
fug	垃
fdx	垅
fmg	垌
fyn	垓
fws	垛
fve	垠
frg	垢
fgj	垣
fgc	垤
vef	垦
ftm	垧
fgo	垭
fmn	垲
fpf	垸
fct	埃
fdn	城
fth	埏
fef	埒
fkg	埕
fkm	埚
fwn	埠
frt	埤
fvi	埭
foo	埮
fdj	埯
fjq	埸
fuk	培
adw	基
fvp	埽
fjs	堁
fee	堋
lrf	堑
fsf	堙
fan	堞
fxg	堟
fad	堪
fft	堵
fly	塄
fyo	塆
fjn	塌
ubt	塑
faw	塔
fov	塘
fxh	塡
fgk	塥
ffh	填
fdr	塬
flv	塿
fni	墀
fjl	墁
fuj	境
foa	墌
rxa	墍
fiv	墚
ful	增
fha	墟
lbw	墼
nku	壁
fvh	壗
fyk	壤
fdl	壥
tfd	壬
fbj	壭
ufg	壮
fnr	声
fpw	壳
fpo	壶
fpg	壹
fll	夁
thi	处
tlf	备
tou	夈
tjt	复
dht	夏
qhy	外
qqu	多
vqu	夛
ywt	夜
qkq	够
jsq	夥
gdi	天
dyi	太
fwi	夫
tdi	夭
mdi	央
der	夯
djj	夰
rwi	失
dfj	夲
udi	头
gxw	夷
dfn	夸
gud	夹
dfu	夺
dkj	夼
dcb	夿
qmd	奂
djn	奄
dfi	奈
dlf	奋
dff	奎
dwg	奏
dhv	契
dfa	奔
yod	奕
uqd	奖
ddc	套
exd	奚
dft	奢
tmo	奥
vvv	女
vcy	奴
vsh	奵
vbt	奶
vfh	奸
vbn	她
vbg	好
vmh	奾
nvg	妀
vkg	如
vnn	妃
vag	妅
uvg	妆
vvg	妇
vcg	妈
vtf	妊
vga	妍
vyy	妏
vfc	妓
vwy	妗
vit	妙
vdh	妚
jvf	妟
vmw	妠
vrh	妡
vxx	妣
evf	妥
vyt	妨
vfq	妩
var	妪
vdc	妭
vnx	妮
vmg	妯
vvk	妱
vjg	妲
vyx	妶
vrw	妷
vsk	妸
vfi	妹
gvh	妻
vjh	妽
uvf	妾
ekv	妿
vty	姀
vtp	姂
vxy	姆
vck	始
vmd	姎
veg	姐
vdg	姑
vny	姒
vtg	姓
tvf	委
hxv	姕
van	姖
vmm	姗
vua	姘
vqi	姚
ugv	姜
vri	姝
vyw	姣
vft	姥
vgx	姨
vah	姬
vig	姯
vqj	姰
vpt	姹
vld	姻
vqq	姼
vqd	姽
vad	娀
dgv	威
vff	娃
ovf	娄
vgo	娅
vat	娆
vtd	娇
yov	娈
vhq	娊
vyv	娘
vle	娚
vng	娜
vke	娟
vdf	娠
vfn	娡
vux	娣
vtr	娥
vuk	娧
vqk	娩
vyg	娮
vkm	娲
vus	娴
bcv	娶
vjj	娼
vbs	婀
vrm	婂
vpf	婃
vqo	婅
vpq	婉
vge	婊
vha	婋
vhg	婌
voo	婒
vgv	婕
vqa	婚
vph	婠
vrt	婢
vhj	婥
ssv	婪
vjx	婫
vma	婰
mmv	婴
vul	婵
vpj	婶
vyk	婷
vfm	婻
vnh	婿
vjm	媀
vdm	媆
vue	媊
val	媌
vqm	媍
vaf	媒
vhm	媜
vda	媠
viv	媣
vjl	媪
vqb	媰
vtl	媲
vth	媳
vab	媶
vam	媾
vrq	媿
vpg	嫁
veh	嫂
vpw	嫆
vut	嫉
vxu	嫋
vuv	嫌
vee	嫍
vpr	嫔
vsf	嫖
vlx	嫘
vuj	嫜
vaa	嫟
fit	嫠
vyu	嫡
vgh	嫣
vak	嫤
vaj	嫫
voq	嫾
vfk	嬉
vyl	嬗
vvh	嬧
lev	嬲
vxr	嬵
vos	嬷
vlh	嬽
vfs	孀
vni	孎
bbb	子
bnn	孔
bbf	孕
bbg	孖
pbf	字
dhb	存
biy	孙
ebf	孚
bty	孜
bnu	孞
blf	孟
bck	孡
bqn	孢
tbf	季
brc	孤
ipb	学
xeb	孧
byn	孩
yob	孪
bmy	孭
nbb	孱
yxy	孶
bfd	孺
bvh	孻
psj	宁
pxb	它
pvb	宄
pta	宅
pgf	宇
pfu	守
pvf	安
psu	宋
pfq	完
pdc	宏
pdf	宕
pxc	宖
pfi	宗
phn	官
pmf	宙
pgh	定
pqb	宛
peg	宜
pgy	宝
pud	实
pdx	宠
pjh	审
pgj	宣
pgc	室
pah	宦
pqi	宨
ptf	宪
pkk	宫
pjv	宴
pie	宵
pge	家
pww	容
pkg	宺
pam	宽
prg	宾
phg	寂
pds	寄
pgm	寅
pgk	富
pqm	寏
pnh	寐
pjm	寓
piv	寖
prc	寙
paj	寞
pwf	察
pde	寡
pnw	寥
pdu	寮
plg	寰
cfy	对
ffu	寺
vfu	寻
nfu	导
efu	寽
dtf	寿
uqf	将
usg	尊
iht	小
ite	少
tiu	尓
qiu	尔
biu	尕
idu	尖
iff	尘
imk	尚
idi	尜
ipf	尝
dnv	尢
dny	尤
dnq	尥
dnw	尬
dnj	尴
vte	尹
nyi	尺
nvv	尻
nxv	尼
nyu	尽
ntf	尾
nii	尿
nnk	局
nxx	屁
nfc	层
nmi	屃
ndd	居
nbm	屈
nan	屉
nmd	届
ngc	屋
noi	屎
nua	屏
nie	屑
nae	展
nbs	屙
ntk	属
nft	屠
nth	屣
ntt	履
bhk	屮
mmm	山
tmj	屲
mer	屴
mdr	屵
mvr	屶
mbt	屷
mag	屸
mtn	屹
mnn	屺
mmh	屾
mgn	屿
mmj	岀
mqu	岁
mnb	岂
meg	岄
mah	岈
cmj	岊
mby	岌
mga	岍
mwv	岎
mfc	岐
mrh	岓
mar	岖
mmr	岗
mmq	岘
tdm	岙
mwr	岚
mcb	岜
msk	岢
mqk	岣
muf	岦
mdf	岩
mlh	岬
mwy	岭
mpx	岮
rgm	岳
mdg	岵
mrg	岶
mna	岷
mvk	岹
mqa	岻
mai	岽
mjv	岿
mmf	峀
mqt	峁
mcg	峄
mca	峅
mqj	峋
mve	峎
mff	峙
mgu	峡
mqv	峥
yom	峦
mtr	峨
mie	峭
mvt	峮
mtd	峰
mcw	峻
myv	崀
mgo	崃
mpw	崆
mpf	崇
mss	崊
mds	崎
mjx	崐
mqf	崟
mbi	崡
mrd	崤
mrt	崥
mdj	崦
msw	崧
mee	崩
mlr	崭
mld	崮
mqg	崯
mvl	崰
mln	崽
msv	崾
msy	嵀
mtu	嵊
mnh	嵋
maf	嵌
mjm	嵎
msj	嵖
map	嵘
mov	嵝
mex	嵠
myk	嵩
mux	嵫
mrq	嵬
mug	嵯
miw	嵴
mcc	嵾
msd	嵿
muj	嶂
mgm	嶆
mkw	嶉
mrw	嶊
mnr	嶍
msa	嶘
moq	嶙
mwg	嶝
mog	嶪
maj	嶱
mxt	嶷
mea	嶾
mda	巁
mue	巃
mak	巈
mid	巌
mtv	巍
mxh	巓
vpv	巡
vjs	巢
aaa	工
daf	左
and	巨
aww	巫
uga	差
nng	己
ckx	巼
nna	巽
mhk	巾
tmh	币
dmh	布
mhw	帆
jgm	师
qam	帋
rdm	希
mhf	帏
mht	帐
vcm	帑
mhr	帕
mhh	帖
pwm	帘
vpm	帚
yup	帝
emh	帠
gkp	带
mhi	帩
oam	席
mhd	帱
mhl	帼
mhj	帽
pjd	幂
mhg	幅
mho	幞
mhu	幢
guf	平
uaj	并
fuf	幸
xxx	幺
xet	幼
mxx	幽
oyg	广
oxv	庀
osk	庁
oci	広
ofd	庄
otc	庅
odi	庆
oxx	庇
osi	床
ofc	庋
oah	庌
ork	庍
ofq	庑
olk	库
oig	应
oqa	底
omd	庙
ovw	庚
ohx	庛
odx	庞
ont	废
off	庤
ows	庥
oac	度
oww	座
orf	庪
oua	庰
ort	庳
odj	庵
ovi	康
ove	庸
owc	庺
oxd	庼
ojm	庽
oew	庾
orq	廆
ouv	廉
oeh	廋
oak	廑
ogq	廒
oyk	廓
olv	廔
obw	廕
onw	廖
oon	廘
oyl	廪
omm	廮
obf	廰
pny	廴
thp	延
tfp	廷
vgp	建
spd	廼
agt	廾
agh	廿
gak	开
caj	弁
naj	异
yca	弃
gaj	弄
yoa	弈
umi	弊
ayi	弋
aay	式
rsa	弑
xng	弓
xhh	引
xgf	弖
xjk	弗
xcy	弘
xbn	弛
xcn	弝
uxh	弟
xta	张
xqi	弥
xyx	弦
xrc	弧
vcx	弩
xah	弫
xbg	弭
yox	弯
xux	弱
xul	弹
xdj	弼
xsk	彁
xam	彉
xoa	彍
xgd	彑
jvg	归
ivf	当
viu	录
xgt	彘
xgo	彝
vox	彞
ett	彡
gae	形
yee	彣
mye	彤
ese	彩
sse	彬
jyk	影
tbn	彵
tyt	彷
twc	役
tgg	彺
thc	彼
tyg	往
tgh	征
tca	径
tqj	徇
tve	很
tug	徉
tlk	徊
tvg	律
twg	徐
tgo	徕
tjg	得
thh	徙
tim	徜
trh	御
tnh	徦
trg	徨
trf	循
tmg	微
tum	徶
tfl	德
try	徼
nte	必
nnn	忆
net	忇
nvt	忉
nsh	忊
nnu	忌
vyn	忍
hgn	忐
any	忒
ndy	忕
nfy	忖
fnu	志
nyn	忙
nbn	忚
oni	応
gdn	忝
ynu	忞
nyy	忟
khn	忠
nkh	忡
gnu	忢
ndn	忧
nwc	忪
nnw	快
nyh	忭
nqa	忯
nvf	忰
ngg	忹
nrh	忻
qrn	忽
nrn	忾
ndh	怀
dyn	态
nfq	怃
nar	怄
nta	怅
nwb	怆
nvk	怊
thf	怎
vcn	怒
ngh	怔
nrg	怕
ndm	怖
dnu	怘
ndg	怙
njg	怛
nwy	怜
lnu	思
ckn	怠
nck	怡
qvn	急
ngu	怦
ntg	性
qbn	怨
nnx	怩
ncf	怪
nxj	怫
nlg	怬
nsy	怵
ukn	总
cfn	怼
ncg	怿
nqq	恀
nqj	恂
nff	恃
nee	恊
yon	恋
nig	恍
awy	恐
ngj	恒
nsg	恓
vkn	恕
ffn	恚
nlk	恛
ndo	恢
ntl	恤
nve	恨
ldn	恩
nmg	恫
ntd	恬
awn	恭
thn	息
nwg	恰
ven	恳
nmn	恺
nmj	恻
nyr	恼
npl	恽
nls	悃
nux	悌
njf	悍
nkc	悒
ntx	悔
ncw	悛
nuk	悦
nir	悩
njc	悭
nuy	悯
ntb	悸
nph	悺
njx	惃
nge	情
nmf	惆
nyk	惊
npq	惋
nqg	惍
noo	惔
njq	惕
nmu	惘
ncc	惙
nqr	惚
nim	惝
gjh	惠
noh	惦
nhw	惧
ncd	惨
tln	惫
nlr	惭
nxf	惯
nda	惰
shn	想
njt	惺
nto	愀
ton	愁
nqm	愌
ujn	意
nkk	愕
jmh	愚
dgk	感
nly	愣
nfa	愤
nrq	愧
ngx	愫
nji	愰
nme	愲
nxh	愼
dri	愿
nuv	慊
nay	慌
nfh	慎
nbc	慑
njl	慢
dhd	慧
nvc	慨
nlp	慩
nfi	慰
nov	慷
nlv	慺
nul	憎
nsj	憛
nso	憟
nuj	憧
njy	憬
nxg	憴
nss	憷
nma	憹
nat	懂
nqe	懈
ntm	懊
nyl	懔
nfo	懗
nos	懡
nfd	懦
nja	懪
noa	懭
nde	懮
nqy	懰
nal	懵
dgx	戌
dyx	戍
ade	戎
cay	戏
trx	我
aak	戒
wba	戗
hka	战
dha	戛
may	戝
ujx	戠
kbx	戢
nwe	戮
haj	戱
fla	戴
yne	户
gnr	戸
ynd	戾
yny	房
rnr	所
rtg	手
rgh	扌
fte	才
rnn	扎
rhy	扑
rwy	扒
rsh	打
rbt	扔
rfg	扗
rta	托
rdy	扙
rag	扛
rbn	扡
rkg	扣
rot	扩
run	扪
rvg	扫
rnh	扭
rwv	扮
rhg	扯
rdn	扰
rrc	扳
rfw	扶
rxx	批
rdb	扼
ray	找
bdi	承
rfc	技
rgg	抂
rit	抄
rcn	把
rqb	抑
rwc	投
ruf	抖
ryw	抗
rrh	折
rfq	抚
rve	抛
rfn	抟
rar	抠
rwx	抡
rwb	抢
ryn	护
rbc	报
rhc	披
rck	抬
rqn	抱
rqa	抵
rgs	抹
rlh	押
rmg	抽
rna	抿
ryg	拄
rjg	担
rry	拆
rxy	拇
rhk	拈
rug	拉
rwf	拊
rrg	拍
rke	拐
ran	拒
rdg	拓
rdc	拔
rpx	拕
rtb	拖
rxe	拗
rbm	拙
rca	拚
rvk	招
rny	拟
roc	拡
rdx	拢
reh	拥
rud	拦
rps	拧
rnt	拨
rcg	择
rsg	拪
rtd	括
raa	拭
rfk	拮
rbi	拯
udr	拳
rvq	拶
rft	拷
rua	拼
rjx	拽
rwg	拾
rff	持
rxj	指
rpv	按
vkr	挐
rqi	挑
rbg	挕
yor	挛
rfp	挝
rdp	挞
rgu	挟
rat	挠
riv	挡
rqv	挣
ryj	挤
rpl	挥
rct	挨
rww	挫
rdf	振
rkc	挹
rqk	挽
rce	捅
rls	捆
rkh	捉
ref	捋
rie	捎
rjf	捏
rap	捞
rkm	损
rqm	换
rqg	捦
rdw	捧
rrt	捭
rnd	据
rgv	捷
rrq	掀
roh	掂
rcc	掇
rep	授
rhj	掉
ruk	掊
roq	掋
rds	掎
rqr	掏
rqe	掐
rhd	排
ruv	接
rpw	控
rdj	掩
raj	措
rqo	掬
rha	掳
rul	掸
rcd	掺
rxf	掼
rxg	掾
rpg	揎
ral	描
rtf	插
rkb	揖
rng	握
rmd	揣
rjq	揭
reg	援
rbb	揶
rjt	揽
rqq	揿
rut	搁
rov	搂
rip	搅
rge	搏
ryk	搞
rub	搠
rxu	搦
rte	搬
raw	搭
rld	摁
rlf	摆
rer	摇
rpr	摈
rcw	摊
ryx	摔
ryu	摘
rlx	摞
rmw	摧
roa	摭
rlt	撂
rmm	撄
rum	撇
rae	撒
rad	撕
rus	撙
ruj	撞
ryc	撤
rdu	撩
rto	播
rjb	撮
rbd	撱
rfl	擂
ryl	擅
rog	擈
rkk	操
ros	擵
rvl	擸
srr	攀
rll	攂
rth	攥
rhh	攫
hcu	攴
nht	收
nty	改
aty	攻
yty	放
ght	政
dty	故
oty	敉
tdt	敌
giy	救
ftb	教
nbt	敢
aqk	敬
ovt	数
gki	整
hpt	敹
yyg	文
ybf	斈
yjf	斉
ydm	斋
gyg	斑
yje	斔
ufk	斗
ouf	料
ccp	斚
rtt	斤
ryi	斥
wrr	斧
lrh	斩
drh	斫
onr	断
usr	新
ytb	施
yte	旅
yrm	旆
ytn	旋
ytt	族
yta	旗
fqv	无
vca	既
jgf	旦
hjg	旧
xjf	旨
jfj	早
jvt	旫
qjd	旬
vjd	旭
vjf	旮
jvb	旯
jfh	旰
jdu	旲
jmj	旵
jfy	时
jot	旷
jgg	旺
jyu	旻
jqu	昀
jqb	昂
jxx	昆
jyt	昉
jgd	昊
jjf	昌
jjg	昍
jeg	明
qaj	昏
jwv	昐
jqr	易
ajf	昔
jrh	昕
thj	昝
jtg	星
jmd	映
jwe	昣
dwj	春
jfi	昧
jth	昨
jca	昪
juf	昱
jqt	昴
jnx	昵
nyj	昼
jdx	昽
jog	显
joc	昿
jqi	晁
jig	晃
jtm	晌
jpv	晏
jsg	晒
jat	晓
jwx	晔
jpl	晕
jwy	晗
jqk	晚
jdn	晟
jgk	晤
jtx	晦
jdf	晨
uog	普
jsr	晰
joo	晱
srj	晳
jge	晴
jjj	晶
tdk	智
lrj	暂
jpg	暄
jnh	暇
jdm	暊
jft	暑
juj	暗
jep	暧
jaw	暴
jkk	暺
jxt	曏
jry	曒
jaq	曔
jnw	曜
jja	曝
jug	曦
mad	曲
jxe	曳
gjr	更
jlc	曼
fwf	替
jbc	最
jhg	朄
eee	月
def	有
efq	朊
eeg	朋
ebc	服
eqk	朐
mua	朑
eqi	朓
yvc	朗
ecw	朘
eyk	朜
fjf	朝
eam	朠
erb	朡
muo	朥
eap	朦
fii	未
gsi	末
sgd	本
snn	札
syi	术
snb	朰
rii	朱
shy	朴
wsu	朵
bsu	朶
svt	朷
svn	朹
swn	机
sxn	朼
ssh	朾
rsu	杀
vsu	杂
scy	权
sfh	杆
set	杉
skh	杊
sbg	杍
sbf	李
skf	杏
sft	材
sfy	村
sdy	杖
nsi	杘
say	杙
sfg	杜
sbn	杝
sag	杠
tsu	条
smh	杣
goi	来
snr	杨
scg	杩
sit	杪
sdh	杯
sou	杰
jsu	杲
sjf	杳
scn	杷
sny	杺
swc	松
src	板
sby	极
squ	枃
sqc	构
sgg	枉
sqb	枊
syt	枋
smf	枏
srh	析
spq	枕
ssy	林
smw	枘
sty	枚
jsi	果
sfc	枝
sar	枢
sde	枥
smq	枧
sta	枨
swb	枪
swr	枫
sdg	枯
cks	枲
skw	枳
skg	枵
eks	架
sek	枷
sqn	枹
spx	柁
snx	柅
smd	柍
srg	柏
afs	某
saf	柑
ias	柒
ivs	染
slh	柙
smg	柚
san	柜
sth	柞
sps	柠
sqa	柢
sjg	查
saq	柩
sxe	柪
gli	柬
sbm	柮
ssk	柯
syg	柱
sqt	柳
hxs	柴
slg	柶
skq	柷
ske	柺
sym	柿
sxy	栂
smm	栅
sfx	栈
sab	栉
sdx	栊
sai	栋
stn	栎
sud	栏
scf	树
ssg	栖
ssu	栗
sqq	栘
syw	校
sng	栩
sri	株
sld	栶
sug	样
syn	核
sve	根
stk	格
fsx	栽
yos	栾
qah	桀
stg	桁
sff	桂
sqi	桃
sqd	桅
pvs	案
spv	桉
uds	桊
hjs	桌
sfk	桔
seg	桕
sbs	桗
sat	桡
shm	桢
siv	档
smn	桤
std	桥
swx	桦
swf	桧
sof	桩
sii	桫
seb	桴
sev	桵
sce	桶
sqe	桷
ivw	梁
stx	梅
sdt	梆
suf	梓
smy	梖
sie	梢
ssq	梦
sgk	梧
tjs	梨
scw	梭
sux	梯
saa	械
syc	梳
ssw	梵
slp	梿
swg	检
svo	棂
srm	棉
sad	棋
sjx	棍
sdw	棒
spf	棕
see	棚
svi	棣
soo	棪
sss	森
sfw	棱
scc	棳
sjs	棵
shj	棹
sph	棺
sha	椃
suv	椄
sds	椅
sqo	椈
swy	椎
snd	椐
sfn	椟
lrs	椠
sma	椣
slq	椤
suo	椪
sbd	椭
sbb	椰
snk	椲
swd	椴
sxg	椽
ssj	楂
slw	楐
sln	楒
svg	楗
ssn	楚
sgl	楝
sly	楞
sfm	楠
snh	楣
spg	楦
skb	楫
sjq	楬
sew	楰
sxx	楷
sto	楸
sbc	楹
sov	楼
skk	榀
svc	概
sjl	榅
suk	榈
sig	榉
sna	榐
syv	榔
syu	榜
sah	榧
stm	榭
sqy	榴
spw	榷
sjn	榻
sex	榽
sme	榾
syk	槁
sxh	槇
srq	槐
srd	槔
sdk	槗
sjt	槛
spr	槟
syf	槠
sla	槶
sgm	槽
sak	槿
slx	樏
sip	樘
soa	樜
suj	樟
saj	模
sni	樨
sam	横
sfu	樯
sfv	樰
sus	樽
stf	橇
soq	橉
sep	橓
sqk	橡
seu	橳
sqg	橹
syl	檀
sry	檄
sfl	檑
sap	檬
sll	櫑
slv	櫢
shh	欋
sau	欗
qwu	欠
cqw	欢
rqw	欣
arq	欧
vkq	欩
hma	欳
ooq	欻
ffi	款
tfe	歃
jqw	歇
uvo	歉
hhg	止
ghd	正
hxn	此
hhr	步
fhn	武
hfc	歧
hhu	歨
dhg	歪
hte	歬
hob	歯
gqi	歹
hqu	歺
gqx	死
gqm	殃
gqc	殆
gqq	殉
gqr	殊
gqf	残
gqw	殓
gqu	殚
gqb	殛
arw	殴
wdw	段
rvn	殷
naw	殿
eaw	毁
fpl	毂
uew	毅
xdd	毋
txu	每
gxu	毒
xxn	比
xxf	毕
lxx	毗
tfn	毛
lvt	氀
qav	氏
nav	民
rnb	气
rnj	氘
rnm	氙
rnk	氚
rnw	氛
rnx	氟
rnc	氢
rnl	氤
rnu	氧
rnp	氨
rno	氮
rnv	氯
bii	氶
yii	氷
yni	永
iwu	氼
wiu	氽
ivn	氿
ish	汀
ian	汇
icy	汉
ikh	汌
iqy	汐
imh	汕
miu	汖
ifh	汗
inn	汜
ivg	汝
aiu	汞
iag	江
ibn	池
ifn	污
ifg	汢
inr	汤
ijg	汨
igg	汪
idc	汯
idy	汰
iby	汲
iyh	汴
iyy	汶
ity	汷
irb	汹
irn	汽
iwv	汾
icn	汿
iny	沁
irh	沂
ifq	沅
icq	沇
ipq	沈
igb	沌
iav	沏
isy	沐
ijf	沓
igh	沔
iit	沙
igm	沛
iiy	沝
iqc	沟
iwc	没
idh	沣
iar	沤
iwx	沦
iwb	沧
iyn	沪
igs	沫
ieg	沮
ipx	沱
itb	沲
isk	河
ixj	沸
img	油
ick	治
ivk	沼
idg	沽
ihk	沾
iwk	沿
ilw	泅
riu	泉
irg	泊
ibm	泏
ibe	泐
ixc	泓
iaf	泔
ifc	法
ilg	泗
itp	泛
ips	泞
iqn	泡
ihc	波
iug	泣
inx	泥
inv	泦
iyg	注
ihg	泪
iyx	泫
ina	泯
ilf	泴
diu	泵
ipi	泶
idx	泷
ihn	泸
itn	泺
int	泼
icg	泽
ica	泾
ifk	洁
ilk	洄
isg	洒
iri	洙
ita	洚
itk	洛
ioy	洣
iaw	洪
itl	洫
iqi	洮
ibg	洱
iyt	洲
iqj	洵
igj	洹
itd	活
ire	派
iyc	流
igu	浃
iqv	浄
ifx	浅
uqi	浆
iat	浇
ihm	浈
ijy	浊
imj	测
iwf	浍
iyj	济
ipl	浑
ipe	浓
irr	浙
iwh	浟
ikc	浥
itf	浩
iyv	浪
ieb	浮
iww	浴
itx	海
ivp	浸
ink	浺
iqk	浼
iev	浽
imy	浿
iwg	涂
ils	涃
iie	消
ihh	涉
ice	涌
ike	涓
imw	涔
idt	涛
iap	涝
igo	涞
ilp	涟
ikm	涡
iqm	涣
its	涤
iuj	涧
ixt	涨
ivy	涩
iuk	涪
iph	涫
inm	涮
idf	涯
iyw	液
ibi	涵
ild	涸
iuv	淁
ivl	淄
isr	淅
ird	淆
iqe	淊
iss	淋
iim	淌
ihj	淖
iqr	淘
iec	淝
ioo	淡
ieq	淣
iqg	淦
iet	淫
iwy	淮
ipw	深
iyk	淳
ijx	混
idj	淹
igd	添
iii	淼
ihd	渄
ige	清
ivi	渌
ilr	渐
ikj	渑
icd	渗
ift	渚
ioa	渡
ifp	渤
ing	渥
ile	渭
ixb	渳
ijq	渴
ihi	渺
inh	湄
imd	湍
idm	湎
ikb	湒
iue	湔
ide	湖
iad	湛
iyo	湾
ijo	湿
imf	溅
ivc	溉
iov	溏
idr	源
ipj	溟
iuw	溢
ico	溤
iex	溪
iub	溯
idw	溱
ieh	溲
ixu	溺
ijn	溻
ibw	滁
iux	滋
ibh	滍
iwr	滏
ime	滑
ipu	滓
iee	滔
itt	滗
igk	滞
ibc	滠
iha	滤
ijt	滥
ipr	滨
icw	滩
iyu	滴
isf	漂
isw	漆
ion	漉
ilv	漊
ibt	漋
inf	漏
iyr	漓
ipg	演
iaj	漠
iqt	漪
ijl	漫
ilx	漯
ixw	潍
ium	潎
ito	潘
ifw	潜
iam	潢
isj	潭
ifj	潮
iti	潲
inb	潺
ikk	澡
ima	澧
iog	澲
itm	澳
iyl	澶
iqd	澹
iry	激
iou	濂
ihw	濉
ivh	濜
ifd	濡
iwo	濮
inw	濯
inp	瀈
ija	瀑
ibd	瀡
ihq	瀣
imm	瀴
iol	瀵
iel	灂
iak	灌
ios	灖
ifa	灞
ooo	火
oqb	灮
osh	灯
dou	灰
ojh	灲
oag	灴
vou	灵
ofg	灶
oaj	灷
qyo	灸
obn	灺
oqy	灼
pou	灾
omh	灿
jou	炅
oyy	炆
oyn	炉
oqw	炊
odh	炋
oou	炎
ooy	炏
osy	炑
oit	炒
ogb	炖
aou	炗
orh	炘
qou	炙
joy	炚
ofn	炜
owb	炝
oyh	炞
olh	炠
ogh	炡
ovk	炤
oxj	炥
odc	炦
obm	炪
oyx	炫
mdo	炭
oqn	炮
omk	炯
cko	炱
oth	炸
hko	点
odg	炻
oan	炼
okw	炽
okq	炾
otu	烀
otn	烁
oud	烂
oca	烃
fox	烖
otk	烙
ojy	烛
old	烟
oft	烤
odm	烦
oat	烧
owx	烨
ony	烬
ord	烯
oeb	烰
opf	烷
otd	烽
oke	焆
ghg	焉
ojf	焊
ocw	焌
ogk	焐
owy	焓
oqm	焕
oun	焖
onn	焗
ouk	焙
sso	焚
uoi	焛
bco	焣
wyo	焦
oje	焨
ojq	焬
ohj	焯
oqe	焰
omu	焵
qdy	然
ojj	焻
ofa	焼
owd	煅
opl	煇
opg	煊
oju	煜
qvt	煞
ole	煟
oaf	煤
jvk	照
omn	煱
okm	熉
tgl	熏
opw	熔
ahk	熙
oce	熥
gqt	熬
ojl	熳
omj	熴
oyu	熵
ojb	熶
ofk	熺
osj	燂
oqd	燃
ouj	燑
oto	燔
aku	燕
ouy	燘
otm	燠
okk	燥
oue	燧
oep	燰
ofu	燵
oja	爆
oha	爈
ovl	爉
odt	爏
ouq	爓
oel	爝
ohh	爠
oip	爣
emg	爨
emf	爯
epd	爱
elv	爵
wru	父
wrb	爷
wrc	爸
wrq	爹
rru	爻
drr	爽
thg	片
aht	牙
tgk	牛
txn	牝
ctg	牟
tfg	牡
ptg	牢
tty	牧
tqr	物
tlg	牭
tdg	牯
tsk	牱
ttg	牲
txy	牳
dpt	牵
tsg	牺
nit	犀
tds	犄
thw	犋
tlc	犤
qtb	犯
udy	状
qtc	狁
qtg	狂
qto	狄
qtr	狐
qtx	狒
qtq	狗
qte	狙
qtp	狞
qtv	狠
qtj	独
qty	狼
qtt	猁
qta	猎
qtl	猥
qtf	猪
fmu	献
qtw	猴
qts	猹
qtm	猾
qtu	獍
yxu	玄
yxi	率
gyi	玉
ggg	王
gsh	玎
get	玏
gwn	玑
gag	玒
gfh	玕
gqy	玖
gcg	玛
gyy	玟
gwv	玢
gfq	玩
gty	玫
gxx	玭
gfn	玮
gdh	环
gmq	现
gwy	玲
gwa	玳
ghk	玷
qig	玺
ghc	玻
glh	玾
gvk	玿
grg	珀
gsk	珂
gck	珆
gek	珈
gna	珉
gmm	珊
gwe	珍
ggy	珏
gfc	珐
gdx	珑
gaw	珙
gtk	珞
gri	珠
gve	珢
gbg	珥
gtg	珩
gff	珪
gyt	班
gpl	珲
gye	珳
ggi	球
gke	琄
gyv	琅
gjf	理
gtb	琇
gyc	琉
gah	琊
glp	琏
gim	琐
gnd	琚
gpw	琛
gge	琢
gha	琥
gds	琦
gjx	琨
gad	琪
gpq	琬
gvi	琭
gpf	琮
goo	琰
gss	琳
ggw	琴
ggx	琵
ggc	琶
gqg	琻
gyk	琼
gnh	瑕
geg	瑗
gvt	瑙
gde	瑚
gam	瑛
gwg	瑜
gmd	瑞
ggn	瑟
gjl	瑥
gov	瑭
grq	瑰
ger	瑶
gtl	璁
gyr	璃
gvj	璅
guj	璋
gul	璔
goq	璘
gjy	璟
gaq	璥
ghq	璨
gtf	瓒
rcy	瓜
gnn	瓦
wcg	瓮
arg	瓯
uag	瓶
ukg	瓿
afd	甘
tda	甜
tgd	生
ehk	用
env	甩
geh	甫
dhe	甭
pne	甯
lll	田
lhn	甲
jhk	申
jnv	电
ler	男
qld	甸
lsh	町
glb	画
lsj	甼
lkh	甽
vlf	甾
lgj	畀
ylc	畆
lrc	畈
lty	畋
lwj	界
olg	畑
lug	畔
llf	畕
qyv	留
cdl	畚
yxl	畜
ltk	略
lff	畦
olf	畨
lye	畩
ldt	畴
lds	畸
lpq	畹
xxa	畿
luj	疃
xfg	疆
nhi	疋
nhy	疏
xtd	疑
ube	疓
usk	疔
uxv	疕
ubk	疗
uad	疘
utn	疙
ufi	疛
umk	疝
unr	疡
udn	疣
ucv	疤
uwj	疥
uwc	疫
ude	疬
uwb	疮
uwr	疯
uqn	疱
uhc	疲
uaf	疳
uhx	疵
ujg	疸
uwe	疹
utu	疼
ueg	疽
utd	疾
uyx	痃
ugm	病
unx	痆
ugh	症
uca	痉
uwg	痊
uug	痒
uve	痕
uce	痛
uie	痟
utj	痢
uww	痤
uqm	痪
uus	痫
uph	痯
uoo	痰
uma	痶
urm	痸
uld	痼
ubs	痾
utv	痿
uyw	瘁
unh	瘕
uov	瘘
ucy	瘙
uli	瘝
ujl	瘟
uiw	瘠
uqy	瘤
ueh	瘦
uaw	瘩
ucw	瘫
usf	瘭
ucc	瘮
ulx	瘰
uuj	瘴
uwf	瘵
uek	瘸
ulv	瘻
ubq	瘾
umm	瘿
uam	癀
ukk	癌
ugy	癍
unk	癖
una	癜
uqg	癣
ufh	癫
uhh	癯
wgd	癸
rrr	白
djf	百
rxb	皀
rfj	皁
rab	皂
rqy	的
xxr	皆
rgf	皇
rpf	皖
hci	皮
hcf	皯
plh	皲
hcp	皹
hlf	盀
gfl	盂
xhl	盄
khl	盅
wvl	盆
dyl	盇
bcl	盈
uwl	益
fcl	盍
mdl	盎
fhl	盐
dol	盔
ugl	盖
tel	盘
dnx	盛
vil	盝
jel	盟
eil	盥
hhh	目
hsh	盯
hfh	盰
hgf	盱
ynh	盲
fhf	直
htn	盵
hfq	盶
shg	相
hgb	盹
hrh	盺
hwv	盼
rfh	盾
hyy	盿
heg	眀
ith	省
hqa	眂
hrc	眅
hyt	眆
hit	眇
hpq	眈
nhd	眉
rhf	看
har	眍
hmd	眏
hxe	眑
liu	眔
hqk	眗
hck	眙
hps	眝
fhw	真
hna	眠
hrw	眣
hhx	眦
hvk	眧
htp	眨
hyx	眩
hug	眫
hff	眭
hoy	眯
hbg	眲
hqq	眵
udh	眷
hct	眸
hqi	眺
hve	眼
hre	眽
hqv	睁
hcw	睃
hpf	睆
hux	睇
htr	睋
hhq	睍
hgo	睐
hoo	睒
hdf	睚
hge	睛
htf	睡
hrt	睥
hfw	睦
heq	睨
hgv	睫
hes	睬
had	睰
hjt	睲
hpl	睴
hfk	睵
hft	睹
hpg	睿
hal	瞄
hto	瞅
hwc	瞈
hov	瞊
heh	瞍
hpd	瞎
hpj	瞑
hag	瞒
htw	瞛
hlv	瞜
hsf	瞟
hip	瞠
hkk	瞣
hwy	瞧
hog	瞨
hnt	瞩
hwg	瞪
hsj	瞫
hep	瞬
hyc	瞮
hnb	瞰
hcn	瞲
huj	瞳
hrl	瞴
hoq	瞵
hqd	瞻
hhw	瞿
hpn	矃
hoa	矌
hun	矙
tdu	矢
ctd	矣
dwn	矶
dbg	矷
dfh	矸
dag	矼
dqy	矽
dot	矿
dnr	砀
dcg	码
dit	砂
dyy	砇
dav	砌
dqw	砍
dah	砑
dxx	砒
dga	研
dlh	砗
dgb	砘
dmq	砚
dwr	砜
dth	砟
dpx	砣
dqa	砥
hxd	砦
dxj	砩
dyg	砫
dug	砬
dtp	砭
dgu	砰
dhc	破
drg	砶
djh	砷
dam	砸
dar	砹
dwa	砼
dtn	砾
doc	砿
dbm	础
dca	硁
dtl	硇
dtk	硌
dmg	硐
dsg	硒
ddm	硕
dat	硗
die	硝
dtr	硪
dyc	硫
dgj	硬
dqe	确
dqv	碀
dmf	碉
dvi	碌
djg	碍
dyw	碎
drt	碑
dqg	碒
dpq	碗
dma	碘
duk	碚
dgm	碛
dcd	碜
dan	碟
djq	碣
grd	碧
dlg	碨
duo	碰
ddg	碱
dmd	碳
dsj	碴
dpg	碹
dna	碾
dux	磁
dov	磄
dyu	磅
drq	磈
dcc	磉
ddd	磊
duv	磏
dfc	磕
doq	磷
dwy	礁
dyk	礅
dtm	礇
dgl	礓
djx	礘
dap	礞
daw	礤
dos	礳
dai	礴
fiu	示
pyn	礼
pyf	社
pyb	祁
pyr	祈
pye	祖
pyq	祗
pyt	祚
pyk	祝
pyj	神
bmf	祟
pyu	祥
sfi	票
wfi	祭
pyh	祯
pyd	祷
pya	祺
ssf	禁
pyv	禄
pyg	福
pyy	禳
mci	禸
tkm	禹
yrb	离
ttt	禾
tbr	秀
tcy	私
twu	秂
twb	秃
tbg	秄
tfh	秆
tgv	秉
toy	秋
tkh	种
tit	秒
tnt	秘
teg	租
tgu	秤
dwt	秦
trw	秩
tsy	秫
ttn	秭
tkw	积
tqi	称
tqq	移
tmq	秽
trd	稀
tyv	稂
teb	稃
tkk	稆
tie	稍
tuk	税
trt	稗
twy	稚
ttj	稪
tqv	稳
tlw	稷
tee	稻
tpg	稼
tyk	稿
tri	穆
tev	穏
toa	穬
pwu	穴
pwv	究
pwe	穷
pwx	穹
pwa	穿
pwd	突
pwr	窑
pwg	窒
pwq	窕
pwt	窗
pwk	窝
pwn	窟
pwj	窠
pwo	窭
pwb	窿
uuu	立
uwn	竌
uwv	竕
jcu	竖
ujq	竟
upd	竤
umd	端
tht	竹
tff	竺
tgf	竽
tbb	竾
taf	笁
tcg	笃
tga	笄
tcb	笆
tby	笈
tvt	笋
ttd	笑
ttf	笔
tlj	笚
tmf	笛
tck	笞
tuf	笠
tvk	笤
tng	笥
twf	符
txh	第
tqk	笱
tek	笳
tfx	笺
tdx	笼
tab	筇
twa	筏
tag	筐
taw	筑
tgm	策
trk	筘
txx	筚
tce	筩
tal	筪
tmu	筫
twh	筱
tth	筵
tnn	筷
tuj	简
tbc	箃
tra	箍
tge	箐
tir	箔
tad	箕
tha	算
tpw	箜
tph	管
tpq	箢
trc	箨
tlq	箩
tul	箪
tvi	箫
tue	箭
tsh	箱
tft	箸
txg	篆
tyn	篇
twn	篌
tov	篓
tss	篥
ttl	篦
tyr	篱
trq	篼
tvo	簘
tsj	簟
tam	簧
taq	簪
tig	簿
oyt	米
tyo	籴
ofh	籵
own	籶
ovg	籹
odu	类
obg	籽
ovy	籾
ofy	籿
owv	粉
oxh	粌
ocn	粑
oug	粒
org	粕
ogs	粖
oeg	粗
ohk	粘
omg	粙
voj	粛
bmo	粜
osg	粞
tlo	粤
xox	粥
oaw	粪
oyv	粮
ogj	粳
oyw	粹
oge	精
ojs	粿
ocd	糁
onh	糈
ode	糊
oux	糍
oov	糖
otf	糙
ogm	糟
oxk	糨
xiu	糸
txi	系
xsh	糽
xvt	糿
xkh	紃
xpq	紞
gxi	素
fpx	索
xrh	紤
jcx	紧
hxx	紫
xmg	紬
lxi	累
xhc	紴
xmd	紻
xmk	絅
xrg	絈
xoc	絋
xri	絑
xuq	絘
xsg	絤
vkx	絮
xhq	絸
xpd	綋
xuk	綐
xjs	綶
xgv	緀
xbc	緅
xtv	緌
xus	緧
xpl	緷
xmn	緺
xhm	緽
xub	縌
xme	縎
xkm	縜
xji	縨
txt	繁
xjb	繓
xoq	繗
xqe	繲
xuj	繶
xha	纑
gxh	纛
xnh	纠
xag	红
xfy	纣
xtf	纤
xqy	约
xby	级
xot	纩
xnn	纪
xvy	纫
xfc	纭
xgb	纯
xit	纱
xmr	纲
xmw	纳
xww	纵
xwx	纶
xwv	纷
xqa	纸
xyy	纹
xyt	纺
xfx	线
xaf	绀
xdc	绂
xan	练
xeg	组
xjh	绅
xlg	细
xkw	织
xtu	终
xqv	绉
xug	绊
xxj	绋
xbm	绌
xvk	绍
xcg	绎
xca	经
xck	绐
xdt	绑
xad	绒
xfk	结
xdf	绔
xat	绕
xtg	绗
xwf	绘
xwg	给
xqj	绚
xtk	络
xqc	绝
xyw	绞
xyc	统
xgj	绠
xie	绡
xke	绢
xtb	绣
xev	绥
xts	绦
xon	继
xgm	绩
xft	绪
xfw	绫
xfn	续
xds	绮
xhd	绯
xhj	绰
xim	绱
xjx	绲
xkj	绳
xwy	维
xrm	绵
xep	绶
xee	绷
xmf	绸
xth	绺
xud	绻
xpf	综
xpg	绽
xph	绾
xvi	绿
xcc	缀
xvl	缁
xak	缂
xdg	缄
xjt	缆
xjg	缇
xhi	缈
xkb	缉
xln	缌
xwd	缎
xwn	缑
xyu	缔
xov	缕
xyn	编
xna	缗
xge	缚
xfh	缜
xyk	缟
xoj	缠
xyr	缡
xuw	缢
xuv	缣
xpr	缤
xsf	缥
xjl	缦
xlx	缧
xmm	缨
xpw	缩
xnw	缪
xvj	缫
xdu	缭
xgl	缰
xkk	缲
xry	缴
rmk	缶
rmn	缺
rmj	罎
rma	罐
mrr	网
muy	罔
lqu	罗
ldh	罘
lyj	罚
ldf	罟
lgh	罡
lfc	罢
lux	罤
lke	罥
ldj	罨
lhj	罩
lhd	罪
lfm	罱
lft	署
lnw	罹
lvj	罺
lja	罼
lul	罾
lxk	羂
laj	羃
lxh	羄
ugj	羊
ufq	羌
ugw	羚
ugn	羞
ugc	羟
vtk	群
ugt	羲
ugo	羹
nny	羽
nag	羾
wcn	翁
fcn	翅
lng	翈
ung	翊
nug	翋
nuf	翌
nyw	翠
nrf	翫
tol	翻
nla	翼
igq	耀
ftx	老
ftg	考
ftj	者
dmj	而
dii	耒
dib	耔
dif	耕
dic	耙
dih	耜
diw	耠
dij	耦
dio	耧
did	耨
dia	耩
diy	耪
bgh	耳
bsh	耵
bbh	耶
dbf	耷
wwb	耸
bfc	耺
bhg	耻
bpq	耽
bdc	耾
boy	耿
bay	聀
bcc	聂
bxe	聈
bbm	聉
bqt	聊
bkw	职
bps	聍
bqi	聎
bfk	聐
btd	聒
bud	联
bmg	聘
bci	聚
bak	聝
bwc	聡
beq	聣
byk	聤
bkh	聩
buk	聪
bqd	聸
vgk	聿
vhk	肀
vij	肃
dcv	肆
mww	肉
eet	肋
ewn	肌
evn	肍
pef	肎
evy	肒
ief	肖
evg	肗
efy	肘
kef	肙
efg	肚
eag	肛
efh	肝
efn	肟
enr	肠
ewc	股
efc	肢
efw	肤
ecn	肥
eyt	肪
egb	肫
emw	肭
hef	肯
edc	肱
yce	育
rde	肴
erh	肵
exx	肶
eqw	肷
egm	肺
hpe	肻
efj	肼
edy	肽
jce	肾
ekh	肿
eta	胀
eew	胁
lef	胃
ejg	胆
erg	胉
uxe	背
erc	胍
eck	胎
mub	胐
enx	胒
eug	胖
ewe	胗
edh	胚
elh	胛
etg	胜
eqa	胝
eqn	胞
exy	胟
deg	胡
txe	胤
nhe	胥
emd	胦
edx	胧
eai	胨
ehg	胩
ehn	胪
eca	胫
eld	胭
edf	胯
egx	胰
eig	胱
etk	胳
eyw	胶
eqr	胸
epv	胺
eua	胼
cex	能
exj	脂
eqd	脆
eyn	脉
iwe	脊
ewf	脍
ers	脎
eof	脏
eyj	脐
eyr	脑
eoy	脒
efp	脖
eww	脞
ean	脦
eeb	脬
eev	脮
euk	脱
eni	脲
eir	脳
ewg	脸
ert	脾
ejs	腂
eoo	腅
ema	腆
etv	腇
ecc	腏
owf	腐
eow	腑
ehd	腓
epw	腔
epq	腕
epf	腙
epg	腚
edw	腠
ejm	腢
ejt	腥
efm	腩
eln	腮
esv	腰
enh	腵
etj	腹
eri	腺
eaf	腻
ejl	腽
eud	腾
eve	腿
eyu	膀
euv	膁
eeh	膄
eov	膅
egk	膈
eiw	膌
eex	膎
epr	膑
eak	膒
eon	膔
ela	膕
esf	膘
exk	膙
eip	膛
esw	膝
efv	膤
eoq	膦
efk	膨
eda	膸
efa	膹
eyl	膻
emn	膼
eyx	臃
euj	臆
ekk	臊
eah	臔
dnd	臧
thd	自
ths	臬
gcf	至
eth	臼
qef	臽
eef	舀
eaj	舁
dwe	舂
eqo	舄
ele	舅
elg	舆
tdd	舌
wfk	舍
tdq	舐
nvp	舝
rlg	舞
tei	舟
tea	舡
tey	航
tew	般
tex	舭
tem	舰
tep	舵
tes	舸
teh	舻
tej	艃
tet	艇
ten	艉
teu	艟
vei	艮
yve	良
cve	艰
qcb	色
dhq	艳
xjq	艴
uaq	艵
anb	艺
asj	艼
avb	艽
aru	艾
abr	艿
avr	芀
abj	节
avy	芄
acy	芆
afj	芉
atf	芊
agf	芋
aqy	芍
axb	芎
aff	芏
bhb	芔
aqu	芕
adu	芖
axt	芗
afw	芙
afq	芜
apu	芝
aqw	芡
abn	芤
awj	芥
aby	芨
aqa	芪
awv	芬
acb	芭
anu	芯
awx	花
ayr	芳
aqc	芶
ahf	芷
afc	芸
arj	芹
aah	芽
agm	芾
ayh	苄
afn	苇
adb	苊
amq	苋
ata	苌
awb	苍
aew	苏
axh	苐
aqb	苑
ack	苔
amf	苖
alf	苗
amk	苘
auf	苙
ask	苛
aqn	苞
ana	苠
aan	苣
adk	若
adf	苦
arf	苩
asg	苯
amd	英
aeg	苴
aaf	苷
agu	苹
axu	苺
abm	茁
adx	茂
aib	范
aek	茄
acn	茅
ahx	茈
ags	茉
aca	茎
apn	茕
avv	茘
ave	茛
asf	茜
aju	茧
auq	茨
aiy	茫
awd	茯
aia	茳
aws	茶
abf	茸
avk	茹
ayc	茺
amg	茼
aqj	荀
aga	荆
agc	荎
awt	荏
adh	荐
agx	荑
ayn	荒
aee	荔
aat	荛
axx	荜
ain	荡
aps	荣
apl	荤
api	荥
apt	荦
apo	荧
avf	荨
abe	荫
axa	荭
axf	荮
axq	药
afp	荸
aev	荽
acw	荾
age	莆
atj	莉
alj	莗
awh	莜
atb	莠
ayv	莨
atr	莪
ajd	莫
ago	莱
alp	莲
akm	莴
aqt	获
apg	莹
apq	莺
axg	莼
ady	莽
aph	菅
avd	菇
aqo	菊
alt	菌
ajx	菎
ais	菏
avl	菑
aeb	菔
ajj	菖
asw	菘
aes	菜
ard	菝
aih	菠
asr	菥
aoq	菧
auk	菩
apd	菪
aiv	菬
ahd	菲
aqf	菳
aie	菹
ahg	菽
ayw	萃
art	萆
agv	萋
aje	萌
atv	萎
aqe	萏
alq	萝
apj	萤
apk	营
apx	萦
avi	萧
abu	萨
ait	落
awk	葆
aft	著
ash	葙
ajq	葛
aqg	葡
atg	董
arc	葩
agq	葬
aqr	葱
adg	葳
awg	葵
aln	葸
akb	葺
arb	葼
ayu	蒂
air	蒎
apf	蒙
afi	蒜
axm	蒳
aub	蒴
abi	蒸
auv	蒹
aut	蒺
ayx	蓄
ame	蓇
apw	蓉
awc	蓊
ayk	蓑
atl	蓖
ajt	蓝
ace	蓪
ath	蓰
anw	蓼
agk	蔌
ald	蔑
ajl	蔓
aoa	蔗
anf	蔚
ayt	蔟
awf	蔡
anh	蔬
abg	蔯
afu	蔷
auw	蔺
ayj	蔼
aum	蔽
ato	蕃
ann	蕊
agj	蕙
ajb	蕞
abt	蕯
aul	蕲
axj	蕴
adc	蕻
afl	蕾
aoe	蕿
ail	薀
ary	薂
aig	薄
atm	薇
auj	薏
ank	薜
aus	薪
aov	薮
aog	薱
aej	薶
afk	薹
adi	藉
adn	藏
aer	藐
atq	藜
aeu	藤
aik	藻
aye	蘐
aos	蘑
aam	蘣
aha	蘧
atx	蘩
hav	虍
haw	虎
hae	虏
haa	虐
han	虑
hay	虔
hao	虚
hak	虞
jhn	虫
jnn	虬
jwn	虮
jsh	虰
ntj	虱
jhy	虲
jbn	虵
jbg	虸
jag	虹
jtn	虼
kju	虽
qnj	蚀
jyr	蚁
jcg	蚂
jcn	蚆
yju	蚉
jyy	蚊
jmw	蚋
jdh	蚌
jxh	蚓
gdj	蚕
jkh	蚛
jah	蚜
jtf	蚝
jsy	蚞
jwc	蚣
cyj	蚤
jwj	蚧
jfw	蚨
jmq	蚬
jwa	蚮
jmg	蚰
jsk	蚵
jaf	蚶
jmf	蚺
snj	蚻
jyg	蛀
jdc	蛂
jdg	蛄
jpx	蛇
jlf	蛊
nhj	蛋
jma	蛐
jct	蛑
jlk	蛔
jff	蛙
jri	蛛
jyw	蛟
jng	蛡
jwg	蛤
jgc	蛭
yoj	蛮
jgu	蛱
jyj	蛴
jgv	蛵
jgi	蛷
jie	蛸
jlh	蛼
jmy	蛽
jtr	蛾
lqj	蜀
jtd	蜂
rrj	蜇
jkg	蜈
jeb	蜉
jql	蜔
juk	蜕
jkm	蜗
pnt	蜜
jlt	蜠
jaj	蜡
jbl	蜢
jak	蜮
ecj	蜰
jrt	蜱
jtv	蜲
jud	蜷
jjs	蜾
jpq	蜿
jcc	蝃
jmu	蝄
jkj	蝇
jlg	蝈
jul	蝉
jtu	蝌
jvc	蝍
jjq	蝎
jrg	蝗
jyn	蝙
jle	蝟
jus	蝤
jrb	蝬
jtj	蝮
jde	蝴
jan	蝶
jfm	蝻
jov	蝼
jdw	蝽
jap	蝾
jyv	螂
jdr	螈
juv	螊
jeh	螋
gkm	融
jme	螖
jrq	螝
jpj	螟
jip	螳
jsf	螵
jlr	螹
jlx	螺
jyx	蟀
jad	蟒
jfk	蟛
jto	蟠
jam	蟥
jva	蟳
jyl	蟺
jqd	蟾
juq	蠀
jaa	蠂
jlq	蠋
jal	蠛
jll	蠝
tld	血
tlu	衅
tgs	行
tqg	衔
tqd	衡
yeu	衣
geu	表
puc	衩
pue	衫
puf	衬
fke	袁
put	袄
eky	袈
puq	袍
pum	袖
pug	袜
puh	被
dxy	袭
xye	袰
yqq	袲
fye	裁
ufy	装
pui	裆
puk	裎
yem	裔
puw	裕
pul	裢
puo	裤
pur	裨
puj	裸
jse	褁
puy	褊
ywk	褒
puu	褙
pua	褡
yli	褱
pun	褶
pux	襁
ykk	襄
pus	襟
svf	要
stt	覆
chq	覌
hqb	覎
qih	覙
foh	覝
tvh	覣
hqt	覹
mqb	见
cmq	观
fwm	规
emq	觅
pym	视
hkm	觇
ipm	觉
mnm	觊
qeh	角
hxq	觜
yyy	言
vyd	訄
yvn	訅
qyd	訇
ybn	訑
myf	訔
uyd	訚
yxh	訠
ylg	訵
hxy	訾
lyf	詈
yxe	詏
ypx	詑
yhc	詖
yde	詴
yoy	詸
qdw	詹
ybg	誀
yvp	誛
yeq	誽
yqo	諊
yln	諰
yeh	謏
yex	謑
ylp	謰
ylv	謱
yrl	譕
yxg	譝
yqm	讂
yll	讄
ybe	讔
yfh	计
ysh	订
yhy	讣
ywy	认
ywn	讥
yag	讧
yfy	讨
yhg	让
ymh	讪
ykh	训
yyr	议
ynf	讯
ynn	记
yfj	讲
yar	讴
yah	讶
ymw	讷
ytf	许
ywx	论
ywc	设
yyt	访
ygh	证
ydg	诂
ysk	诃
ygu	评
yeg	诅
ykw	识
yry	诉
ywe	诊
yqa	诋
yqv	诌
ybm	诎
yvk	诏
ycg	译
yck	诒
ydi	诔
yaa	试
yff	诗
yfk	诘
ydo	诙
ydn	诚
ytd	话
yth	诞
yrg	诟
yqd	诡
yqj	询
yxj	诣
yyn	该
yug	详
ypt	诧
ypl	诨
yng	诩
yaw	诬
ygk	语
yie	诮
ykg	误
ytx	诲
yqt	诳
yuk	说
yct	诶
yge	请
yft	诸
ybc	诹
yad	诺
yfn	读
yhd	诽
yjs	课
ytv	诿
yew	谀
ymf	调
yqe	谄
yyk	谅
yyw	谇
yoo	谈
ype	谊
yaf	谋
yan	谍
yay	谎
ygl	谏
yxx	谐
yha	谑
yjq	谒
yle	谓
ywg	谕
yqk	谗
yuq	谘
yuj	谙
yut	谚
yaj	谟
yip	谠
ylw	谡
ytm	谢
yer	谣
yyu	谤
yuw	谥
yuv	谦
yak	谨
yjl	谩
yue	谫
ysj	谭
yaq	谮
yuo	谱
ycn	谲
yfm	谳
wwk	谷
gku	豆
gei	豕
ueu	豙
qke	象
ety	豸
eqy	豹
eft	豺
evk	貂
ews	貅
edj	貊
erq	貌
etl	貔
cmu	貟
mbn	貤
mtg	貹
mtl	賉
mdx	賎
mmy	賏
pnm	賔
mpl	賱
mmt	贁
mip	贘
hmu	贞
qmu	负
amu	贡
mft	财
gmu	责
jcm	贤
mty	败
mta	账
wxm	货
rfm	质
mrc	贩
wvm	贫
mtp	贬
mqc	购
mpg	贮
xfm	贯
afm	贰
mfx	贱
fam	贲
anm	贳
khg	贵
mkq	贶
xjm	费
ekm	贺
mck	贻
smu	贾
mde	贿
hxm	赀
mtk	赂
mof	赃
uqw	资
myn	赅
mny	赆
mgi	赇
gom	赉
mwf	赊
mfh	赋
fww	赍
mfn	赎
mjq	赐
muk	赔
moo	赕
mge	赙
muv	赚
paw	赛
mul	赠
mqd	赡
fou	赤
fof	赫
fhu	走
fhh	赴
fhr	赵
fhe	趄
fhv	超
fhq	趋
fhi	趟
fhb	趣
fht	趱
khu	足
khw	趴
gqk	趸
khh	趾
kht	跃
khr	跌
khq	跑
kha	距
khv	跟
khd	跨
khf	践
khc	踊
khi	踏
khj	踢
khe	踩
khp	踪
kho	踱
khb	蹑
lrk	蹔
khm	蹦
tmd	身
lkf	軎
ldy	軑
lmh	軕
lgg	軖
lmw	軜
lqk	軥
lkq	軦
lqn	軳
ldc	軷
lua	軿
lig	輄
lie	輎
ljs	輠
lqe	輡
lph	輨
lyk	輬
ljq	輵
lgv	輺
llp	轋
lnb	轏
log	轐
lah	轞
lgn	车
lnn	轧
lvn	轨
lfh	轩
lvy	轫
lfn	转
ldb	轭
lwx	轮
lqw	软
lcc	轰
ldg	轱
lsk	轲
lmg	轴
lkw	轵
lrw	轶
lwe	轸
ltn	轹
lvk	轺
lca	轻
laa	轼
flx	载
lgc	轾
ltd	轿
lyw	较
lbn	辄
lge	辅
lgm	辆
hdh	辈
ljx	辊
lmu	辋
lvl	辎
ldw	辏
lgk	辐
lkb	辑
lwg	输
lfk	辕
lpd	辖
lna	辗
lon	辘
lyc	辙
loq	辚
ufj	辛
duf	辜
udx	辫
dfe	辱
ehu	辵
gpd	辷
bpe	辸
epe	边
vpe	辺
fpk	辻
bpk	辽
dpi	达
mpk	辿
gfp	迂
tnp	迄
nfp	迅
fpi	过
gqp	迈
npe	迉
qbp	迎
fcp	运
rpk	近
rcp	返
dhp	还
ypi	这
fjp	进
fqp	远
lpk	连
nyp	迟
vkp	迢
mkp	迥
ekp	迦
ckp	迨
mpd	迪
rpd	迫
rwp	迭
syp	述
pxp	迱
cap	迳
opi	迷
uap	迸
yop	迹
vep	退
udp	送
tdp	适
qip	逃
tah	逄
bip	逊
iep	逍
tbp	透
gep	逐
ceh	通
rrp	逝
kgp	逞
cwt	逡
tdh	逢
vip	逮
tvp	逶
lqp	逻
uep	遂
hmp	遉
ynm	遍
rgp	遑
jnp	遢
cop	遤
erm	遥
gma	遭
oao	遮
lvp	遱
ryt	邀
vlr	邋
kcb	邑
sbh	邒
cbh	邓
nbh	邔
vkc	邕
fbh	邗
vbh	邚
abh	邛
obh	邝
ybh	邡
gab	邢
ngb	那
rbh	邤
dtb	邦
mbh	邮
afb	邯
ckb	邰
rgb	邱
vkb	邵
uxb	邶
qay	邸
qvb	邹
rib	邾
deb	郁
qjb	郇
plb	郓
ebb	郛
fob	郝
kmb	郧
ukb	部
ykb	郭
oob	郯
eqb	郳
ssb	郴
ulb	郸
nka	郼
ajv	郾
sfb	鄄
kfl	鄙
xbh	鄳
fkk	酃
mdh	酆
sgs	酊
sgq	酌
sgn	配
sgb	酏
sgr	酗
sgw	酚
sgp	酡
sgx	酯
uqs	酱
sgf	酵
sgt	酷
sgc	酸
sge	酹
sgu	醅
sgy	醉
sga	醋
sgj	醒
tos	醔
sgo	醚
toi	釆
esu	采
tom	釉
toc	释
jfd	里
tgj	重
jfc	野
jgj	量
qqq	金
wrf	釜
qwn	釠
wqf	釡
qbt	釢
qiy	釥
qfn	釫
qag	釭
qrh	釿
qwc	鈆
qxh	鈏
qwv	鈖
qcq	鈗
qsy	鈢
qjg	鈤
qyy	鈫
qbm	鈯
qck	鈶
qwe	鉁
qxy	鉧
qek	鉫
qoc	鉱
qjy	鉵
qct	鉾
qdx	銭
yoq	銮
qcc	錣
qph	錧
qso	錰
lrq	錾
qqg	鍂
qpl	鍕
qjm	鍝
qhm	鍞
qbb	鎁
qji	鎤
qco	鎷
qvj	鏁
qja	鏎
qme	鏰
qae	鏾
qob	鑁
qpa	鑧
qhh	鑺
qnn	钇
qfh	针
qsh	钉
qjh	钊
qbh	钌
qfg	钍
qkh	钏
qet	钐
qqy	钓
qun	钔
qvg	钕
qcy	钗
qgh	钙
qan	钜
qgb	钝
qit	钞
qmw	钠
qmy	钡
qmr	钢
qrc	钣
qeg	钥
qqw	钦
qqn	钨
qqc	钩
qyt	钫
qoy	钬
qnh	钮
qcn	钯
qfx	钱
qaf	钳
qdg	钴
qsg	钵
qsk	钶
qak	钷
qdm	钸
qdc	钹
qgn	钺
qhk	钻
qhg	钼
qlh	钾
qlg	钿
qmg	铀
qrw	铁
qrg	铂
qwy	铃
qwk	铅
qqt	铆
qym	铈
qyx	铉
qpx	铊
qnx	铌
qhc	铍
qcg	铎
qbg	铒
qde	铕
qdn	铖
qat	铙
qiv	铛
qkk	铝
qmn	铠
qmj	铡
qwx	铧
qwg	铨
qrs	铩
qtk	铬
qqk	铭
qqv	铮
qyw	铰
qye	铱
qut	铲
qyc	铳
qin	铴
qpv	铵
qve	银
qvk	铷
qdt	铸
qap	铹
qge	铺
qlp	链
qjc	铿
qie	销
qim	锁
qjf	锂
qkg	锃
qkm	锅
qww	锉
qtd	锋
quf	锌
quk	锐
qux	锑
qvp	锓
qbs	锕
qft	锗
qad	锘
qal	锚
qdf	锛
qjs	锞
qjx	锟
qjq	锡
qlq	锣
qrm	锦
qrq	锨
qqr	锪
qoo	锬
qpg	锭
qnd	锯
qbl	锰
qvl	锱
qdh	锲
qxx	锴
quq	锵
qln	锶
qwd	锻
qoa	镀
qug	镁
qov	镂
qxj	镄
qbc	镊
qth	镍
qyu	镑
quw	镒
qpr	镔
qsf	镖
qjl	镘
qlx	镙
quj	镜
qsj	镡
qdu	镣
qog	镤
quo	镨
qxk	镪
qaw	镬
qfl	镭
qpw	镲
qon	镳
qyk	镶
tay	长
uye	閍
uii	閖
uud	閚
usd	閪
ued	閰
uyh	门
uwi	闪
udd	闫
uft	闭
ukd	问
ugd	闰
ufn	闱
usi	闲
udc	闳
ujd	间
uyi	闵
uni	闷
ulk	闸
uym	闹
uff	闺
ubd	闻
uji	闽
uwa	阀
utk	阁
uyn	阂
uls	阃
uqj	阄
uuk	阅
uyv	阆
uak	阈
udj	阉
ujj	阊
ueq	阋
uqa	阍
uqe	阎
uul	阐
uit	阔
ufc	阖
uub	阙
unb	阚
bet	阞
bwy	队
bgq	阢
bbn	阤
bdh	阫
bfq	阮
bfj	阱
byt	防
bjg	阳
beg	阴
blh	阵
bwj	阶
bth	阼
bsk	阿
bpx	陀
bhc	陂
bwf	附
bfi	际
bgb	陆
bdx	陇
bai	陈
bca	陉
bqq	陊
bgm	陋
bdj	陌
bta	降
bve	限
bgu	陕
bie	陗
bxx	陛
bhh	陟
bfh	陡
bpf	院
bwg	除
bjf	陧
bkm	陨
bbc	陬
bqo	陱
btf	陲
brt	陴
bfw	陵
bqr	陶
bqe	陷
bsf	陻
bft	陼
baj	隁
bjm	隅
btg	隆
bda	隋
brg	隍
bde	随
bqv	隐
bgk	隔
brq	隗
buw	隘
bij	隙
buj	障
bev	隠
boq	隣
bnk	隦
bue	隧
bfn	隯
bjx	隰
bit	隲
bha	隵
vii	隶
wyb	隽
cwy	难
dww	雁
dcw	雄
wys	集
ynw	雇
tdw	雉
hxw	雌
yxt	雍
egw	雎
qvw	雏
mfk	雕
fvf	雪
fsu	雬
fyu	雯
fyr	雱
fde	雳
fwy	零
flf	雷
fqn	雹
fdm	需
fie	霄
fyf	霅
ftf	霆
fdf	震
fig	霈
fuv	霎
fhd	霏
feq	霓
fss	霖
fsh	霜
fnh	霞
fyj	霭
fae	霰
fak	霸
fnk	霹
fej	霾
gef	青
gem	靓
uge	靖
geq	静
akf	革
ujf	音
ujv	韶
hah	頥
fod	頳
ehx	頿
dmu	页
sdm	顶
xdm	顷
adm	项
kdm	顺
edm	须
gdm	顼
fqd	顽
dbd	顾
gbn	顿
wvd	颁
wcd	颂
ywd	颃
cnh	预
hcd	颇
cad	颈
fkd	颉
xid	颍
hhd	频
twd	颓
jsd	颗
jgh	题
mdm	颛
ptk	额
ylk	颤
akk	颧
wri	风
wre	飕
dyd	飙
wro	飚
nui	飞
wyv	食
xtw	飨
hqc	餐
qnb	饣
qnw	饥
qnr	饭
qnq	饮
qnf	饯
qnt	饰
qnc	饴
qna	饶
qny	饺
qnu	饼
qne	馁
qnp	馆
qns	馇
qnk	馈
uth	首
tjf	香
coq	馰
cot	馲
coa	馵
cog	馷
cor	馸
coj	馹
cob	馺
coc	馻
coy	馼
cok	馽
cod	駀
con	駃
com	駉
coh	駊
cov	駋
col	駰
cou	駾
cos	騋
coe	騪
coo	騼
cgd	马
cga	驱
cgr	驳
cge	驵
cgk	驶
cgq	驹
cgp	驼
vcc	驽
ekc	驾
kkc	骂
cgt	骄
cgg	骊
cgm	骋
cgw	验
cgv	骎
cgj	骒
cgy	骗
cgc	骚
cgs	骠
cgl	骡
cgn	骣
cgb	骤
cgu	骥
mef	骨
mev	骩
mew	骰
meh	骳
mes	骵
mey	骸
met	骼
mej	髁
meo	髅
mep	髋
men	髎
mel	髑
med	髓
ykm	高
dce	鬃
obx	鬯
rqc	鬼
fcr	魂
tvr	魏
qoj	魝
qor	魬
qox	魮
qom	魶
qos	魺
qol	魻
qoh	鮍
qoe	鮾
qok	鰐
qgf	鱼
qgd	鱿
qgj	鲁
qgw	鲋
qgq	鲍
qgc	鲐
qgu	鲜
udq	鲞
qgg	鲡
qgt	鲦
qgp	鲩
qgv	鲫
qgm	鲷
qgy	鲸
qgl	鳃
qgk	鳄
qgr	鳇
qga	鳓
qgs	鳔
qgo	鳞
xjw	鴲
evw	鵎
vlw	鶅
lvw	鷜
qyn	鸟
vqy	鸠
cqy	鸡
ayq	鸢
kqy	鸣
xfq	鸨
pqq	鸩
aiq	鸫
hnq	鸬
lqy	鸭
mdq	鸯
qbq	鸳
wsq	鸺
iaq	鸿
keq	鹃
usq	鹇
eeq	鹏
deq	鹕
meq	鹘
nhq	鹛
pwy	鹤
duj	鹩
hlo	鹶
onj	鹿
gtu	麦
sww	麴
oss	麻
amw	黄
ipa	黉
tqt	黎
twi	黏
lfo	黑
jfo	黒
kjn	黾
fqk	鼋
kkl	鼍
hnd	鼎
bhn	鼐
fku	鼓
qif	鼗
enu	鼠
thl	鼻
yjj	齐
hbn	齓
hbt	齕
hba	齖
hbr	齗
hbw	齘
hbc	齝
hbk	齞
hbj	齥
hbe	齨
hby	齩
hbl	齫
hbd	齮
hbb	齱
hbp	齳
hbu	齴
hbq	齺
hbs	齼
hwb	龄
ttx	龝
qjn	龟
lhk	㐃
vnb	㐇
fnb	㐊
enb	㐍
ynb	㐎
gnb	㐏
onb	㐘
oln	㐣
wkg	㐰
wer	㐱
wqy	㐴
wxy	㑄
wjc	㑠
wlq	㑩
rwu	㒵
phu	㓀
ush	㓅
uyc	㓍
ybk	㓙
hcj	㓟
vlj	㓯
soj	㔄
lce	㔥
dxb	㔫
aqh	㔰
arh	㔸
fet	㔹
hlk	㔽
mbb	㕀
dud	㕇
ccu	㕕
wkf	㕣
kvn	㕤
kyt	㕫
ksy	㕲
kgg	㕵
krg	㕷
ikx	㕾
kvg	㖀
kjx	㖂
kvf	㖊
wjk	㖋
koh	㖢
kec	㖬
kxm	㖰
kue	㗴
ksl	㘄
kco	㘐
lee	㘞
lak	㘟
llk	㘡
lij	㘤
fle	㙕
fal	㙹
dbj	㚎
daj	㚏
ddu	㚐
vdu	㚑
dsu	㚓
dqk	㚚
vvf	㚣
vay	㚤
vot	㚧
vhn	㚶
lvf	㚻
vlg	㚼
vqn	㚿
vrc	㛂
vsg	㛉
vrd	㛓
vuf	㛙
vmy	㛝
vss	㛦
vdj	㛪
vjq	㛫
vpo	㛮
vsj	㜁
vna	㜊
vlp	㜕
von	㜙
vlq	㜛
lrv	㜞
vlv	㜢
vlm	㜥
vrx	㜰
vrr	㜱
vhh	㜹
vbf	㜽
pcu	㝊
pbj	㝋
ppu	㝎
pnc	㝕
pth	㝚
pfk	㝨
gni	㝳
nci	㞋
nbd	㞌
ncv	㞎
bhw	㞣
mwu	㞤
mwn	㞦
mbr	㞧
mbg	㞨
vmj	㞪
mpu	㞫
mjf	㞱
mkh	㞲
myu	㞵
myy	㞶
mkg	㞻
bim	㞼
mnx	㞾
mxy	㟂
mku	㟕
mra	㟛
mud	㟡
mvi	㟤
mcd	㟥
mlv	㟺
msf	㟽
mnk	㠔
mll	㠥
mhx	㠲
mhv	㠴
oai	㡲
oyd	㢇
obs	㢌
oxt	㢕
onl	㢞
hpv	㢟
xmh	㢫
xlr	㢴
xmq	㢷
xum	㢼
tdy	㣕
vnu	㣽
nyt	㤃
nrc	㤆
nes	㥒
nbk	㥛
nle	㥜
eav	㥯
nrx	㦡
nlx	㦬
rvt	㧅
rxn	㧈
rxm	㨥
lrr	㨻
jst	㪙
ygj	㪯
jxb	㫐
jet	㫑
jbf	㫗
jkq	㫛
jbh	㫞
jwk	㫟
jrm	㫼
jim	㫾
jwi	㬰
eqv	㬹
sbt	㭁
siy	㭂
snf	㭄
scq	㭇
asu	㭉
slf	㭗
sqm	㭥
sle	㭷
sim	㭻
sij	㭼
stv	㮃
scl	㮭
seh	㮴
xsd	㯋
sxk	㯞
mqw	㰞
hsk	㱒
pqw	㱽
iwn	㲹
piu	㲾
iot	㲿
iay	㳀
ilh	㳌
iln	㴓
isv	㴗
ijb	㵊
ilm	㵋
ibx	㶌
iuc	㶒
woi	㶡
ovb	㶢
oxe	㶭
oqj	㶷
oct	㶼
ofp	㶿
oef	㷐
omt	㷨
otv	㸅
obb	㸎
ejf	㸓
tcn	㸭
tmy	㸽
gcy	㺨
ghy	㺪
gdu	㺯
gvo	㻏
gbc	㻓
glv	㻲
gtv	㻶
glq	㻿
gvl	㼃
glx	㼈
evr	㼏
let	㽖
lwy	㽗
lcq	㽙
een	㽰
ufd	㽵
unv	㽶
urc	㽹
ubm	㽾
uhd	㾇
uvk	㾒
urh	㾷
rcu	㿝
hcv	㿪
qhd	䀏
het	䀐
hvy	䀓
hxh	䀕
htd	䀢
hdg	䀦
htk	䀩
htx	䀲
hyv	䀶
hfu	䁄
hle	䁌
hsv	䁏
ham	䁐
hrb	䁓
her	䁘
hjp	䁙
hrq	䁛
hji	䁜
hyu	䁤
hqo	䁩
hul	䁬
hlm	䁲
hyl	䁴
hry	䁶
hnk	䁹
hrx	䁻
hel	䂃
dxn	䂗
dbh	䂙
day	䂝
djs	䂺
tbh	䄦
tbt	䄧
stu	䅇
unn	䇃
uay	䇅
uvi	䇐
tau	䇝
tdf	䇢
tsf	䇴
tkc	䇼
tyf	䇾
tbv	䈨
ttm	䉛
oqk	䊅
eou	䊆
oim	䊑
ome	䊘
ors	䊛
oos	䊳
xvn	䊵
xhg	䊼
xsy	䊾
xoy	䋛
xnd	䋧
xqg	䋮
xto	䋺
xsv	䌁
xrq	䌆
xnk	䌟
xbb	䌰
xes	䌽
lfj	䍐
lsu	䍒
lou	䍘
lld	䍛
lrb	䍟
ngf	䍿
dng	䎁
nij	䎓
div	䎩
tob	䎹
brm	䎺
bvi	䎼
wef	䏌
cef	䏍
exh	䏖
ern	䏗
eaq	䏘
eqq	䏧
ebg	䏪
eux	䏲
eie	䏴
eds	䐀
elt	䐃
evl	䐉
ejx	䐊
evc	䐚
eim	䐝
exu	䐞
enk	䑀
eal	䑅
erx	䑈
atu	䒘
axn	䒛
ayf	䓂
afo	䓇
abl	䓝
ahj	䓬
acl	䓿
aco	䔍
ajm	䖁
tju	䖝
jjy	䖵
juo	䗒
jos	䗫
jxf	䗰
sdu	䙲
hqf	䙷
pxh	䙾
ybt	䚮
yxn	䚰
yiy	䚱
yet	䚲
qyf	䚻
yrc	䛀
yqb	䛄
ylh	䛅
ymg	䛆
yoh	䛸
yhp	䜜
esy	䝗
eia	䝣
myx	䝮
mtb	䝯
mpq	䝹
mim	䞆
mjj	䞎
lwn	䡄
llh	䡛
lad	䡳
lue	䡵
lal	䡸
lth	䡻
lha	䡾
leg	䢁
bpd	䢊
mpi	䢙
wbh	䢳
vlb	䣎
qwa	䤦
qlk	䤧
qfo	䤲
qbi	䤴
qpo	䤹
qcl	䥁
pjj	䥌
xcj	䥒
qum	䥕
qlc	䥯
qpe	䥱
urk	䦐
bvk	䧂
blg	䧃
bye	䧇
bsg	䧈
bke	䧎
bov	䧜
fnf	䨒
ohd	䨾
kvw	䬭
xju	䭫
xjv	䭬
mek	䯣
liw	䳴
hbm	䶡
hbh	䶥
