aaa	工艺
aab	工薪阶层
aad	匞
aaf	甙
aag	工整
aah	工具
aai	工艺流程
aaj	蒸蒸日上
aak	工艺品
aam	蘳
aan	草草收场
aao	工序
aap	切切实实
aaq	匿名
aar	熙熙攘攘
aas	工棚
aat	工程
aau	蕴藏着
aav	苆
aaw	工人
aax	花花绿绿
aay	工商
abb	2
abc	菆
abd	䔺
abe	蘟
abf	芓
abh	卭
abi	荪
abj	节日
abk	莻
abm	䔜
abn	蒸发
abp	2
abr	菰
abs	2
abt	㲨
abu	节前
abw	节余
aby	节育
aca	茅草
acb	节能降耗
acc	蔘
acg	戎马一生
ach	2
aci	七台河
acj	2
ack	葈
acm	2
acn	蓣
acp	2
acr	2
acs	2
act	英勇行为
acu	英勇善战
acv	2
acx	2
ada	巨大贡献
adb	期限
adc	茇
add	基础研究
ade	葫
adf	萘
adg	甚至
adh	茬
adi	藕
adj	巨大影响
adk	惹
adm	蒇
adn	基层
ado	甚广
adp	其实
adq	茂名
adr	勘探
ads	勘查
adt	基础科学
adu	蕨
adv	基础建设
adw	其
adx	茏
ady	基础设施
aea	功劳
aeb	莩
aec	萉
aed	雅加达
aee	蒯
aef	菜地
aeg	散开
aeh	落脚点
aei	散漫
aej	﨟
aek	功勋
aem	虋
aen	散居
aep	苏军
aeq	萖
aer	艻
aes	芝加哥
aet	㣉
aeu	菜单
aew	萸
aex	蒵
aey	苏州
afa	东城区
afb	敬老院
afc	芰
afd	薷
afe	贡献力量
aff	葑
afg	莫过于
afh	蒖
afi	劳动法
afj	或者是
afk	薣
afl	七十四
afm	区域网
afn	蓬勃发展
afo	䕋
afp	劳动密集型
afq	芫
afr	蓬勃的
afs	劳动模范
aft	蓍
afu	某部
afv	七十九
afw	菱
afx	劳动强度
afy	黄土高原
aga	莱芜
agb	芚
agc	菿
agd	七大
age	菁
agf	七十
agg	七万
agh	蔫
agi	莍
agj	苹果
agk	荳
agl	共青团中央
agm	颟
agn	匚
ago	区政府
agp	葬礼
agq	薤
agr	匪夷所思
ags	莱西
agt	董事长
agu	荚
agv	巧妙
agw	巧合
agx	䓯
agy	荆州
aha	卧式
ahb	2
ahc	2
ahd	匪
ahe	2
ahf	苜
ahg	邪恶
ahh	欺上瞒下
ahk	㐄
ahl	蓾
ahm	2
ahn	臣
aho	蔝
ahp	雅安
ahq	萈
ahs	2
aht	雅
ahu	2
ahv	2
ahw	藈
ahx	䓱
ahy	某些方面
aia	蕖
aib	医学院
aic	落汤鸡
aid	荣誉感
aie	薄膜
aif	落地
aig	萍
aih	落点
aii	莎
aij	节省时间
aik	落叶
ail	范围
aim	落网
ain	荧光屏
aio	藻类
aip	东宁
aiq	茫然
air	落后
ais	东西
ait	藩
aiu	䒕
aiv	葏
aiw	范例
aix	东经
aiy	蒗
aja	草药
ajb	划出
ajc	2
ajd	幕
ajf	䒤
ajg	䕎
ajh	㓚
ajj	昔日
ajk	2
ajl	蓝图
ajm	䘍
ajn	草书
ajp	划定
ajq	鹊
ajr	划拨
ajs	蓝本
ajt	蔓延
aju	斯里兰卡
ajv	莫如
ajw	募集
ajx	䒶
ajy	草率
akb	蕺
akc	共患难
akd	戓
ake	莒县
akf	勒
akg	或
akh	蒉
aki	勤学
akj	勒紧
akk	萼
akm	鞍山
akq	勤勉
akt	鞭策
aku	革新
akv	2
akw	勤俭
akx	2
aky	燕京
ala	莲花
alb	匣子
alc	藣
ald	茵
ale	莮
alf	薯
alg	世界政治多极化
alh	世界眼光
ali	世界潮流
alj	世界时
alk	茴
all	藟
alm	蕒
aln	世界性
alo	2
alp	甍
alq	鹋
alr	世界舞台
als	世界杯赛
alt	世界各国
alu	苗头
alw	世界人口
alx	世界纪录
aly	苗族
ama	共同基金
amc	黄骅
amd	英雄
ame	䕧
amf	苒
amg	黄豆
amh	萜
ami	黄海
amj	英明
amk	贡品
aml	黄连
amm	花岗岩
amn	英尺
amo	2
amp	共同完成
amq	黄金
amr	共同提高
ams	英杰
amt	黄牛
amu	共同关心的
amv	英灵
amw	芮
amx	共同纲领
amy	英语
ana	蔬菜
anb	芑
anc	2
and	巨大
ane	2
anf	基层干部
ang	世事
anh	葭
ani	恐怖活动
anj	螶
ank	巨响
anl	巨轮
anm	巨幅
ann	恐惧心理
ano	2
anp	世家
anq	世贸
anr	2
ans	枼
ant	恐怖行动
anu	荬
anv	基层建设
anw	巨人
anx	基层组织
any	荩
aoa	工业基地
aob	2
aoc	2
aod	卧床不起
aof	鞭炮声
aog	䕺
aoj	蔊
aok	工业品
aol	工业园
aom	2
aon	蔍
aoo	工业废水
aop	营业室
aoq	䓎
aor	营业所
aos	蘼
aot	营业税
aou	苂
aov	蒌
aow	工业企业
aox	藕断丝连
aoy	䕲
apa	劳工
apb	荥阳
apc	莫之能御
apd	蒙古
ape	切实加强
apf	莞
apg	萱
api	荣誉
apj	荣昌
apk	营口
apl	劳累
apm	攻守同盟
apn	荧屏
apo	营业
apq	蓥
apr	工农兵
aps	切实可行
apt	营造
apu	营养
apv	工农群众
apw	蓿
apy	䔃
aqa	葡萄
aqb	获取
aqd	慕名而来
aqe	获胜
aqf	敬献
aqg	蓟
aqi	敬酒
aqj	黄金时间
aqk	警
aql	敬畏
aqm	花名册
aqn	警惕
aqo	敬业
aqp	警官
aqq	警句
aqr	萄
aqs	警醒
aqt	莸
aqu	获奖
aqv	兂
aqw	基金会
aqx	世贸组织
aqy	茑
ara	区划
arc	苽
ard	落后面貌
are	蘤
arf	区域
arg	欧亚
arh	䕫
ari	茱
arj	欧盟
ark	区别
arl	蘀
arm	菗
arn	区属
aro	2
arp	菦
arq	蔸
arr	殴打
ars	东拉西扯
art	区委
aru	欧美
arv	萔
arw	区分
arx	2
asa	基本功
asc	黄梅戏
asd	基本原理
asf	基本规律
asg	蘸
ash	基本上
asi	花样滑冰
asj	蕈
ask	基本路线
asl	基本国策
asn	艺术性
asp	基本实现
asr	基本的
ass	基本权利
ast	基本知识
asu	基本问题
asv	基本建设投资
asw	艺术创作
asx	基本纲领
asy	苛刻
ata	医药
atb	医院
atd	蓬
ate	蒩
atf	莛
atg	尧
ath	鸦片战争
ati	共和党
atj	工程师
atk	勤务员
atl	共和国
atm	薁
atn	医书
ato	萩
atp	攻守
atq	蘅
atr	工程技术人员
ats	戒备森严
att	切身利益
atu	䒩
atv	工程建设
atw	医务人员
atx	莓
aty	攻读
aua	菩萨
aub	医疗卫生
auc	革新能手
aud	茁壮成长
aue	葥
auf	菛
aug	颐养天年
aui	共产党
auj	萻
auk	营养品
aul	东道国
aum	欧美同学会
aun	工资改革
auo	2
auq	蒋
aur	工资制
aus	藽
aut	工资待遇
auu	工资总额
auv	菨
auw	医疗保险
aux	劳资纠纷
auy	东道主
ava	若即若离
avb	切除
avc	莭
avd	薅
ave	萧县
avg	茟
avh	2
avi	甘肃省
avj	2
avk	苕
avo	䔥
avp	切割
avs	2
avt	㓛
avu	2
avv	葌
avw	切分
avx	2
avy	切记
awa	荷花
awb	芁
awc	芟
awd	共有
awe	共用
awf	荟
awg	荃
awh	工作上
awi	工作汇报
awj	工作量
awk	茶叶
awl	花园
awm	工作岗位
awn	巷
awo	革命精神
awp	革命家
awq	花钱
awr	共振
aws	荷
awt	花生
awu	䒔
awv	共建
aww	觋
awx	工作组
awy	巩
axa	蕴藏
axb	葞
axc	苰
axd	䔛
axe	节约用水
axf	苏维埃
axg	薄弱环节
axh	䒡
axi	药水
axj	茀
axk	世纪中叶
axl	2
axo	节约粮食
axq	蕝
axr	2
axs	东张西望
axt	药物
axu	蒻
axv	2
axw	蒶
axx	芘
axy	药方
aya	荒芜
ayd	B
aye	䒾
ayf	荒地
ayi	a
ayj	荠
ayk	蒿
ayl	工商界人士
aym	貣
ayn	芦
ayo	荒唐
ayp	芳容
ayq	工商银行
ayr	蓠
ayt	工商管理
ayu	芠
ayv	蓈
ayw	茭
ayx	蕹
ayy	荒诞
baa	防范工作
bac	2
bad	陿
bae	2
baf	陈规
bag	职工再就业
bak	䧕
bal	2
bam	2
ban	聚苯乙烯
bao	取其精华去其糟粕
bap	限期完成
baq	2
bar	陈年
bau	2
bav	2
baw	职工代表大会
bax	2
bay	除草剂
bbb	子孙
bbd	防卫厅
bbe	2
bbg	聑
bbh	耳聪目明
bbi	2
bbj	2
bbk	2
bbl	2
bbo	2
bbp	孤陋寡闻
bbr	孙子兵法
bbs	2
bbt	孺子牛
bbv	孕妇
bbw	随随便便
bbx	隐隐约约
bby	子夜
bca	聂荣
bcb	郰
bcc	颞
bcd	2
bce	取用
bcf	盈亏
bcg	2
bci	夃
bcj	联欢晚会
bcl	戤
bcm	2
bcn	取悦
bco	㷅
bcp	2
bcq	陈巴尔虎旗
bcr	2
bcs	取材
bct	盈利
bcu	聚首
bcw	聚集
bcx	取经
bcy	聚变
bda	隳
bdb	阳奉阴违
bdc	䧀
bdd	承袭
bde	堕
bdf	了不起
bdg	联成一体
bdi	随大流
bdj	随时
bdl	2
bdm	聏
bdn	2
bdo	2
bdr	随后
bds	随想
bdt	承德
bdu	随意
bdv	承建
bdw	也不例外
bdy	承认
bea	檃
bed	阴历
bee	承受力
bef	阴云
beg	䎳
beh	䏂
bej	阴暗
bek	2
bel	2
bem	2
ben	2
beo	2
ber	阻挡
bes	阴森
bet	附加条件
beu	阴道
bev	䧌
bfa	隫
bfb	随声附和
bfc	阹
bfd	隔墙有耳
bff	孤零零
bfg	2
bfh	䦹
bfj	降雨量
bfk	㝆
bfl	聴
bfo	2
bfp	2
bfq	％
bfr	2
bfs	2
bfu	2
bfw	承运人
bfx	2
bgb	出现了
bgc	2
bgd	孒
bge	隔膜
bgf	║
bgh	耳目
bgi	耳光
bgj	卫冕
bgk	陆路
bgm	降下帷幕
bgn	隔壁
bgp	陈列室
bgq	隞
bgr	卫兵
bgs	耳机
bgt	除恶务尽
bgu	陕北
bgv	2
bgw	陷于停顿
bgx	隔绝
bgy	队列训练
bha	䖎
bhc	陈旧观念
bhd	除此而外
bhe	2
bhf	2
bhg	蚩
bhh	骘
bhi	2
bhj	2
bhk	阽
bhl	2
bhm	2
bhn	除此以外
bho	2
bhq	䧋
bhr	2
bhs	2
bht	2
bhu	2
bhv	2
bhx	2
bia	2
bib	孙子
bid	函大
bif	防波堤
big	卺
bij	降水量
bil	2
bin	2
bio	2
bip	陆海空三军
bis	2
bix	2
biy	阥
bjb	.
bjc	阳台
bjd	阳春
bje	2
bjf	聪明才智
bjh	䎶
bji	阳江
bjj	2
bjk	)
bjl	2
bjo	2
bjs	2
bjt	2
bju	及时总结经验
bjw	聪明人
bjx	䏉
bjy	也是为了
bka	陨落
bkc	职能
bkd	出口成章
bkg	防患于未然
bkh	隤
bki	2
bkj	陨星
bkl	出口转内销
bkm	孙中山
bkn	2
bkp	职守
bkr	2
bkt	职称
bkv	2
bkw	出口创汇
bkx	2
bky	出口商
blc	2
bld	2
ble	阵脚
blf	盁
blg	隈
blj	2
blk	2
bll	2
blm	2
bln	2
blo	2
blq	2
bls	2
blt	2
blv	2
bly	出国访问
bma	出工
bmb	䢺
bmc	出马
bmd	出面
bme	出力
bmf	聃
bmg	出现
bmh	䖓
bmi	出没
bmj	出题
bmk	出口
bml	出车
bmm	孾
bmn	出书
bmo	出席
bmp	出神
bmq	出错
bmr	出兵
bms	2
bmt	出生
bmu	出差
bmw	出任
bmx	出纳
bmy	聘请
bna	2
bnb	孔隙
bnc	2
bnd	2
bne	2
bnf	阠
bng	了事
bnh	卩
bni	孔洞
bnj	乃是
bnm	2
bnn	巜
bno	孔府
bnp	2
bnt	也行
bnu	也门
bnw	䦼
bny	了望
bob	出席了会议
boc	2
bod	䧪
boe	2
bof	职业教育
bog	䧤
boh	2
boj	2
bok	2
bom	2
bon	2
boo	㷦
boq	隣
bor	出类拔萃
bos	2
bot	2
bou	职业病
bov	䧡
bow	联席会议
box	2
boy	阦
bpa	辽东
bpb	辽阳
bpc	2
bpd	随之而来
bpf	院士
bpg	聢
bph	2
bpi	阿富汗
bpj	䏃
bpk	陪审员
bpl	2
bpm	2
bpn	2
bpo	2
bpp	孤家寡人
bpr	阿塞拜疆
bps	院校
bpt	出神入化
bpu	䏁
bpv	2
bpw	聜
bpy	院方
bqa	隐蔽
bqb	阿尔及利亚
bqd	陒
bqf	承包者
bqg	聊天
bqh	陥
bqj	2
bqk	陶器
bql	2
bqm	2
bqn	了解情况
bqo	䧰
bqp	出色完成
bqq	㚉
bqr	承包制
bqt	陷入
bqu	陶冶
bqw	承包人
bqx	隐约
bqy	出外谋生
bra	2
brb	2
brc	阪
brd	出手不凡
bre	2
brf	附近地区
brg	承担责任
brh	2
bri	函授学校
brj	2
brk	2
brl	2
bro	2
brp	孤寂
brq	孤儿
brr	㝂
brs	聚氨酯
brt	聛
bru	孤单
brv	2
brw	孤僻
brx	2
bsb	2
bsc	2
bsd	2
bse	2
bsf	䏇
bsh	䦺
bsj	刴
bsk	娿
bsl	▂
bsm	2
bsn	2
bsp	2
bsq	2
bsr	2
bss	2
bsv	阿妈
bsw	䧒
bsx	2
bsy	2
bta	降落
btb	卫生防疫
btd	卫生厅
bte	2
btf	阡
btg	降到
bth	联系点
bti	隆重举行
btj	降临
btk	卫生员
btl	陷入困境
btm	隩
btn	卫生局
bto	隆重庆祝
btp	取长补短
btr	隆重推出
bts	隐私权
btt	出版物
btu	卫生间
btw	降价
btx	卫生组织
bty	出版商
bua	聠
bub	联防
bud	联邦
bue	附着力
buf	孤立地
bug	䧧
bui	承兑汇票
buj	联盟
buk	陪
bul	2
bum	陪同
bun	联展
bup	联袂
bur	联手
bus	联机
but	隡
buu	防疫站
buv	隒
buw	联合
bux	联结
buy	承前启后
bvb	2
bvc	2
bvd	2
bvj	限时
bvl	2
bvm	2
bvn	2
bvp	限定
bvq	2
bvr	了如指掌
bvs	2
bvt	2
bvv	2
bvx	2
bvy	2
bwa	除草
bwb	降低了
bwc	聬
bwd	队友
bwe	坠毁
bwf	坠
bwg	险
bwh	险些
bwi	除尘
bwj	联合早报
bwk	聆听
bwl	联合国秘书长
bwm	附则
bwn	附属
bwq	除夕
bwr	联合制
bws	险要
bwt	聚合物
bwu	出人意料地
bwv	聁
bww	队伍
bwx	联合组织
bwy	聆
bxb	2
bxg	墬
bxh	2
bxi	联络小组
bxj	2
bxk	出纳员
bxl	2
bxm	2
bxo	2
bxq	2
bxr	2
bxu	阶级立场
bxv	2
bxw	2
bxx	聨
bxy	2
bya	防范
byb	防卫
byd	阿谀奉承
byf	防城
byg	及至
byi	孓
byj	也就是
byk	䧐
byl	2
bym	2
byn	陔
byo	防腐
byp	防空
byr	孩提
byt	防御
byu	防盗
byv	2
byw	防风
byx	防弹
byy	﨤
caa	巴基斯坦
cab	2
cac	2
cad	艰苦奋斗
caf	2
cah	预期目标
caj	刭
cak	2
cal	2
cam	马鞍山
can	艰巨性
cao	劲爆
caq	2
car	预期指标
cas	艰苦朴素
cau	颈部
caw	鴘
cax	2
cay	巯
cbb	2
cbc	2
cbd	2
cbe	2
cbf	2
cbi	2
cbk	2
cbl	2
cbm	2
cbn	2
cbo	2
cbp	2
cbq	2
cbr	2
cbs	2
cbu	2
cbv	2
cbx	2
cby	邓州
cca	2
ccb	艰难险阻
ccc	桑
ccd	熊熊大火
cce	叠加
ccf	双喜
cch	双眼
cci	参观游览
cck	2
ccl	参观团
ccm	双峰
ccn	参观展览
cco	双料
ccr	双拥
ccs	难能可贵
cct	双重
ccu	㕛
ccx	2
ccy	厸
cda	2
cdc	能不能
cdd	鸡犬不宁
cde	毵
cdf	对不起
cdg	参政
cdi	骄奢淫逸
cdj	参量
cdk	2
cdl	马克思主义
cdm	貵
cdn	双丰收
cdp	参军
cdq	2
cdr	参看
cds	2
cdu	参差
cdv	2
cdw	对不住
cdx	2
cdy	参议
ceb	参加了会见
cec	2
ced	能耗
cee	通用
cef	通过
ceg	通天
ceh	勇
cei	通常
cej	通电
cek	通史
cem	通邮
cen	通用性
ceo	2
ceq	熊猫
cer	勇气
ces	2
cet	通知
ceu	双边关系
cev	2
cew	通风
cex	熊
cey	能为
cfb	对联
cfc	双增双节
cfd	頚
cfe	2
cff	圣地
cfg	对开
cfh	圣战
cfi	通过学习
cfj	通过鉴定
cfk	对口
cfl	2
cfm	对峙
cfn	参考书
cfo	对数
cfq	对外
cfr	对抗
cft	对待
cfu	预示着
cfv	2
cfw	对华
cfx	圣经
cfy	对话
cga	骁
cgb	驰
cgc	骏
cgd	骑
cge	马力
cgf	驻地
cgg	驱逐
cgh	马虎
cgj	马里
cgk	驯
cgl	驷
cgm	马山
cgn	验收
cgo	2
cgp	驻军
cgq	骝
cgr	勇于探索
cgs	马来西亚
cgt	骆
cgu	骈
cgv	骕
cgw	驸
cgx	2
cgy	驻
cha	2
chb	2
chc	台上台下
chd	2
chf	2
chg	2
chh	2
chi	2
chj	2
chk	2
chl	2
chm	2
chn	2
cho	2
chp	2
chs	2
cht	2
chu	2
chv	2
chw	2
chx	2
chy	2
cib	2
cic	2
cid	2
cie	2
cif	台海地区
cig	邓小平理论
cih	2
cii	台湾省
cik	2
cil	2
cim	台湾同胞联谊会
cin	台湾民主自治同盟
cio	2
cip	2
cit	2
ciu	台湾问题
ciw	观赏价值
cix	2
ciy	2
cja	2
cjb	2
cjc	2
cjd	2
cje	2
cjg	2
cjh	2
cji	2
cjj	2
cjk	2
cjl	2
cjm	2
cjn	2
cjo	2
cjq	2
cjr	2
cju	2
cjv	2
cjw	2
cjx	2
cjy	2
cka	2
ckb	台阶
ckc	2
ckd	2
cke	㣍
ckf	欢呼声
ckg	台球
cki	台港
ckj	刣
ckl	2
ckn	怠慢
cko	台灯
ckp	台安
ckq	鸡鸣狗盗
ckr	2
cks	䢄
ckt	对号入座
cku	台前
ckv	2
cky	台州
cla	2
clb	2
clc	2
cld	2
cle	2
clf	2
clg	2
cli	2
clj	2
clk	2
cll	2
cln	2
clo	2
clp	2
clq	2
cls	2
clt	2
clv	2
clw	2
clx	2
cly	2
cma	2
cmb	2
cmc	2
cme	2
cmf	2
cmg	2
cmh	观战
cmi	观赏
cmk	2
cml	2
cmm	2
cmo	能见度
cmp	观礼
cmr	观后
cms	2
cmt	2
cmu	贠
cmv	2
cmw	观众
cmx	2
cna	难民营
cnc	难以预料
cnd	难以达到
cne	2
cnf	柔韧
cnh	巴
cni	巴掌
cnj	2
cnk	柔顺
cnl	难以置信
cnm	预购
cnn	戏剧性
cnp	预赛
cnq	难以解决
cnr	预报
cns	难以想象
cnt	巴黎
cnu	矛头
cnw	预售
cnx	双层经营
cny	
coa	駆
cob	駬
coc	騃
cod	駄
coe	騱
cof	馯
cog	駍
coh	騑
coi	駫
coj	駻
cok	駽
col	騦
com	駎
con	駅
coo	驎
cop	馾
coq	駠
cor	駈
cos	騕
cot	駇
cou	騂
cov	駸
cow	颿
cox	2
coy	馿
cpa	2
cpb	2
cph	2
cpi	2
cpj	2
cpl	2
cpm	2
cpn	2
cpo	2
cpq	2
cps	2
cpv	2
cpw	2
cpx	2
cpy	2
cqb	欢聚
cqc	欢迎参加
cqd	对外友好协会
cqf	骤然增多
cqg	对外政策
cqh	2
cqj	2
cqk	驰名中外
cql	2
cqm	2
cqn	欢快
cqo	欢度
cqq	对外贸易
cqr	对外投资
cqt	欢笑
cqu	欢送
cqv	2
cqw	欢迎仪式
cqx	对外经贸
cqy	允许
cra	2
crc	2
crd	2
crf	巴拉圭
crg	2
crh	2
crj	2
crk	2
crl	2
crm	2
crn	通报情况
cro	2
crq	2
crs	马拉松比赛
cru	2
crv	2
crw	2
crx	2
cry	2
csa	2
csb	2
csc	2
csd	巴林左旗
cse	2
csf	2
csg	2
csh	2
csi	2
csj	2
csk	2
csl	2
csm	2
csn	2
cso	2
csp	2
csq	2
csr	2
csv	2
csw	2
csx	2
cta	鸡毛蒜皮
ctb	预备队
ctc	2
ctd	欸
cte	2
ctf	勇往直前
ctg	预处理
cth	2
ctj	2
ctk	2
ctm	预算内资金
ctp	预算审查
ctq	预算外
cts	2
ctt	双向选择
ctu	对敌斗争
ctw	预备会议
ctx	对牛弹琴
cty	双管齐下
cub	2
cuc	2
cud	对立面
cue	2
cuf	2
cug	勇斗歹徒
cuh	2
cuj	2
cuk	2
cul	2
cum	2
cun	2
cuo	2
cup	2
cuq	2
cur	2
cus	2
cut	2
cuu	2
cuv	2
cva	艰巨
cvd	2
cvf	2
cvg	2
cvh	2
cvi	2
cvj	2
cvk	2
cvl	2
cvm	2
cvn	2
cvo	2
cvp	2
cvq	2
cvr	2
cvs	2
cvt	2
cvv	2
cvw	2
cvx	2
cvy	2
cwb	通信联络
cwc	难舍难分
cwd	驻华大使馆
cwe	难受
cwf	通信地址
cwg	难事
cwi	桑拿浴
cwj	双休日
cwk	骇人听闻
cwl	2
cwn	难民
cwo	对人类
cwq	难解
cwr	难找
cws	2
cwt	皴
cwu	难关
cwv	难寻
cww	驻华使节
cwy	难忘
cxa	2
cxb	2
cxd	2
cxe	2
cxf	2
cxg	2
cxh	2
cxi	2
cxj	2
cxk	2
cxl	2
cxm	2
cxn	2
cxp	2
cxq	2
cxr	2
cxs	2
cxt	2
cxu	2
cxv	2
cxx	2
cxy	2
cya	通州区
cyb	通讯卫星
cyd	双方愿意
cye	2
cyh	2
cyk	参议员
cyo	2
cyp	难言之隐
cyq	2
cys	对话机制
cyt	通讯系统
cyu	参谋部
cyy	双方商定
daa	碊
dab	2
dad	左右
dae	面黄肌瘦
daf	不甘示弱
dah	在某些方面
dai	左派
daj	厝
dak	礶
dal	在世界范围内
dam	磺
dan	左翼
dap	成功之路
daq	百花争艳
dar	奁
das	左权
dat	有期徒刑
daw	在工作中
day	硭
dba	2
dbb	不了了之
dbc	原子能
dbd	有职有权
dbf	厄运
dbg	有限责任公司
dbh	顾虑
dbk	2
dbl	2
dbm	布隆迪
dbr	不出所料
dbs	有隙可乘
dbt	大队长
dbw	在职人员
dby	砐
dcd	雄厚
dce	髯
dcf	不能超过
dcg	面对现实
dch	䀾
dci	在通常情况下
dcj	2
dcl	不予置评
dcn	友情
dco	礟
dcp	不能容忍
dcq	镹
dcr	镻
dct	不能自拔
dcu	厷
dcv	友好
dcw	友人
dcx	2
dcy	不允许
dda	大区
ddb	大队
ddc	还不能
ddd	㕆
dde	大胆
ddf	大都
ddg	砳
ddh	大战
ddi	大小
ddj	大师
ddk	在历史上
ddl	大国
ddm	大幅
ddn	碱性
ddo	大业
ddp	大赛
ddq	大钱
ddr	大批
dds	大桥
ddt	大选
ddu	厦门
ddv	大好
ddw	大众
ddx	大红
ddy	夶
dea	布加勒斯特
deb	有限
dec	不受欢迎
ded	不胫而走
dee	硼
def	大力支持
deg	有助于
deh	有点
dei	历法
dej	历时
del	不服输
den	历届
deo	有底
dep	大胆实践
deq	有名
der	有的
des	有权
det	有利
deu	有着
dew	历任
dex	有线
dey	有望
dfa	三十七
dfb	夺取
dfc	砝
dfd	耕地面积
dfe	唇
dff	圶
dfg	三十五
dfh	不起眼
dfi	奔波
dfj	三元里
dfk	奔跑
dfl	三十四
dfn	砖
dfo	硳
dfp	有过之而无不及
dfr	压迫
dfs	不需要
dft	夺得
dfu	大声疾呼
dfv	不过如此
dfw	奢侈
dfx	夸张
dfy	大城市
dga	硎
dgb	达到了
dgc	三通
dgd	三百
dge	感受
dgf	三十
dgg	感到
dgh	达到目的
dgi	感觉
dgj	感冒
dgk	咸
dgl	三国
dgm	三峡
dgn	感慨
dgo	硬度
dgp	厂家
dgq	励
dgr	大型的
dgs	石棉
dgt	丆
dgu	硖
dgv	感召
dgw	石化
dgx	碡
dgy	感谢
dha	在世
dhb	℡
dhc	不能
dhd	砉
dhe	不用
dhf	不过
dhg	砋
dhh	不止
dhi	不少
dhj	还是
dhk	否
dhl	不图
dhm	在内
dhn	丰收
dho	不应
dhp	丰富
dhq	不够
dhr	不失
dhs	不可
dht	不得
dhu	不准
dhv	恝
dhw	不会
dhx	不经
dhy	不论
dia	耢
dib	石河子
dic	耗能
did	还没有
die	感染力
dif	耘
dig	石油天然气总公司
dih	龙潭虎穴
dii	耖
dij	耗电
dik	2
dil	石油输出国组织
dim	厰
din	有法必依
dio	耱
dip	不法之徒
diq	2
dir	大海捞针
dis	有法可依
dit	耗
diu	夵
diw	石油化工
dix	大学毕业
diy	砅
dja	春暖花开
djb	百出
djc	2
djd	不紧不慢
dje	奛
djf	厘
djg	百万
djh	矵
dji	在日常生活中
djj	百里
djk	2
djn	鹌
djo	厚度
djp	厚实
djq	百色
djr	面临的
djt	大量生产
dju	成果奖
djw	百货
djx	䃂
djy	百户
dkb	不足取
dkd	历史丰碑
dkf	夻
dkg	大中型
dkh	三足鼎立
dki	历史潮流
dkj	历史时期
dkk	历史唯心主义
dkl	成员国
dkm	石嘴山
dkn	历史性的
dko	2
dkp	百叶窗
dkq	2
dkr	右手
dks	历史档案
dkt	历史长河
dku	历史背景
dkv	2
dkw	历史使命
dkx	有口皆碑
dky	历史文化名城
dlb	大男子主义
dlc	不畏艰险
dld	春回大地
dlf	克罗地亚
dlh	奋战
dlj	2
dlk	㕅
dll	感恩图报
dlo	2
dlp	䃛
dlq	2
dlr	2
dls	不置可否
dlt	碅
dlv	2
dlw	㎏
dlx	不畏强暴
dly	2
dma	面世
dmb	面孔
dmc	而又
dmd	耐碱
dme	面貌
dmf	不同地区
dmg	不同于
dmh	原则上
dmi	大同小异
dmj	㞭
dmk	2
dml	面罩
dmm	不同见解
dmn	而已
dmo	不同类型
dmp	不同之处
dmq	面包
dmr	而后
dms	碋
dmt	面积
dmu	面前
dmw	布什
dmx	不见经传
dmy	面议
dna	成功
dnb	成了
dnc	不避艰险
dnd	成套
dne	感情用事
dnf	成才
dng	成型
dnh	碬
dni	成活
dnj	成果
dnk	成品
dnl	奋发图强
dnm	成册
dnn	不愉快
dno	2
dnp	成家
dnq	成名
dnr	成年
dns	有必要
dnt	盛行
dnu	成立
dnv	成群
dnw	成分
dnx	成
dny	成为
doa	矿工
dob	不断出现
dod	不断丰富
doe	磷肥
dof	不断增加
dog	不断开创
doh	2
doi	不断深化
dol	励精图治
don	不断改进
doo	矿床
doq	灰色
dor	不断扩大
dos	䃺
dot	矿物
dou	矿产
dow	百废俱兴
doy	不断变化
dpa	不定期
dpb	确定了
dpc	2
dpd	研究成果
dpe	有礼貌
dpf	故宫博物院
dpg	碇
dph	太空战
dpi	牵涉
dpj	确实是
dpk	研究员
dpl	不容置疑
dpm	2
dpn	面容憔悴
dpo	石家庄市
dpp	大灾之年
dpq	丰富多彩
dpr	丰富的经验
dps	研究机构
dpt	研究生
dpu	研究部署
dpv	2
dpw	研究会
dpx	牵引
dpy	破案率
dqa	磔
dqb	克隆
dqc	2
dqd	㕋
dqe	克服
dqf	有名无实
dqg	不负责任
dqh	大饱眼福
dqi	三角洲
dql	顾名思义
dqm	克山
dqn	不久以前
dqo	大多数人
dqp	确实
dqq	不锈钢
dqr	砍掉
dqs	2
dqt	不够重视
dqu	确立
dqw	确保
dqx	2
dqy	鸪
dra	原著
drb	原子
drc	㼋
drd	原有
drf	原地
drg	原来
drh	磃
dri	原
drj	大批量
drl	大兵团
drm	愿同
drn	有所改善
dro	原煤
drp	有所突破
drq	秦皇岛
drr	大势所趋
drs	在技术上
drt	原先
dru	原装
drv	磤
drw	大气候
dry	不失为
dsa	奇葩
dsb	不可限量
dsc	不可能
dsd	不可不
dse	不可胜数
dsf	不可动摇
dsg	克林顿
dsh	矴
dsi	在校学生
dsj	不要紧
dsk	奇
dsn	不可避免
dso	不可磨灭
dsq	不可多得
dsr	奇缺
dss	成本核算
dst	厅长
dsu	䂞
dsw	还本付息
dsx	不可终日
dsy	不要忘记
dta	面向世界
dtb	帮
dtc	2
dtd	在很大程度上
dte	有生力量
dtf	焘
dtg	故事
dth	成千上万
dti	寿光
dtj	故里
dtk	邫
dtl	不利因素
dtn	矿务局
dto	三季度
dtp	不稳定
dtq	厂长负责制
dtr	矿物质
dts	布告栏
dtt	古生物
dtu	三等奖
dtw	不符合
dtx	㥻
dty	面向市场
dua	歪门邪道
dub	劂
duc	2
dud	不准确
due	不着边际
duf	有关专家
dug	磋
duh	磁卡
dui	有关当局
duj	大问题
duk	矿产品
dul	有意思
dum	三部曲
dun	成立以来
duo	有关精神
dup	盛况空前
duq	辜负
dur	碰撞
dus	否决权
dut	有奖征文
duu	有关部门
duw	有关人士
dux	礠
duy	磋商
dva	2
dvd	有始有终
dve	硍
dvf	不好过
dvg	大好形势
dvh	2
dvi	三好学生
dvj	大好时光
dvk	2
dvl	䃳
dvm	2
dvn	2
dvo	友好精神
dvq	2
dvr	2
dvs	友好相处
dvt	友好条约
dvu	大刀阔斧
dvw	友好合作
dvx	成群结伙
dvy	在建设中
dwa	春节
dwb	不仅限于
dwc	奉劝
dwd	春耕
dwe	有偿服务
dwf	春运
dwg	奉
dwh	大体上
dwi	
dwj	蠢
dwk	古今中外
dwl	在全国范围内
dwm	秦岭
dwn	不会改变
dwo	百分数
dwp	百分之百
dwq	大伙儿
dwr	春播
dws	不仅可以
dwt	％
dwu	泰斗
dwv	耐人寻味
dww	赝
dwx	三八红旗手
dwy	矾
dxa	2
dxb	面红耳赤
dxc	2
dxd	大红大紫
dxe	2
dxf	寿比南山
dxg	龙王
dxh	成绩卓著
dxi	龙潭
dxj	有线电视
dxk	聋哑
dxm	龙岩
dxo	有线广播
dxq	2
dxr	龙泉
dxs	2
dxt	胡编乱造
dxu	龙门
dxw	龙凤
dxx	在组织上
dxy	砪
dya	原计划
dyb	太子
dyc	䃵
dyd	太原
dye	㕈
dyf	丈夫
dyg	䂴
dyi	丈
dyj	成效显著
dyk	丰衣足食
dyl	䃪
dym	2
dyn	碥
dyo	太康
dyp	有识之士
dyr	有效措施
dys	有效机制
dyt	尤为重要
dyu	碲
dyv	有话好说
dyw	磙
dyx	友谊比赛
dyy	在这方面
eaa	䏼
eac	爱莫能助
ead	臓
eae	腊月
eaf	毁坏
eag	毁灭
eaj	膜
eak	臙
eam	䐟
ean	䐑
eaq	䐭
ear	䝙
eat	2
eaw	臒
eax	2
eay	膵
eba	采取切实措施
ebc	鵩
ebd	采取不正当手段
ebe	月乃用舟家衣下
ebg	服刑
ebj	2
ebk	边防哨所
ebl	2
ebm	朏
ebn	肔
ebo	2
ebq	采取多种形式
ebr	服气
ebs	2
ebt	采取行动
ebu	边防部队
ebv	2
ebw	䳕
ebx	2
eby	䏜
ecb	2
ece	肥力
ecg	2
eci	肥水
eck	驾驶员
ecm	覶
ecn	腬
ecp	2
ecq	肥猪
ecs	2
ect	䏬
ecu	2
ecv	2
ecw	䝜
ecx	2
ecy	肞
edb	䐛
edc	胜不骄败不馁
edd	办不成
ede	腼腆
edf	悬而未决
edg	办不到
edh	夓
edi	2
edj	腌
edk	2
edl	2
edm	腼
edn	肬
edo	脄
edp	2
edq	䐒
edr	䝠
eds	䝝
edt	爱不释手
edu	膫
edw	朋友们
edy	胆大妄为
eea	脑力劳动
eeb	月出
eee	勰
eef	月刊
eeg	月球
eei	肝脑涂地
eej	2
eel	2
eep	肺腑之言
eeq	月色
eer	脱胎换骨
ees	䐆
eet	肜
eew	腴
eex	貕
eey	月夜
efb	脖子
efc	脚
efd	臑
efe	肝脏
eff	边境地区
efg	脚下
efh	豻
efi	脚注
efk	臌
efl	2
efn	
efp	用武之地
efq	脚印
efs	县直机关
eft	㲕
efu	肝癌
efw	肢体
egb	受到限制
egc	悬
egd	爰
ege	膊
egf	助教
egg	悬殊
egh	2
egi	助兴
egj	刞
egk	办事员
egl	2
egm	悬崖
egn	县属
ego	肺炎
egp	䢐
egq	用一句话来说
egr	悬挂
egs	䏞
egt	县委
egu	受到冲击
egv	脻
egw	悬念
egx	县级
egy	办事效率
eha	用工
ehb	2
ehc	遚
ehe	用脑
ehf	用场
ehg	用于
ehh	用餐
ehi	用法
ehj	用量
ehk	丯
ehm	2
ehn	用以
eho	用料
ehq	䏹
ehr	用兵
ehs	2
ehu	用意
ehv	2
ehw	用人
ehy	用计
eib	2
eic	2
eid	2
eif	2
eih	2
eii	2
eik	2
ein	胆小怕事
eio	2
eip	爱汉字就是爱祖国
eis	2
eit	䏚
eix	2
eiy	2
eja	2
eje	2
ejf	貋
ejg	䐎
ejh	胂
eji	胆小
ejj	用电量
ejl	胆略
ejo	2
ejq	2
ejr	2
ejt	胆管
eju	2
ejv	2
ejw	2
eka	加蓬
ekb	贺函
ekc	驾驶
ekd	加压
eke	加力
ekg	加速
ekh	加上
eki	加油
ekj	加盟
ekk	腭
ekl	驾车
ekm	脶
ekn	加以
ekp	加密
ekq	2
ekr	贺年
eks	哿
ekt	加重
eku	架次
ekw	加倍
ekx	加纳
eky	架设
elb	爱国阵线
elc	2
ele	舅舅
elf	爵士
elg	腘
elj	2
elk	2
ell	2
elm	2
eln	爱国心
elp	2
elq	臅
els	脾胃相投
elv	膢
elw	爱国侨胞
elx	边界线
ely	爱国主义
ema	爱岗敬业
emc	2
emd	腨
eme	2
emf	䏥
emg	胴
emi	2
emj	2
emm	䑍
emo	2
emr	2
ems	2
emt	2
emu	2
emw	觅食
emy	2
ena	2
enb	爱屋及乌
enc	2
end	胸怀大志
ene	2
enf	䏔
eng	甩开
enh	貑
eni	力学
enl	肠胃
enm	2
enn	肊
eno	䐖
enp	2
enq	加以解决
enr	甩掉
ens	鼠标
ent	月收入
enu	鼹
enw	加以分析
enx	䝚
eny	用心良苦
eoa	2
eob	2
eoc	2
eod	2
eoe	2
eog	2
eoh	2
eoi	2
eoj	2
eok	2
eol	2
eom	2
eon	臕
eop	2
eor	2
eos	2
eot	2
eou	臁
eow	毇
eox	2
eoy	脏话
epa	受苦
epb	受阻
epc	受骗
epd	迌
epe	脓
epf	脘
epg	受到
eph	2
epi	受潮
epj	2
epk	2
epl	边界
epn	爱情
epo	2
epp	受害
epq	舜
epr	受损
eps	2
ept	2
epu	边关
epv	爱好
epw	膣
epx	边疆
epy	受雇
eqb	䐢
eqc	脃
eqe	胸膛
eqf	2
eqh	㪒
eqj	彩色照片
eqk	胸中
eql	2
eqm	2
eqn	胸怀
eqo	边角料
eqr	脚镣手铐
eqs	2
eqt	2
equ	胸部
eqw	脍炙人口
eqy	肑
era	2
erc	力所能及
erd	脪
ere	肺气肿
erf	腯
erg	貃
erh	脌
eri	遥测
erj	2
erl	膴
erm	繇
ero	2
erp	2
erq	邈
err	脾气
ert	贺年片
erv	用兵如神
erw	力排众议
esa	2
esb	肠梗阻
esc	2
ese	采用
esf	彩云
esh	股票上市公司
esi	采光
esj	彩虹
esk	胢
esn	2
eso	彩灯
esq	腰包
esr	采掘
ess	用材林
est	2
esu	彩卷
esw	采集
esx	采编
esy	采访
eta	服务项目
etb	胜出
etd	胜利在望
ete	腹腔
etf	胜过
etg	服务于
eth	胙
eti	爱科学
etj	胜利果实
etk	貉
etl	膍
etm	䐿
etn	服务性
eto	膰
etp	胜利完成
etr	服务热线
ett	胜利
etu	腹部
etw	服务公司
etx	脢
ety	服务商
eua	脱节
eub	胖子
euc	2
eud	滕
eue	腹背受敌
euf	脱产干部
eug	䏠
euh	2
eui	脱产学习
euj	月产量
euk	脱口
eum	2
eup	腾空
euq	脱钩
eur	2
eus	2
eut	脱身
euw	爱立信
euy	滕州
eva	2
evb	2
evd	2
eve	貇
evf	爱好者
evg	腱
evh	2
evi	䐂
evj	2
evm	2
evo	2
evp	2
evq	2
evs	2
evv	2
evx	2
evy	肕
ewa	受人欺凌
ewb	2
ewc	䐋
ewd	Б
ewe	办公用品
ewf	受伤者
ewg	腧
ewh	脸上
ewi	臾
ewj	2
ewk	2
ewl	2
ewm	䝿
ewn	股民
ewp	办案
ewq	股金
ewr	办报
ews	股票
ewt	股长
ewu	脸部
ewv	朌
eww	办公
ewx	б
ewy	办公设备
exa	2
exc	2
exd	脱颖而出
exe	脸红脖子粗
exg	加强两岸
exi	乿
exj	加强监督
exm	2
exo	2
exq	2
exr	2
exs	加强检查督促
ext	加强和改进
exv	2
exw	加强领导
exx	豼
exy	加强交流
eyb	脑际
eyc	2
eyd	用词不当
eye	臃肿
eyf	用户协会
eyg	用户至上
eyh	2
eyj	舆论监督
eyk	脝
eyl	舆论界
eym	2
eyn	胲
eyq	脱离危险
eyr	脉搏
eys	2
eyt	胶片
eyu	膪
eyv	朖
eyw	腋
eyx	脉络
eyy	胶州
faa	二期工程
fab	2
fad	喜获丰收
fae	超期服役
faf	坩
fag	博茨瓦纳
fah	壏
faj	堰
fak	域
fam	墴
fan	地区性
fao	2
fap	规范字
faq	零花钱
far	南斯拉夫
fas	塔顶
fat	规范管理
fau	地区冲突
fav	2
faw	规范化
fax	规范经营
fay	示范户
fba	土耳其
fbc	2
fbd	地磁
fbe	地貌
fbf	地震
fbg	地下
fbh	地点
fbi	地温
fbj	南联盟
fbk	进出口
fbl	地界
fbn	地层
fbo	夫子庙
fbp	逇
fbq	地名
fbr	地热
fbs	无隙可乘
fbt	地利
fbu	地产
fbv	2
fbw	地段
fbx	壣
fby	地方
fca	动荡
fcb	埃及
fcc	劫难
fcd	却不
fce	劫
fcf	云南
fcg	运到
fch	走马上任
fci	支流
fcj	刦
fck	动听
fcl	运输
fcm	2
fcn	支书
fco	走马灯
fcp	才能实现
fcq	去留
fcr	支持
fcs	支配
fct	运行
fcu	支
fcv	刧
fcw	支付
fcx	支线
fcy	无能为力
fda	震荡
fdb	城防
fdc	老大难
fdd	十三大
fde	坜
fdf	雼
fdg	需求
fdh	坯
fdi	示威游行
fdj	城里
fdm	顸
fdn	震惊
fdp	志愿军
fdq	过不多久
fdr	震撼
fds	都不可能
fdt	坏处
fdu	地面站
fdv	城建
fdw	雷厉风行
fdx	城乡
fdy	坏话
feb	垺
fed	动脉硬化
fee	协助
fef	无边无际
feg	无助于
feq	堄
fer	霢
fes	动力机械
fet	㘦
feu	协办单位
fev	2
few	协会
fey	协调
ffa	款项
ffb	增进了解
ffc	地震预报
ffd	二十三
ffe	运动服
fff	亖
ffg	二十五
ffh	卦
ffi	云南省
ffj	零零星星
ffk	封口
ffl	二十四史
ffn	圬
ffo	寺庙
ffp	堵塞
ffq	南朝鲜
ffr	栽培技术
ffs	土木
fft	博士生
ffu	墙
ffv	二十九
ffw	二十八
ffx	鼃
ffy	二十六
fga	干警
fgb	坉
fgc	干预
fgd	十大
fge	埔
fgf	⒒
fgg	干
fgh	士
fgi	地下水
fgj	埂
fgk	十足
fgl	起死回生
fgm	二则
fgn	十一届三中全会以来
fgo	干燥
fgp	填平补齐
fgr	干扰
fgs	十杰
fgt	地球物理
fgu	干部
fgv	干好
fgw	十八
fgx	干线
fgy	雨衣
fha	武警
fhb	走出
fhc	直观
fhd	起码
fhe	武力
fhf	㱏
fhg	越
fhh	走上
fhi	武汉
fhj	真是
fhk	武器
fhl	赶回
fhm	考虑周到
fhn	起
fho	起床
fhp	真空
fhq	直销
fhr	直接
fhs	真相
fht	走向
fhu	趑
fhv	起始
fhw	颠
fhx	直线
fhy	走访
fia	霟
fib	未了
fic	远水难救近火
fid	未成
fie	霪
fif	远洋运输
fig	未来
fih	䙿
fii	无党派人士
fij	载誉归来
fik	干涉中国内政
fil	云游四方
fim	干涉内政
fin	教学改革
fio	2
fip	未完
fiq	未免
fir	未按
fis	真没想到
fit	违法行为
fiu	未曾
fiv	未婚
fiw	声泪俱下
fix	违法经营
fiy	未变
fja	教师节
fjb	进取
fjc	朝圣
fjd	坦克
fjf	韩
fjg	堤
fjh	刌
fji	井水
fjj	朝野
fjk	进口
fjl	韩国
fjm	堤岸
fjn	进展
fjo	霓虹灯
fjp	进军
fjq	朝鲜
fjr	朝气
fjt	进入
fju	埋头
fjv	刱
fjw	刊登
fjx	堒
fjy	坦诚
fkb	吉隆
fkc	鼓劲
fkd	鼓励
fke	喜爱
fkf	鼓动
fkg	露天
fkh	露
fki	鼓掌
fkj	吉日
fkk	鼓吹
fkl	无足轻重
fkm	埙
fkn	喜剧
fko	※
fkp	嘉宾
fkq	嘉鱼
fkr	喜看
fks	武器禁运
fkt	鼓乐
fku	喜
fkv	动员群众
fkw	喜人
fkx	武器弹药
fky	喜讯
fla	载荷
flb	2
flc	2
fld	十四大
flf	㿻
flg	卖国求荣
fli	顽固派
flj	运输量
flk	䨓
fll	靁
flm	运输网
fln	㥁
flp	无固定收入
flq	畞
flr	2
fls	2
flt	雷管
flu	戴罪立功
flw	载货
flx	运输线
fly	直辖市
fma	献艺
fmb	献出
fmd	南丰
fme	南县
fmf	坍塌
fmg	南亚
fmh	南非
fmi	南沙
fmk	2
fmm	南丹
fmn	貮
fmo	2
fmp	献礼
fmr	2
fmt	献血
fmu	南
fmv	2
fmw	南风
fmx	南疆
fmy	垻
fna	专著
fnb	㐋
fnd	志愿
fne	卖力
fnf	场地
fng	无异于
fnh	违
fni	违法
fnj	声明
fnk	专员
fnl	专车
fnm	志丹
fnn	圮
fnp	真心实意
fnq	违犯
fnr	场
fns	专机
fnt	专程
fnu	忈
fnv	亐
fnw	馨
fnx	专线
fny	专访
foa	䞑
fob	赧
foc	垿
fof	赭
fog	墣
foh	赪
foi	赤水
foj	赨
fok	2
fol	2
fom	䞒
fon	塶
foo	赯
fop	无米之炊
foq	赦免
for	专业技术人员
fos	2
fot	赦
fou	灻
fov	墉
fow	专业人员
foy	赤诚
fpa	过节
fpb	孛
fpc	2
fpd	过大
fpf	过去
fpg	懿
fpi	过渡
fpj	过量
fpk	迀
fpl	考察团
fpm	索贿
fpn	过快
fpo	过度
fpp	赤裸裸
fpq	过错
fpr	过年
fps	无家可归
fpt	过剩
fpu	过问
fpv	垵
fpw	悫
fpx	坨
fpy	南宁市
fqa	远东
fqb	圥
fqc	无能
fqd	均有
fqe	无须
fqf	坎坷
fqg	无毒
fqh	远非
fqi	远洋
fqj	元帅
fqk	堍
fql	无畏
fqm	远见
fqn	坞
fqo	无烟
fqp	无穷
fqq	均匀
fqr	远近
fqs	无机
fqt	均衡
fqu	无关
fqv	无妨
fqw	元件
fqx	无线
fqy	无效
fra	地质勘探
frb	支持了
frc	直接参与
frd	直接原因
fre	无所用心
frf	违反规定
frg	支持下
fri	声势浩大
frk	2
frl	十指连心
frn	地质局
fro	2
frp	亏损额
frr	趁热打铁
frs	十年树木
frt	支气管
fru	地热资源
frv	十年九不遇
frw	二氧化碳
frx	二年级
fry	无所谓
fsa	栽花
fsb	2
fsd	无可厚非
fse	2
fsf	栽培
fsg	酨
fsh	圢
fsi	需要注意
fsj	需要量
fsk	专横跋扈
fsm	2
fsn	2
fso	2
fsq	无可争辩
fsr	考核制度
fss	栽植
fst	二极管
fsu	超标准
fsv	老板娘
fsw	栽倒
fsx	规模经营
fsy	二板市场
fta	老区
ftb	孝
ftc	都能
ftd	考古
fte	耂
ftf	才干
ftg	增长速度
fth	考虑
fti	老汉
ftj	都
ftk	教员
ftl	进行国事访问
ftm	增长幅度
ftn	教科书
fto	献身精神
ftp	教室
ftq	老外
ftr	老年
fts	考核
ftt	考生
ftu	老总
ftv	堆积如山
ftw	老人
ftx	霉
fty	攼
fua	丧葬
fub	培养了
fuc	2
fud	二次大战
fue	增加
fuf	雴
fug	增至
fuh	老前辈
fui	南美洲
fuj	增量
fuk	裁判员
ful	啬
fum	增幅
fun	支部书记
fup	增补
fuq	境外
fur	规章制度
fus	专门机构
fut	增生
fuu	增产
fuv	干部群众
fuw	零部件
fux	博闻强记
fuy	培育
fvb	2
fvc	2
fve	南召县
fvf	真刀真枪
fvg	进退两难
fvi	雪水
fvj	2
fvk	2
fvm	雪崩
fvo	封建迷信活动
fvp	封建社会
fvq	2
fvr	封建制度
fvs	2
fvt	堖
fvu	封建意识
fvx	封建统治
fvy	喜怒哀乐
fwa	规划
fwb	均作了
fwc	规劝
fwd	零碎
fwe	截肢
fwf	逵
fwg	夫妻
fwh	零点
fwi	截流
fwj	零时
fwk	超凡品味
fwl	颠倒黑白
fwm	规则
fwn	堠
fwo	零度
fwp	老人家
fwq	专人负责
fwr	十几年来
fws	规模
fwt	十分重视
fwu	十分关心
fwv	十拿九稳
fww	替代
fwx	十分费解
fwy	堆
fxa	2
fxb	2
fxc	无比骄傲
fxd	动弹不得
fxf	无缘无故
fxi	增强活力
fxj	无线电厂
fxl	增强团结
fxn	无线局域网
fxo	2
fxp	城乡之间
fxq	2
fxt	二级简码
fxu	城乡差别
fxv	城乡建设
fxw	城乡人民
fxx	堦
fxy	盏
fya	培训工作
fyc	无言对答
fyd	直言不讳
fyf	城市规划
fyg	教育事业
fyh	超高频
fyi	教育学
fyj	霁
fyk	墩
fyl	地方国营
fyn	协调发展
fyp	裁军
fyq	协议金额
fyr	垴
fys	协调配合
fyt	城市管理
fyu	墒
fyv	无论如何
fyw	城市化
fyx	教育经费
fyy	南京市
gaa	开幕
gab	开除
gac	邢台
gad	形成
gae	开办
gaf	开封
gag	开来
gah	形式上
gai	刑法
gaj	型
gak	瑾
gal	开车
gam	璜
gan	开展
gao	开庭
gap	开赛
gaq	形象
gar	开拓
gas	开票
gat	开盘
gau	形状
gav	开垦
gaw	开创
gax	下世纪初
gay	开设
gbb	瑘
gbd	击破
gbf	2
gbg	㺭
gbh	2
gbj	顿时
gbl	2
gbm	击败
gbn	屯
gbo	2
gbp	一孔之见
gbq	2
gbr	2
gbs	2
gbu	2
gbv	屯垦
gbw	击剑
gby	2
gca	致敬
gcb	到职
gcc	2
gcd	互通有无
gce	㻆
gcf	到
gcg	到来
gch	至上
gci	一马当先
gcl	2
gcm	到岸
gcn	互通情报
gcp	到家
gcq	致欢迎词
gcs	到顶
gct	致辞
gcu	致病
gcv	2
gcw	致使
gcx	2
gcy	致词
gda	⑺
gdb	表达了
gdc	蚕桑
gdd	▲
gde	＠
gdf	环境
gdg	⑸
gdh	′
gdi	天津
gdj	天时
gdk	环路
gdl	◆
gdm	天山
gdn	正确性
gdo	天府
gdp	&
gdq	天色
gdr	」
gds	／
gdt	⑴
gdu	天门
gdv	⑼
gdw	天体
gdx	№
gdy	正确认识
gea	逐项
geb	逐出
gec	豝
ged	表达
gee	逐月
gef	表示
geg	玥
geh	敷
gei	逐渐
gej	静电
gek	青史
gel	开脱罪责
gem	青山
gen	表层
geo	下脚料
gep	靛
geq	青岛
ger	青年
ges	表述
get	副县长
geu	表彰
gev	豤
gew	静坐
gex	五彩缤纷
gey	瑶族
gfa	五十七
gfb	环境卫生
gfc	表示欢迎
gfd	玩耍
gfe	现场采访
gff	表示支持
gfg	万无一失
gfh	玩具
gfi	平均水平
gfj	一无是处
gfk	下坡路
gfl	迂回
gfn	表示慰问
gfo	一塌糊涂
gfp	柬埔寨
gfq	一块儿
gfr	平均年龄
gfs	2
gft	政协委员
gfu	表示关切
gfv	五十九
gfw	亚运会
gfy	五十六
gga	一切
ggb	表现出
ggc	一双
ggd	一百
gge	一边
ggf	一起
ggg	一天
ggh	一些
ggi	一流
ggj	一旦
ggk	一号
ggl	王国
ggm	一则
ggn	一致性
ggo	一度
ggp	刑事案件
ggq	五金
ggr	一批
ggs	一概
ggt	一般
ggu	一半
ggv	一如
ggw	一个
ggx	一级
ggy	一方
gha	璩
ghb	一辈子
ghc	下台
ghd	正在
ghe	下肢
ghf	政协
ghg	㺺
ghh	正点
ghi	政治
ghj	琸
ghk	丅
ghl	下车
ghm	下岗
ghn	忑
gho	正业
ghp	正视
ghq	下旬
ghr	逐步提高
ghs	下述
ght	政策
ghu	一些问题
ghv	正好
ghw	正值
ghx	政绩
ghy	下调
gia	政治工作
gib	列举了
gic	2
gid	琐碎
gie	求助
gif	正常运转
gig	政治素质
gih	政治目的
gii	救济
gij	求贤
gik	珠江口
gil	救国
gim	开学典礼
gin	政治局常委
gio	救济粮
gip	政治家
giq	救济金
gir	正常的
gis	正当权益
git	求得
giu	政治问题
giv	珰
giw	救人
gix	亚洲纪录
giy	求
gja	丣
gjc	更难
gjd	一日三餐
gjf	更无
gjg	理事
gjh	㺫
gji	更小
gjj	来电显示
gjk	理顺
gjl	㻴
gjm	理财
gjn	理性
gjo	更应
gjp	惠安
gjq	理解
gjr	更换
gjs	更要
gjt	理智
gju	理疗
gjv	更是如此
gjw	理化
gjx	五星红旗
gjy	理论
gkb	副职
gkc	吞吐能力
gkd	事故
gkf	带动
gkg	整顿
gkh	玔
gki	速
gkj	带电
gkk	噩
gkl	逼
gkm	翮
gkn	整改
gko	事业
gkp	事实
gkq	逗留
gkr	事后
gks	副本
gkt	事物
gku	逗
gkv	剚
gkw	整体
gkx	带给
gky	事迹
gla	2
glc	2
gld	开国大典
gle	2
glf	画坛
glg	一回事
gli	画法
glj	2
glk	一连串
gll	救国图强
glo	一团糟
glp	画家
gls	2
glt	副团长
glu	两国间
glw	画像
gly	正因为如此
gma	曹
gmb	两院
gmc	责难
gmd	现在
gme	两用
gmf	现场
gmg	再现
gmh	形同虚设
gmi	枣
gmj	现时
gmk	㺾
gml	两辆
gmm	璎
gmn	两翼
gmo	枣庄
gmp	瑞安
gmq	现象
gmr	两手
gms	″
gmt	再生
gmu	再次
gmv	刺刀
gmw	丙
gmx	刺绣
gmy	珼
gna	开发区
gnb	开展了
gnc	2
gnd	与否
gne	恶性膨胀
gnf	更快地发展
gng	珝
gnh	下情上达
gnj	致以最热烈的祝贺
gnl	2
gnn	玌
gno	2
gnp	恶性案件
gnr	整改措施
gns	2
gnt	副局长
gnu	开发部
gnw	开发公司
gnx	殖民统治
gny	开发商
goa	亚欧
gob	来函
goc	2
god	严厉
goe	严加
gof	晋城
gog	恶
goh	亚非
goi	灭
goj	来电
gok	灭火器
gom	严峻
gon	事业心
goo	灭火
gop	亚军
gor	严打
gos	严禁
got	严重
gou	事业单位
gov	严肃
gow	恶化
gox	晋级
goy	来访
gpa	2
gpc	天之骄子
gpd	迋
gpf	事实真相
gpg	逐字逐句
gph	琯
gpi	事实清楚
gpj	一窝蜂
gpk	2
gpl	璭
gpn	现实性
gpq	正襟危坐
gpr	瑸
gps	与之相比
gpt	一定程度
gpu	天安门广场
gpw	一定会
gpx	两审终审制
gpy	现实主义
gqa	殡葬
gqb	迈出
gqc	万能
gqd	残存
gqe	殍
gqf	殖
gqg	死于
gqh	殩
gqi	珧
gqj	烈
gqk	殒
gql	死因
gqm	万岁
gqn	烈性
gqo	烈火
gqp	殡
gqq	残留
gqr	天然气
gqs	天然林
gqt	歼
gqu	残疾
gqv	兀
gqw	殄
gqx	裂缝
gqy	死亡
gra	青年工人
grb	一揽子协议
grd	残缺不全
gre	2
grf	开拓进取
grg	一年来
grh	2
gri	珠海
grj	2
grk	一气呵成
grl	救护车
grm	残兵败将
grn	一刹那
gro	一手遮天
grp	瑰宝
grq	一年多来
grr	一手抓
grs	2
grt	琕
gru	棘手问题
grw	开拓创新
grx	一年比一年
gry	束手就擒
gsa	末期
gsc	2
gsd	一概而论
gsf	到机场迎接
gsg	一模一样
gsi	互相学习
gsj	末日
gsk	唜
gsl	2
gsn	琴棋书画
gso	2
gsq	2
gsr	严格执行
gss	严格要求
gst	║
gsu	互相尊重
gsv	2
gsw	两极分化
gsy	㺷
gta	一筹莫展
gtb	来得及
gtc	一箭双雕
gtd	严重破坏
gte	珘
gtf	平稳过渡
gtg	一系列
gth	2
gti	一息尚存
gtj	严重影响了
gtk	副委员长
gtl	麦田
gtm	严重曲折
gtn	政策性
gto	严惩腐败
gtp	现役军人
gtq	一笔勾销
gtr	一般的
gts	平等相待
gtt	一条街
gtu	一等奖
gtw	一般人
gtx	珻
gty	一般说来
gua	副总工程师
gub	一意孤行
guc	一次又一次
gud	颊
gue	开门办学
guf	平均
gug	平静
guh	一决雌雄
gui	平滑
guj	平时
guk	平顺
gum	开门见山
gun	下决心
guo	平度
gup	平定
gur	更新换代
gus	表决权
gut	副部长
guu	平凉
guv	亊
guw	残疾人
gux	副总统
guy	平房
gva	开始工作
gvb	开始了
gvc	2
gvf	开始进行
gvg	一刀两断
gvh	璶
gvi	㻖
gvm	2
gvp	开始实行
gvq	2
gvr	2
gvt	严肃处理
gvu	2
gvv	一九九八年
gvw	到群众中去
gwa	下个世纪
gwb	玱
gwc	现代通信
gwd	一件大事
gwe	副作用
gwf	万亿元
gwg	整体素质
gwh	现代战争
gwi	再创辉煌
gwj	一个时期的
gwk	珍品
gwl	与会国
gwm	殊途同归
gwn	珍惜
gwo	2
gwp	珍视
gwq	殡仪馆
gwr	与会的
gwt	现代科学技术
gwu	一个问题
gwv	带领群众
gww	一体化
gwx	融会贯通
gwy	玐
gxa	毒药
gxc	正统观念
gxd	一丝不苟
gxe	一贯采取
gxf	一贯支持
gxg	毒素
gxi	互派
gxj	毒蛇
gxp	毒害
gxr	互换
gxs	素材
gxt	副组长
gxu	素养
gxv	2
gxw	一级企业
gxx	瑎
gxy	互为
gya	理论工作者
gyb	理论联系实际
gyc	天文台
gyd	两方面
gyf	来访者
gyg	琂
gyh	斑点
gyi	玊
gyk	玉器
gyl	理论界
gym	琼山
gyn	一言以蔽之
gyo	副主席
gyp	班禅
gyr	更高的
gys	班机
gyt	璇
gyu	理论问题
gyw	平方公里
gyx	班级
gyy	死亡率
haa	虚荣
hab	2
hac	2
had	䁰
hae	皻
hag	眶
hai	2
haj	瞙
hak	虎口
hal	占世界人口
han	虚心
hao	觑
haq	
har	虚拟
has	虎林
hat	虐待
hau	虎门
hav	䀙
haw	彪
hax	虚弱
hay	虔诚
hba	齛
hbb	䶔
hbc	䶕
hbd	䶝
hbe	齯
hbf	＄
hbg	䶦
hbi	2
hbj	齵
hbk	齶
hbl	䁅
hbm	䶣
hbo	2
hbq	䶟
hbr	齭
hbs	齽
hbt	齚
hbu	齸
hbv	2
hbw	䶖
hbx	2
hby	䶩
hca	皮鞋
hcb	皮子
hcc	㿬
hcd	颇有
hce	颇受
hcf	㿹
hcg	皮球
hch	点对点协议
hcj	㿸
hcl	2
hco	2
hcq	皮包
hcr	非对抗性
hct	皮毛
hcv	㿳
hcw	皮货
hcx	2
hcy	颇高
hda	虚有其表
hdc	悲欢
hdd	点石成金
hde	2
hdf	具有十分重要的意义
hdg	占有一席之地
hdh	非
hdi	非洲
hdj	目不暇接
hdl	目不转睛
hdm	頉
hdn	悲惨
hdo	2
hdp	2
hdr	2
hds	㮂
hdt	具有重要的
hdu	悲壮
hdw	非但
hdx	眬
hdy	非议
hea	2
hed	2
hee	2
hef	肯干
heg	䁔
hei	2
hek	2
hem	2
hen	2
heo	2
hep	肯定
het	瞬息
hev	2
hew	2
hex	2
hey	2
hfa	2
hfb	2
hfc	瞌
hfe	2
hff	歭
hfg	2
hfh	瞌睡
hfi	眎
hfj	2
hfk	瞦
hfl	2
hfm	2
hfo	2
hfr	2
hft	此起彼伏
hfv	2
hfw	歧途
hfy	虚无主义
hga	非正式
hgb	上阵
hgc	卡通
hgd	丄
hge	上月
hgf	上去
hgg	上来
hgh	凸
hgi	督
hgj	䁣
hgk	䀳
hgl	上车
hgm	上周
hgn	上层
hgo	上火
hgp	督察
hgq	上饶
hgr	上年
hgs	上校
hgt	上午
hgu	上将
hgv	䀴
hgw	上任
hgx	上缴
hgy	上帝
hha	矑
hhb	目睹了
hhd	颦
hhe	2
hhg	䀠
hhh	频频
hhj	2
hhk	䀡
hhl	亅
hhm	2
hhn	愳
hho	煛
hhp	瞾
hhr	目的
hhs	步枪
hht	频繁
hhu	目前
hhv	非此即彼
hhw	矍
hhx	瞠目结舌
hhy	频率
hia	2
hib	非法出版
hic	2
hid	非常成功
hie	非常遥远
hif	2
hig	非常严格
hih	2
hii	非法活动
hij	非常时期
hik	2
hin	非法收入
hio	非常精彩
hip	非洲之角
hir	非法手段
his	卢沟桥
hit	非常重要
hiw	非常会议
hix	非法组织
hiy	非常高兴
hja	旧式
hjc	2
hjd	卢旺达
hje	非暴力手段
hjf	㫖
hjg	旧事
hjh	眒
hjj	旧日
hjk	2
hjl	2
hjm	2
hjn	旧书
hjo	2
hjq	児
hjr	2
hju	2
hjv	2
hjx	㲃
hjy	2
hka	战区
hkb	点子
hkc	梷
hkd	战友
hke	占用
hkf	战士
hkg	睈
hkh	敁
hkj	战果
hkk	矂
hkl	旧中国
hkm	战败
hkn	点心
hko	点火
hkp	迠
hkq	点钟
hkr	战后
hks	战机
hkt	战乱
hku	点头
hkv	2
hkw	战俘
hkx	战绩
hla	2
hlc	2
hlf	战略地位
hlg	睤
hlh	战略上
hli	2
hlj	2
hll	战略转移
hlo	鹷
hlq	2
hlr	鹾
hlt	战略物资
hlu	战略部署
hlw	㮚
hlx	2
hma	睓
hmb	2
hmc	2
hme	2
hmf	睭
hmg	非同一般
hmh	2
hmj	2
hmk	2
hml	2
hmm	2
hmn	非同以往
hmo	2
hmq	2
hmr	2
hms	2
hmt	2
hmw	2
hmx	2
hna	虚怀若谷
hnb	凹陷
hnd	颅
hne	2
hnf	2
hng	上情下达
hnh	此情此景
hni	虚心学习
hnj	2
hnl	2
hnm	兕
hnn	㠯
hno	2
hnp	2
hnq	卢氏
hnr	悲惨的
hns	2
hnt	䀣
hnv	郻
hnw	虚情假意
hnx	眤
hny	2
hob	齢
hoc	2
hod	2
hoe	2
hof	2
hoh	2
hoj	2
hok	2
hol	2
hom	2
hon	2
hop	2
hos	2
hot	2
hou	2
hov	
how	2
hox	2
hpa	2
hpc	2
hpg	壑
hpi	2
hpj	肯定是
hpk	2
hpm	2
hpo	2
hpp	2
hpq	睕
hpr	2
hpu	2
hpx	2
hqa	眡
hqb	䀚
hqc	粲
hqd	餐厅
hqe	2
hqf	䙸
hqg	2
hqh	餐具
hqj	眴
hqk	眳
hql	战争罪犯
hqm	紫金山
hqp	2
hqq	餐馆
hqr	覐
hqs	2
hqu	㱑
hqw	皮包公司
hra	2
hrd	睎
hrf	上年增加
hrj	2
hrk	2
hrm	2
hro	2
hrp	矈
hrr	虚拟技术
hrs	2
hrv	2
hsa	2
hsb	2
hsc	2
hsd	2
hse	2
hsf	紫禁城
hsh	战术上
hsi	2
hsl	2
hsm	2
hso	2
hsp	2
hsq	2
hsr	2
hst	上述条件
hsx	2
hsy	2
hta	2
htc	2
htd	䀨
htf	频繁地
htg	瞬息万变
hth	眨眼
htj	2
htl	2
htm	矀
htn	䀥
hto	矁
htq	2
hts	2
htt	步行街
htu	非生产性建设
htv	2
hty	2
hua	2
hub	2
huc	2
hud	眹
hue	上门服务
huf	䀞
hug	眻
hui	2
huj	上半时
huk	2
hum	2
hup	2
huq	2
hur	上半年
hut	旧病复发
huu	战斗部队
huv	䁠
huw	此间人士
huy	2
hva	2
hvb	2
hvc	2
hvd	2
hve	眼力
hvf	2
hvg	睷
hvh	眼眸
hvi	眼泪
hvj	眼影
hvl	䁽
hvn	2
hvo	2
hvp	眼神
hvq	眼角
hvs	2
hvv	2
hvw	2
hvy	䀔
hwa	上个世纪
hwb	齿
hwd	睦邻友好
hwe	具体办法
hwf	具体地说
hwg	睽
hwh	瞧瞧
hwi	2
hwl	䡞
hwn	睺
hwp	具体实践
hwr	占优势
hws	督促检查
hwt	具体条件
hwu	具体问题
hwv	凣
hww	具体化
hwx	2
hwy	睢
hxa	柴草
hxb	2
hxc	2
hxd	雌雄
hxf	此地
hxg	㭰
hxi	柴油
hxj	歶
hxk	啙
hxl	2
hxm	颇费周折
hxn	雌性
hxq	此外
hxr	上级指示
hxs	上级机关
hxt	此行
hxu	此间
hxw	上级领导
hxx	紫红
hxy	此刻
hya	2
hyb	2
hyd	2
hye	2
hyf	2
hyh	2
hyi	2
hyj	2
hyk	瞓
hym	2
hyn	盳
hyo	2
hyp	2
hyq	2
hyr	瞝
hys	2
hyt	䁢
hyw	睟
hyx	䂅
iaa	灌区
iab	汇聚
iac	洞若观火
iad	淇
iae	满腔
iaf	江南
iag	满
iah	满目
iai	洪水
iaj	澫
iak	满足
ial	洪恩
iam	洪峰
ian	㲺
iao	光荣业绩
iap	滢
iaq	浇铸
iar	汇报
ias	江西
iat	港币
iau	满意
iav	潇
iaw	港
iay	汇率
ibb	消防队
ibc	溋
ibd	㴍
ibe	㶏
ibg	汓
ibi	洱海
ibj	㳱
ibk	濻
ibl	演出团
ibn	㳧
ibo	2
ibp	㴷
ibq	2
ibu	涵养
ibv	2
ibw	消除分歧
iby	沈阳市
ica	汗马功劳
icb	常驻联合国代表
icc	涰
icd	津巴布韦
ice	慂
icf	涌起
icg	治理
ici	滩涂
ick	汉中
icm	海参崴
icn	沀
ico	㶠
icp	治安
ics	治标
ict	涌入
icu	治病
icw	浚
icx	2
icy	汊
ida	没有共产党就没有新中国
idb	少不了
idc	沷
idd	湖面
ide	沥
idf	沯
idg	沰
idh	滟
idi	湖泊
idj	消耗量
idk	尖叫
idl	学成回国
idm	深有同感
idn	没有发生
ido	洃
idq	没有解决
idr	源泉
ids	没有想到
idt	澳大利亚
idu	潦
idw	小而全
idx	没有经验
idy	汏
iea	深受其害
ieb	举办了
iec	满脸通红
ied	浮夸
iee	浮肿
ief	㳫
ieg	㳉
ieh	漞
iei	溪水
iej	光彩照人
iek	泇
iem	没脸见人
ien	㶀
ieo	2
iep	常用字
ier	满腔热情
ies	滥用权力
iet	氻
ieu	水力资源
iew	浮华
iex	削弱
iey	水乳交融
ifa	污蔑
ifb	渎职
ifc	溘
ifd	潜在
ife	法办
iff	坔
ifg	波士顿
ifh	汁
ifi	河南省
ifj	瀚
ifk	澎
ifl	省直辖行政单位
ifm	法典
ifn	渎
ifo	浾
ifp	法官
ifq	学雷锋
ifr	深远的
ifs	省直机关
ift	法律
ifu	流动资金
ifv	2
ifw	法人
ifx	法纪
ify	济南市
iga	光芒
igb	清除
igc	光能
igd	＜
ige	浦
igf	兴起
igg	清理
igh	耀眼
igi	清洁
igj	清晰
igk	漱
igl	兴国
igm	渍
ign	汅
igo	省政府
igp	兴安
igq	光
igr	激烈的
igs	清楚
igt	光盘
igu	清单
igv	清剿
igw	兴
igx	光缆
igy	兴衰
iha	滹
ihb	小孩
ihc	婆
ihd	湨
ihe	涉县
ihf	小城
ihg	沚
ihh	濒
ihi	小学
ihj	小时
ihk	小品
ihl	小车
ihm	小贩
ihn	小心
iho	小数
ihp	涉案
ihq	小儿
ihr	小报
ihs	2
iht	波长
ihu	波音
ihv	涉嫌
ihw	波段
ihx	小结
ihy	泸州
iia	水工
iib	消防
iic	水能
iid	水面
iie	港澳办
iif	沿海地区
iig	消毒
iii	水
iij	水电
iik	水患
iil	海洛因
iim	港澳同胞
iin	江泽民同志
iio	光辉业绩
iip	淘汰赛
iiq	淡水鱼
iir	水质
iis	小学校
iit	娑
iiu	水准
iiv	婆婆妈妈
iiw	水位
iix	流水线
iiy	水文
ija	清明节
ijd	濒临破产
ijf	涅
ijg	汩
ijh	混战
iji	湿润
ijj	光明日报
ijk	温顺
ijl	温
ijm	混同
ijn	兴旺发达
ijo	温度
ijp	水旱灾害
ijq	温饱
ijr	温泉
ijs	巣
ijt	混乱
iju	温差
ijv	温暖如春
ijw	小时候
ijx	混纺
ijy	灏
ika	泥足巨人
ikb	濈
ikd	2
ikf	党员干部
ikg	塣
ikh	溃
iki	2
ikk	漶
ikm	党中央
ikn	2
ikp	2
ikr	㳏
iks	㳭
ikt	削足适履
iku	溃决
ikv	2
ikw	省吃俭用
ila	戦
ild	洇
ilf	畄
ilg	沺
ilh	举国上下
ili	漯河
ilk	党团员
ill	沉思默想
ilo	2
ilp	沉默寡言
ilq	2
ilr	渐近
ilt	2
ilu	渐次
ilw	赏罚分明
ilx	党团组织
ily	流连忘返
ima	滑落
imb	䣔
imc	尚难
imd	泱
ime	尚且
imf	尚未
img	洞
imi	油污
imj	测量
imk	敞
iml	油轮
imn	油层
imo	油烟
imp	洞察
imq	省内外
imr	测控
ims	滑梯
imt	尚待
imu	常见病
imv	2
imw	油价
imx	海岸线
imy	测试
ina	汛期
inb	澉
inc	满心欢喜
ind	深情厚谊
ine	2
inf	汛
ing	学习班
inh	沑
ini	泥沙
ink	湋
inl	瀷
inm	漏网
inn	㲸
ino	2
inq	2
inr	烫
ins	2
int	泌
inu	泥浆
inw	满怀信心
inx	埿
iny	小心谨慎
ioa	淡薄
ioc	2
iod	水火不相容
iof	水火无情
iog	濧
ioh	2
ioi	洞庭湖
ioj	瀍
iom	2
ion	少数民族
ioo	辉煌灿烂
iop	法庭审理
ioq	潾
ior	没精打采
iot	淡季
iou	㴑
iov	溇
iow	少数人
iox	2
ioy	淡忘
ipa	深切
ipb	
ipd	深厚
ipe	深受
ipf	淙
ipg	淀
iph	沉睡
ipi	常常
ipj	渖
ipk	常
ipl	汉字输入
ipm	常见
ipn	深情
ipo	浓度
ipp	深邃
ipq	鲎
ipr	党的
ips	学校
ipt	学生
ipu	学问
ipv	党群
ipw	溶
ipx	党组
ipy	尝试
iqa	涣散
iqb	2
iqc	沟通
iqd	油然而生
iqe	澥
iqf	濒危动物
iqg	渔
iqi	淘汰
iqj	泡影
iqk	泃
iql	漠然置之
iqn	渔民
iqo	淗
iqp	濥
iqq	淘金
iqr	海外投资
iqs	2
iqt	潴
iqu	涉外单位
iqv	㴔
iqw	海外侨胞
iqy	溜
ira	激荡
irb	派出
irc	法制观念
ird	湃
irf	激起
irg	湟
irh	激战
iri	激光
irj	激昂
irk	党的路线
irl	法制轨道
irm	峾
irn	激发
irp	少年宫
irq	海拉尔
irr	派兵
irs	2
irt	派往
iru	派头
irv	党的建设
irw	法制化
irx	党的纲领
iry	㲼
isa	河东
isb	浮想联翩
isc	酒巴
isd	学术研讨会
ise	洒脱
isf	湮
isg	酒
ish	湘
isi	河流
isj	渣
isk	河口
isl	河畔
ism	河山
isn	消极情绪
iso	酒精
isq	2
isr	酒泉
iss	溧
ist	小本生意
isu	河道
isw	淞
isx	小本经营
isy	沭
ita	省区
itb	举行了
itd	沃
ite	劣
itf	洗
itg	深入开展
ith	溴
iti	海洋
itj	海里
itk	活跃
itl	党和国家
itm	省内
itn	汔
ito	渊
itp	海军
itq	少儿
itr	流行的
its	水利枢纽
itt	省委
itu	海关
itv	少女
itw	党和人民
itx	省级
ity	㳊
iua	洋葱
iub	溢出
iud	浓妆艳抹
iue	注意力
iuf	党总支
iug	洋
iuh	2
iui	湖北省
iuj	潼
iuk	水产品
iul	潧
iun	㵍
iuo	沉着应战
iup	法新社
iuq	澬
iur	尖端技术
ius	当头棒喝
iut	ㄉ
iuu	滋养
iuv	溓
iuw	洋货
iux	涕
iuy	潜意识
ivb	激怒了
ivd	当面
ive	泿
ivf	浔
ivg	津
ivi	浸泡
ivj	当日
ivk	洳
ivm	梁山
ivn	当局
ivo	浩如烟海
ivp	当初
ivq	染色
ivr	沼气
ivt	浸透
ivu	当头
ivv	小姑娘
ivw	粱
ivx	2
ivy	当夜
iwa	没落
iwb	小伙子
iwc	沧桑
iwd	清华大学
iwe	沿用
iwf	淮南
iwg	澄
iwh	滫
iwi	淮河
iwk	消化吸收
iwl	2
iwm	脊髓
iwn	深化改革
iwo	涂料
iwp	浴室
iwr	涂抹
iws	脊椎
iwt	混合物
iwu	沿着
iwv	湓
iww	沿途
iwx	沿线
iwy	汃
ixc	光纤通信
ixd	2
ixe	溺爱
ixf	潍坊
ixg	湪
ixi	涨潮
ixj	消费量
ixk	消费品市场
ixo	2
ixp	2
ixr	2
ixt	省纪委
ixu	消费资料
ixv	2
ixw	涨价
ixx	消费结构
iya	省市区
iyb	浏阳
iyc	澈
iyd	液态
iye	㳖
iyf	济南
iyg	流速
iyh	注目
iyi	游泳
iyj	浏
iyk	濠
iyl	游园
iym	小商贩
iyn	泳
iyo	滦
iyp	注视
iyq	注解
iyr	流失
iys	淳朴
iyt	汸
iyu	尐
iyw	滚
iyx	浪费
iyy	氵
jaa	䗃
jab	昻
jac	2
jad	蜞
jae	昮
jaf	暴露
jag	螨
jai	师范学校
jaj	㫒
jak	暴跌
jal	星期四
jam	暎
jan	暴发
jap	蠓
jaq	螮
jas	最基本
jat	蛲
jau	2
jav	蟏
jaw	蠖
jax	2
jay	野营训练
jbb	电子函件
jbc	电子对抗
jbd	电子有限公司
jbe	最爱
jbf	电子元件
jbg	电子表
jbi	最少
jbj	早出晚归
jbk	最贵
jbm	昢
jbn	最快
jbr	最后
jbs	2
jbt	最先
jbu	电子产品
jbw	最低
jby	电子商务
jcb	2
jce	蛹
jcf	蛏
jcg	紧逼
jch	2
jci	2
jcj	蚂蚁
jck	㬃
jcm	䝨
jcn	蝚
jco	2
jcp	坚定
jcq	里通外国
jcr	紧迫
jct	紧靠
jcu	坚决
jcv	2
jcw	紧俏
jcx	紧张
jcy	2
jda	果不其然
jdb	明确了
jdd	是否有过
jde	蛕
jdf	蝰
jdg	䖨
jdh	明确目标
jdj	显而易见
jdk	2
jdl	2
jdm	蝒
jdn	时有发生
jdo	2
jdp	2
jdq	2
jdr	最大的
jds	明确要求
jdt	时不我待
jdu	最有前途的
jdv	2
jdw	昃
jea	日用工业品
jeb	明了
jec	2
jed	量力而行
jee	蛠
jef	蛶
jeg	蚏
jei	日用消费品
jej	明星
jek	盟员
jel	盟国
jen	电力局
jeo	明火
jep	盟军
jeq	晲
jer	明白
jet	明智
jeu	暴力冲突
jev	日月如梭
jew	明令
jex	螇
jey	明亮
jfa	早期
jfb	时隔
jfc	昙
jfd	蠕
jff	圼
jfg	时下
jfh	旪
jfi	时常
jfj	旱
jfk	显示器
jfm	暔
jfn	显示屏
jfo	㫱
jfp	旱灾
jfq	野外
jfr	早年
jfs	电动机
jft	野生
jfu	时装
jfv	量才录用
jfw	时代
jfy	䖞
jga	蚈
jgb	旽
jgc	晊
jgd	是否
jge	蜻
jgf	晴天霹雳
jgg	蚟
jgh	是
jgj	蟪
jgk	蝠
jgl	遇到困难
jgm	螬
jgn	2
jgo	㫫
jgp	题字
jgq	敭
jgs	昩
jgt	最严重的
jgu	师资
jgv	蜨
jgw	时至今日
jgx	蛦
jgy	题为
jha	是非功过
jhb	虫子
jhc	蚾
jhd	暃
jhe	申办
jhf	冒雨
jhg	蝆
jhh	蠼
jhi	冒尖
jhj	早些时候
jhk	曱
jhl	2
jhm	※
jhn	畅
jhp	野战军
jhq	晛
jhr	监督制度
jhs	监督权
jht	冒牌
jhu	申辩
jhv	2
jhw	明眼人
jhx	蟕
jhy	申请
jia	蟝
jib	2
jie	日常办公
jig	晄
jih	2
jii	2
jik	2
jil	2
jin	2
jio	星光灿烂
jip	曭
jiq	2
jir	临渴掘井
jis	2
jit	䖢
jiv	2
jiw	蝋
jix	2
jja	日期
jjb	日出
jjd	日历
jje	日月
jjf	日元
jjg	蚎
jjh	是是非非
jji	日渐
jjj	日
jjk	昌邑
jjl	电影界
jjm	日见
jjn	临时性
jjo	焸
jjp	星星之火可以燎原
jjq	蜴
jjr	日报
jjs	日本
jjt	时时处处
jju	日益
jjw	紧紧依靠
jjx	紧紧张张
jjy	日夜
jka	2
jkb	2
jkd	2
jke	蜎
jkf	2
jkg	曼哈顿
jkj	紧跟时代
jkk	曮
jkl	2
jkm	日喀则
jkn	2
jko	2
jkp	2
jkr	暗中摸索
jku	2
jkw	2
jkx	2
jlb	2
jlc	鄤
jlf	昷
jlg	归罪于
jlh	䖬
jli	临界温度
jlj	2
jlm	2
jln	2
jlo	2
jlp	2
jlr	㼔
jlu	2
jlv	2
jlw	归国华侨
jlx	螺丝
jly	日思夜想
jma	晪
jmb	映出
jmd	愚蠢
jmf	蜩
jmg	遇到
jmh	遇
jmi	2
jmj	愚昧
jmk	2
jml	2
jmm	蠳
jmn	2
jmo	2
jmp	遇害
jmr	蛧
jmv	2
jmw	愚公
jmx	2
jmy	蚒
jna	电荷
jnb	影剧院
jnc	电能
jnd	电磁
jne	电力
jnf	电教
jng	电表
jnh	蝑
jni	电池
jnj	电量
jnk	电器
jnn	蟤
jno	电焊
jnp	电视
jnq	电镀
jnr	电报
jns	电梯
jnt	毾
jnu	电熨斗
jnw	电信
jnx	电缆
jny	电讯
joa	电火花
jod	2
joe	2
jof	显露
jog	显现
joj	旷野
jok	2
jol	2
jom	2
jon	螰
joo	蟧
jop	2
joq	里应外合
jor	明火执仗
jot	显得
jou	㫧
jov	螗
jow	2
jox	2
joy	星火计划
jpa	电视工作者
jpd	坚定不移
jpe	2
jpf	电视塔
jpg	蝊
jph	䗆
jpj	暝
jpk	监察员
jpl	晖
jpm	电视周
jpn	坚定性
jpo	电视广播
jpp	2
jpq	晼
jpr	电视接收机
jps	监察机关
jpt	电视片
jpu	电视新闻
jpv	鷃
jpw	坚定信心
jpx	紧密结合
jpy	鉴定证书
jqa	昭然若揭
jqb	剔除
jqd	临危不惧
jqe	易县
jqf	晚霞
jqg	紧急救援
jqh	晚餐
jqi	易学
jqj	暴饮暴食
jqk	冕
jqm	蝜
jqn	畅销书
jqo	歇业
jqp	晚宴
jqq	电饭锅
jqr	剔
jqt	晚稻
jqu	晚间
jqv	㬠
jqw	遏
jqx	2
jqy	旳
jra	2
jrc	昄
jrd	紧迫感
jre	䖰
jrf	最近十多年来
jrg	蚯
jrh	蚚
jri	暭
jrj	2
jrk	2
jrl	蟱
jrn	最近以来
jro	2
jrr	电报挂号
jrt	坚持和完善
jru	明摆着
jrv	2
jrw	最近几年
jrx	坚持统一
jry	蚸
jsa	2
jsc	2
jsf	果真
jsg	日本政府
jsh	敤
jsi	果汁
jsj	曋
jsk	果品
jsm	2
jso	颗粒
jsp	果农
jsq	果然
jsr	蜥
jss	最根本的
jsu	日本首相
jsv	2
jsw	蜙
jsy	日本方面
jta	临摹
jtb	蜏
jtc	暗自欢喜
jtd	蜘
jte	临朐
jtf	蜓
jtg	戥
jth	蜒
jti	临沂
jtj	蜊
jtk	监听
jtl	暗自思量
jtm	晑
jtn	蜁
jto	蟋
jtp	监视
jtq	显微镜
jtr	监控
jts	最重要的是
jtt	星系
jtu	临门
jtv	䗻
jtw	冒牌货
jtx	临终
jty	监
jua	蛢
jub	坚决取缔
juc	2
jud	最新成果
jue	照章办事
juf	蚪
jug	蛘
jui	最新消息
juj	蟑
juk	暗中
jul	晕头转向
jum	2
jun	日益发达
jup	日益完善
jur	坚决反对
jut	暗自
juu	坚决斗争
juw	螠
jux	坚决维护
juy	昧着良心
jvb	归队
jvd	归还
jve	蛝
jvf	昭示
jvg	归来
jvi	照耀
jvj	最好时期
jvk	昭
jvm	2
jvo	照料
jvp	归案
jvq	2
jvr	照搬
jvs	照样
jvt	虭
jvu	归并
jvv	2
jvw	照例
jvx	归结
jwa	蟘
jwb	最佳阵容
jwc	暴风骤雨
jwd	时代感
jwf	暴风雨
jwg	暌
jwh	螩
jwi	时代潮流
jwl	2
jwm	2
jwn	电信局
jwo	愚公精神
jwp	2
jwq	2
jwr	蚥
jws	2
jwt	时代特征
jwu	时代前列
jwv	蚡
jww	䘋
jwx	最低纲领
jwy	暹
jxd	最强大
jxe	蚴
jxg	明细表
jxh	最终目的
jxj	昆虫
jxk	2
jxl	2
jxm	昆曲
jxn	昆剧
jxo	2
jxs	2
jxu	紧张状态
jxv	2
jxw	坚强领导
jxx	蚍
jxy	曵
jyb	影院
jyc	蜟
jyd	ァ
jyf	明文规定
jyg	景致
jyh	最高点
jyi	ぁ
jyj	影星
jyk	景
jym	景山
jyn	虻
jyp	最为突出
jyq	景色
jyr	昘
jys	电话机
jyt	蚄
jyu	螃
jyv	蜋
jyw	影像
jyx	电话线
jyy	旼
kaa	中草药
kac	2
kad	喏
kaf	㖼
kag	哐
kah	嚂
kai	中共党员
kaj	叶落归根
kak	中共中央
kal	叫苦连天
kam	唝
kan	喋
kao	2
kaq	噆
kar	呕
kat	顺其自然
kau	中苏关系
kav	2
kaw	嗬
kax	中世纪
kba	2
kbb	吸取
kbc	㖩
kbd	2
kbf	吸取教训
kbg	咡
kbh	嗤
kbi	吸油
kbj	2
kbl	2
kbn	吔
kbp	2
kbq	㗦
kbr	听取批评
kbt	2
kbu	听取意见
kbv	2
kbw	2
kbx	吸引
kby	贵阳市
kca	2
kcb	嗓子
kcc	啜
kcd	2
kce	叹服
kcf	2
kcg	患难与共
kch	2
kci	2
kck	䣈
kcl	2
kcm	2
kcn	噊
kcr	2
kcs	2
kct	哞
kcv	2
kcx	2
kdb	吃不了兜着走
kdc	㕹
kde	别有用心
kdf	只不过是
kdg	喊
kdh	嘁
kdj	顺畅
kdk	顺口
kdm	咘
kdn	哤
kdo	顺序
kdr	顺势
kds	2
kdt	顺德
kdu	㕦
kdv	2
kdw	嗪
kdx	吐故纳新
kdy	呔
keb	啂
ked	吃力不讨好
kee	嗋
kef	哺乳动物
keg	别致
kej	别墅
kek	咖啡
kel	别国
kem	2
keo	另类
kep	㖟
keq	另外
ker	别的
kes	啋
ket	另行
keu	2
kfa	跨地区
kfb	喷出
kfc	嗑
kfe	2
kff	喷雾
kfg	嘲弄
kfh	嗔
kfi	中南海
kfj	呼声最高
kfk	咭
kfl	啚
kfn	嚋
kfo	味精
kfp	噎
kfr	喷泉
kfs	吃老本
kft	嘟
kfu	史无前例
kfw	嚯
kfx	2
kfy	㘊
kga	哢
kgb	郢
kgc	咥
kgd	号码
kge	啄
kgf	吁
kgg	㕶
kgh	嘕
kgi	吴江
kgj	咺
kgk	喇
kgm	啧
kgn	饕
kgp	足球赛
kgq	嗷
kgr	中青年
kgt	另一种
kgu	呯
kgv	嘈杂
kgw	号令
kgx	嗉
kgy	哺育
kha	嘘
khb	趿
khc	蹂
khd	啡
khe	蹈
khf	
khg	遗
khh	跛
khi	中学
khj	蹋
khk	躁
khl	躅
khm	踹
khn	踞
kho	踮
khp	跎
khq	跳
khr	踬
khs	︶
kht	路
khu	蹲
khv	踺
khw	啮
khx	跸
khy	蹄
kia	2
kib	2
kic	2
kid	中流砥柱
kie	吵架
kif	中学教师
kig	中小型
kih	嘙
kii	中小学生
kil	2
kin	2
kio	2
kiq	2
kir	哨兵
kit	嗨
kiu	吵闹
kiv	2
kiw	顺水人情
kix	2
kiy	2
kjd	2
kje	中坚力量
kjf	哻
kjg	啺
kjn	口是心非
kjo	2
kjp	2
kjq	虽然
kjs	嗮
kju	中日关系
kjv	2
kjw	2
kka	嚚
kkb	串联
kkc	踊跃参加
kkd	哭
kke	口服
kkf	鄂
kkg	咄咄逼人
kkh	患
kki	吕梁
kkk	口
kkl	器皿
kkm	蹉跎岁月
kkn	呼吁书
kko	品类
kkp	踏踏实实
kkq	口角
kkr	口气
kks	器械
kkt	品牌
kku	患病
kkv	㖐
kkw	器件
kkx	品级
kky	鄂州
kla	中国革命
kld	嗯
klf	啭
klg	呬
klh	唓
kli	中国少年先锋队
klk	中国中文信息学会
kll	中国国际广播电台
klm	嘪
kln	中国民主促进会
klp	中国农业银行
klq	中国包装总公司
klt	中国科协
klu	嚺
klv	中国建筑工程总公司
klw	中国人民
klx	中国红十字会总会
kly	中国证监会
kma	员工
kmc	中央对外联络部
kmd	咉
kme	嘣
kmf	中央直属机关
kmg	中央政府
kmh	䚋
kmi	跋山涉水
kmk	呐喊
kml	吊车
kmn	中央情报局
kmp	中央军委副主席
kmq	中央银行
kmr	中央气象台
kms	吊桥
kmt	中央委员
kmu	勋章
kmv	2
kmw	剐
kmx	中央统战部
kmy	中央主席
kna	叫苦
knb	啒
kne	2
knf	叫卖
kng	叼
knh	哪些
knk	嘱咐
knm	中心内容
knn	呡
knp	2
knq	吸收外资
knr	嘱托
kns	2
knt	㕧
knw	叫做
knx	中心组
kny	唯心主义
koa	嗻
koc	2
kod	2
koe	2
kof	2
kog	嚉
koj	2
kok	2
kol	2
kom	2
kon	2
koo	㗵
kor	2
kos	嚒
kot	2
kou	2
kov	嘃
kow	2
kox	2
koy	吙
kpa	㗷
kpb	2
kpc	2
kpd	嗐
kpe	口蜜腹剑
kpg	啶
kph	2
kpi	2
kpj	2
kpk	喧哗
kpm	2
kpn	嗤之以鼻
kpo	2
kpp	2
kpq	㕪
kpr	2
kpt	咤
kpu	喧闹
kpw	喀什
kpy	2
kqa	㖧
kqb	㗙
kqd	吹奏
kqe	嘝
kqf	只争朝夕
kqg	唫
kqh	2
kqi	哈尔滨市
kqk	呜咽
kql	2
kqn	咆
kqo	2
kqq	唱独角戏
kqr	啕
kqs	鸣枪
kqt	吹牛
kqu	呁
kqv	喼
kqw	中外合资
kqy	中外记者
kra	喷气式
krb	㕳
krd	嗥
kre	听力
krf	唕
krg	听到
krh	哖
kri	啤酒
krj	2
krk	哪年哪月
krl	2
krm	听见
krr	哳
krs	咑
krt	史籍
kru	唞
krv	2
krw	听从
krx	嚛
kry	听证
ksb	2
kse	2
ksf	㖶
ksg	别树一帜
ksi	叮当
ksj	嘾
ksk	叮嘱
ksn	2
kso	2
ksq	2
kss	啉
kst	2
ksu	喝西北风
ksx	2
kta	吒
ktb	唀
ktd	咶
ktf	呼声
ktg	呼救
kth	川
kti	呼和浩特市
ktj	唯利是图
ktk	呼吁
ktm	噢
ktn	吃惊
kto	响应
ktp	顺利实现
ktq	吃饭
ktr	吃掉
ktt	吃透
ktu	咚
ktv	㘉
ktw	中秋佳节
kty	咊
kua	2
kub	中产阶级
kuc	2
kud	咲
kuf	唴
kug	㕸
kuj	喑
kuk	㖣
kul	中立国家
kum	2
kun	兄弟民族
kuo	2
kur	2
kus	中资机构
kut	遗产税
kuu	跨部门
kuv	兄弟姐妹
kuw	中间人
kux	㖒
kvb	2
kvc	呶
kve	号召力
kvf	㗲
kvi	㖨
kvj	2
kvl	2
kvm	2
kvq	2
kvs	2
kvt	吚
kvu	2
kvv	2
kvx	2
kvy	2
kwa	唯其
kwb	哗众取宠
kwc	只能
kwd	唯有
kwe	中介服务
kwf	咐
kwg	喻
kwh	㖉
kwi	只当
kwj	唯命是从
kwk	吩咐
kwl	嗰
kwm	呼伦贝尔盟
kwn	喉
kwo	2
kwq	唯独
kwr	听人摆布
kws	哚
kwt	只管
kwu	中低产田
kwv	咿
kww	中华人民共和国
kwx	中介组织
kwy	㕥
kxa	2
kxc	2
kxd	2
kxe	吸引力
kxf	2
kxg	嚣张一时
kxk	吆喝
kxl	2
kxo	2
kxp	2
kxq	吸引外资
kxs	2
kxt	㘈
kxu	中继站
kxv	2
kxw	哛
kxx	咝
kxy	呣
kyc	叹为观止
kyd	2
kye	2
kyg	中方表示
kyh	2
kyj	唁电
kyk	哼
kyn	咏
kyo	2
kyp	2
kyr	囄
kyt	嗾
kyu	嘀
kyv	哴
kyw	咬
kyx	呟
kyy	另谋高就
laa	四项基本原则
lac	2
lae	2
laf	䡷
lag	軭
lah	䍓
laj	轕
lak	羁
lan	2
lao	轻工业部
las	2
lat	2
lau	轻工产品
lav	2
law	国共合作
lax	国营经济
lba	国际劳动节
lbb	国际联运
lbc	輙
lbd	国际研讨会
lbe	国防力量
lbf	国际博览会
lbg	国际事务
lbi	国际法
lbk	2
lbn	国际性
lbp	国防军
lbq	国际金融
lbr	国际制裁
lbs	国际机场
lbt	国防科技
lbu	国防部长
lbw	国际化
lbx	国际经济
lby	国际交流
lca	轻工
lcb	轻盈
lcc	辍
lcd	Β
lcf	轻声
lcg	轰击
lch	2
lci	㘝
lck	囼
lcl	轻轻
lcm	圎
lcn	轻快
lcr	2
lct	轻重
lcu	2
lcv	2
lcw	四通八达
lcy	轻率
ldb	因子
ldc	䍔
ldd	因而
lde	国有股
ldf	回顾过去
ldg	軲
ldh	因此
ldi	黑龙江
ldj	轻而易举
ldk	2
ldl	2
ldm	輀
ldn	较大改善
ldo	罽
ldp	固守
ldq	恩怨
ldr	固执
lds	四面楚歌
ldt	恩德
ldu	国有资本
ldv	2
ldw	国有企业
ldx	略有结余
ldy	轪
leb	男孩
lee	輣
lef	田边地头
leg	略胜一筹
leh	2
lei	2
lej	2
lem	2
len	辅助性
leo	2
lep	2
leq	輗
ler	男排
les	2
let	䡃
lev	男女
lew	四月份
lex	2
lfa	园艺
lfb	团聚
lfc	罴
lfd	默契
lfe	墨脱
lff	转动
lfg	转速
lfh	置
lfi	墨水
lfj	黑暗
lfk	团员
lfl	团团
lfm	转帐
lfn	围
lfo	墨
lfp	黑窝
lfq	黑色
lfr	因地制宜
lfs	园林
lft	团
lfu	转产
lfv	转嫁
lfw	团体
lfx	团结
lfy	转让
lga	车工
lgb	国际
lgc	车马
lgd	国有
lge	畏
lgf	车载
lgg	国王
lgh	车皮
lgi	国法
lgj	辐照
lgk	圄
lgl	车轮
lgm	国内
lgn	国情
lgo	国库
lgp	车祸
lgq	车外
lgr	男青年
lgs	车票
lgt	车身
lgu	车间
lgv	鑋
lgw	国债
lgx	2
lgy	国旗
lhb	2
lhc	軙
lhd	四大
lhe	四肢
lhf	四起
lhg	罪恶
lhh	2
lhj	四时
lhk	四川
lhl	2
lhm	䡠
lhn	四
lho	2
lhq	罪名
lhr	2
lht	四季
lhv	2
lhw	四亿
lhy	甲方
lia	2
lib	2
lid	国法不容
lif	塁
lig	㘢
lih	2
lij	䍝
lik	2
lil	2
lim	2
lio	2
lip	圆满完成任务
liq	㱎
lit	输油管线
liu	軣
liv	2
liy	四海为家
ljb	2
ljc	2
ljd	2
lje	2
ljf	2
ljg	畼
ljh	2
lji	2
ljj	2
ljk	2
ljl	輼
ljm	2
ljn	2
ljo	2
ljr	2
ljt	2
ljv	2
ljw	2
ljy	2
lka	回荡
lkb	回函
lkc	2
lkd	回顾
lke	㘣
lkf	回去
lkg	回来
lkh	䡅
lki	圆满
lkj	回电
lkk	回味
lkl	回转
lkm	团中央
lkn	回忆
lko	因噎废食
lkp	廻
lkr	回扣
lks	回想
lkt	回升
lku	回首
lkv	2
lkw	回合
lkx	回绝
lky	回访
lla	2
llb	田阳
llc	2
lle	2
llf	默默无闻
llg	䡒
lli	2
llj	田里
lll	田园
llm	2
lln	罳
llo	2
llq	2
llr	辗转反侧
llu	田头
llw	车辆保养
llx	2
lly	田甲方框四车力
lma	2
lmc	2
lmd	Β
lme	2
lmf	畘
lmg	国内形势
lmh	国内战争
lmi	2
lmj	2
lmk	2
lml	2
lmm	2
lmn	国内情况
lmo	2
lmp	2
lmq	国内外市场
lmr	2
lms	2
lmu	国内新闻
lmv	2
lmw	鷶
lmx	β
lna	思茅
lnd	顋
lne	2
lnf	思索
lng	国民政府
lnh	䡂
lni	思潮
lnk	辅导员
lnl	回心转意
lnm	2
lnn	国民收入
lno	2
lnq	轧钢
lnr	辅导报告
lns	轧机
lnt	㘠
lnu	辅导站
lnw	思念
lnx	思维
lny	回收率
lob	2
loc	2
loe	2
log	轛
loi	2
lok	2
lol	2
lom	2
lon	䍡
loo	2
loq	疄
lor	2
los	2
lot	2
lou	国库券
lov	2
low	2
lox	2
loy	2
lpa	国家工商行政管理局
lpb	连队
lpc	国家验收
lpd	连成
lpe	连用
lpf	国家专利
lpg	国家副主席
lpi	国家海洋局
lpk	国家中医药管理局
lpl	国家国有资产管理局
lpm	连同
lpn	国家发展计划委员会
lpo	国家烟草专卖局
lpp	国家富强
lpq	连锁
lpr	连年
lps	国家机关
lpt	国家和地区
lpu	固定资本
lpv	国家建材局
lpw	国家领导人
lpx	国家级
lpy	国家主权
lqa	连锁功能
lqb	2
lqd	轧钢厂
lqf	斩钉截铁
lqg	罗平
lqh	2
lqj	劅
lqk	㽛
lql	罗田
lqn	䍖
lqo	㽤
lqp	罗定
lqq	黑色金属
lqr	连锁反应
lqs	2
lqt	罗盘
lqu	软包装
lqv	2
lqw	软件
lqx	国外经验
lqy	国外市场
lra	圆白菜
lrc	畖
lrd	连年不断
lrf	连看都不看
lrh	转折点
lrj	暂时
lrl	䍢
lrm	㟻
lrn	慙
lro	2
lrp	暂定
lrq	䡚
lrr	䡈
lrt	因势利导
lrw	暂停
lrx	暂缓
lry	2
lsa	思想工作
lsb	2
lsc	思想观念
lse	2
lsf	回想起
lsg	思想政治教育
lsh	思想上
lsi	思想活跃
lsk	思想路线
lsl	2
lsm	2
lsn	2
lso	2
lsp	困窘
lsr	黑板报
lss	罧
lst	2
lsu	思想道德
lsv	思想灵魂
lsw	思想体系
lsy	思想方法
lta	2
ltb	国务院副总理
ltd	略有
lte	暂行办法
ltf	田径运动
ltg	图表
lti	软科学
ltj	輹
ltk	辂
ltl	连篇累牍
ltm	鸭舌帽
ltn	图书
lto	轓
ltp	因循守旧
ltq	国务卿
ltr	回答提问
lts	图样
ltt	国务委员
ltu	轷
ltw	图们
ltx	轻重缓急
lty	图谋
luc	2
lud	圈套
luf	2
lug	䢂
lui	2
luj	回头是岸
lul	畏首畏尾
lum	2
lun	2
luo	2
lup	2
luq	2
lus	輶
lut	回首往事
luw	恩将仇报
lux	㽧
lva	2
lvb	䣚
lvd	䫫
lve	2
lvf	较好地
lvg	甊
lvh	2
lvi	2
lvj	轈
lvm	2
lvo	2
lvq	2
lvr	2
lvs	2
lvt	輑
lvu	㪹
lvv	2
lvx	2
lvy	轨迹
lwa	软件工程
lwb	界限
lwc	软件预装
lwd	四人帮
lwe	畛
lwf	軵
lwg	辁
lwh	2
lwi	轮流
lwj	输电
lwl	轮转
lwm	2
lwn	国企改革
lwo	轮廓
lwp	团体赛
lwq	囚犯
lwr	轮换
lws	囚禁
lwt	输血
lwu	软件产业
lwv	鴫
lww	轮作
lwx	囵
lwy	囹
lxa	2
lxc	䡏
lxd	团结在
lxe	軪
lxf	软弱无力
lxg	团结一心
lxi	鸭绿江
lxj	2
lxl	毗连
lxm	2
lxn	连贯性
lxo	2
lxp	2
lxr	2
lxs	2
lxt	团结稳定
lxv	2
lxw	连续作战
lxx	辔
lya	2
lyc	较难
lyd	较大
lyf	罚款
lyg	罜
lyh	2
lyi	较小
lyj	较量
lyk	辌
lym	2
lyn	国计民生
lyo	2
lyp	连衣裙
lyq	罚金
lyr	转弯抹角
lys	2
lyt	较短
lyu	图文并茂
lyv	䍚
lyw	较低
lyx	较弱
lyy	较为
maa	典雅
mab	曲阳
mac	2
mad	贼
mae	2
maf	㞬
mag	典型
mah	峫
mai	山东省
maj	贎
mak	巏
mal	2
mam	曲周
man	同工异曲
mao	2
map	崂
maq	嵽
mar	曲折
mas	2
mat	典籍
mav	2
maw	曲阜
may	曲调
mba	2
mbc	2
mbe	2
mbf	2
mbg	邮政
mbh	邖
mbj	骨子里
mbl	2
mbm	内联网
mbn	邮局
mbo	2
mbq	内联外引
mbt	邮箱
mbu	邮递
mbv	2
mbx	邮费
mby	岋
mcb	㽕
mcc	贂
mce	2
mcf	2
mcg	由难到易
mch	2
mcj	2
mcl	2
mcn	2
mco	2
mcp	2
mcq	2
mcr	2
mct	2
mcu	2
mcv	2
mcw	賐
mcx	2
mdc	2
mdd	由盛而衰
mde	岸边
mdf	岸
mdg	崴
mdh	岸上
mdi	岩溶
mdk	2
mdl	輋
mdm	遄
mdn	盎司
mdp	见面礼
mdq	盎然
mdr	财大气粗
mds	嶏
mdt	周而复始
mdu	嶚
mdv	2
mdw	嵟
mdy	贆
mea	骮
meb	㟊
mec	2
med	骷
mee	骨架
mef	胄
meg	岨
meh	骴
mei	䯑
mej	髃
mem	骨骼
men	䯆
meo	髍
mep	髂
meq	骶
mer	髀
mes	䯊
met	骨科
meu	骿
mev	骫
mew	骱
mex	䯗
mey	骹
mfa	雕花
mfb	2
mfc	赋予
mfd	冃
mfe	周边
mff	亗
mfg	周末
mfh	屽
mfi	赌注
mfj	2
mfk	周
mfl	周转
mfm	巅峰
mfn	嶹
mfo	2
mfp	周密
mfq	岏
mfr	周报
mft	赌
mfu	雕塑
mfv	2
mfw	骨干企业
mfx	财经
mfy	周旋
mga	同期
mgb	由表及里
mgc	同台
mgd	刚正不阿
mge	豳
mgf	财政支出
mgg	同事
mgh	同上
mgi	同学
mgj	同日
mgk	峿
mgn	财政收入
mgo	同类
mgp	同窗
mgq	财政金融
mgr	同年
mgs	同机
mgt	同等
mgu	同意
mgv	崨
mgw	同仁
mgx	同级
mgy	典型调查
mha	贴切
mhb	幌子
mhc	岥
mhd	幅面
mhe	幍
mhf	同步增长
mhg	帻
mhh	帧
mhi	幥
mhj	幌
mhk	贴
mhl	㡞
mhm	网上购物
mhn	由
mho	幅度
mhp	帎
mhq	幨
mhr	帙
mhs	由此可以看出
mht	幡
mhu	幛
mhw	帷
mhx	㡉
mhy	由衷
mib	2
mic	2
mif	埊
mih	2
mij	崉
mil	2
mio	2
miq	2
mir	2
mis	2
miu	山海关
miw	同流合污
mix	2
miy	2
mjd	同日而语
mje	2
mjf	嵵
mjg	由易到难
mjh	賵
mji	山盟海誓
mjk	2
mjl	2
mjq	内紧外松
mjr	2
mjs	2
mju	同时并举
mjw	同盟会
mjy	2
mka	2
mkb	嶯
mkc	2
mke	2
mkf	2
mkj	2
mkk	崿
mkl	2
mkm	2
mkn	2
mko	2
mkp	㢠
mkq	岲
mks	2
mkt	2
mkv	2
mkx	2
mky	2
mla	2
mlb	2
mlc	2
mld	崓
mle	2
mlf	2
mlg	周围环境
mlh	嶵
mli	2
mlm	2
mln	䞏
mlo	2
mlp	2
mlq	2
mlr	嶃
mls	2
mlt	2
mlu	周转资金
mlx	2
mly	2
mma	山区
mmb	山阳
mmc	2
mmd	岟
mme	山脚
mmf	山地
mmg	岫
mmh	山上
mmi	山沟
mmj	崱
mmk	山川
mml	2
mmm	山峰
mmq	婴儿
mmr	罂
mms	山村
mmu	山前
mmv	鹦
mmw	山谷
mmx	山乡
mmy	山峦
mna	内心世界
mnb	㐕
mnd	贼心不死
mnf	同心协力
mng	囙
mnh	岂非
mnj	凯里
mnm	同心同德
mnn	乢
mnp	2
mnr	㠄
mnu	2
mnw	贴心人
mny	凯旋
mob	2
moc	2
mod	2
moe	2
mof	赃款
mog	嶫
moh	2
moi	2
moj	2
mok	2
mol	2
mom	2
moo	巆
mop	2
mor	2
mos	㠧
mov	嵣
mox	2
moy	2
mpa	崇敬
mpc	2
mpd	廸
mpe	2
mpf	贻害无穷
mph	2
mpi	崇尚
mpj	㟰
mpl	㟦
mpm	2
mpn	2
mpr	内容提要
mps	2
mpt	贮备
mpu	赔礼道歉
mpv	峖
mpw	崇仁
mpy	崇文
mqa	崏
mqb	岇
mqd	见面
mqe	崅
mqf	见地
mqg	见到
mqi	2
mqj	刿
mqk	嶑
mqm	巍然屹立
mqn	见习
mqp	2
mqq	购销
mqr	岉
mqs	2
mqt	购物
mqu	见闻
mqv	见好
mqx	2
mqy	购房
mrb	由近及远
mrc	岅
mrd	网页
mre	2
mrf	刚才
mrg	网球
mrh	网上
mri	罓
mrj	刚果
mrk	网吧
mrm	网购
mrn	刚性
mro	2
mrq	网名
mrr	网摘
mrs	2
mru	网状
mrx	刚强
mry	2
msb	2
msc	2
mse	2
msf	㠒
msg	2
msh	2
msj	贉
msk	㞹
msl	2
msm	2
msn	2
mso	2
msp	2
msr	㠨
mss	㟳
mst	见机行事
msu	2
msw	㟣
msx	2
mta	同舟共济
mtc	财务预算
mtd	峤
mtf	败者
mth	岝
mti	同往常一样
mtj	峲
mtk	购物中心
mtm	峨嵋
mtn	财务收支
mto	嶓
mtq	㠟
mtr	财务制度
mtt	财务处
mtu	财务部
mtv	崣
mtw	财务会计
mtx	财务纪律
mty	败诉
mua	賆
mud	䞉
mue	巄
muf	赔款
mug	周总理
muh	2
mui	2
muj	㠉
muk	邮递员
mul	财产转移
mum	2
muq	赔钱
mur	财产损失
mus	赔本
mut	嵃
muu	财产关系
muv	骨瘦如柴
muw	财产保险
mux	赠给
muy	赠言
mva	2
mvb	2
mvc	2
mvd	2
mvf	2
mvg	峍
mvh	2
mvj	2
mvm	2
mvn	2
mvo	2
mvp	2
mvq	2
mvs	2
mvt	㟒
mvu	2
mvv	2
mvw	2
mvx	2
mvy	屻
mwa	内幕
mwc	嵡
mwd	内有
mwe	肉用
mwf	内地
mwg	嵛
mwh	肉眼
mwi	内涵
mwj	岕
mwk	肉食品
mwl	见风转舵
mwm	囧
mwn	内心
mwo	内应
mwp	内定
mwq	内销
mwr	赔偿损失
mws	2
mwt	内行
mwu	内部
mwv	嶋
mww	峪
mwx	内乡
mwy	崔
mxa	网络警察
mxb	2
mxc	2
mxd	2
mxe	岰
mxf	网络协议
mxj	岪
mxk	嵹
mxl	网络黑客
mxm	2
mxn	2
mxo	2
mxq	㟜
mxr	见缝插针
mxs	2
mxt	网络管理
mxu	网络新闻
mxw	网络信息中心
mxx	网络经济
mya	雘
myb	䢷
myc	㠡
myd	凯旋而归
myf	由衷地
myg	丹青
myh	2
myi	2
myj	刐
myk	崞
myl	2
myn	丹心
myp	2
myq	2
myr	见诸报端
mys	2
myt	崺
myu	崹
myv	㟍
myw	丹凤
myy	同义词
naa	民工
nab	民防
nad	以牙还牙
nae	民办
naf	异地
nag	惬
nah	懢
nai	殿堂
naj	羿
nak	民品
nal	异国
nam	愥
nan	民心
nao	2
nap	改革家
naq	展馆
nar	民兵
nas	民权
nat	愍
nau	民意
nav	民建
naw	臀
nax	异乡
nay	民族
nbb	发出了
nbc	发出通知
nbd	层出不穷
nbe	㦩
nbf	聼
nbg	局限于
nbh	䣁
nbi	2
nbj	2
nbl	2
nbm	鶌
nbn	局限性
nbo	2
nbp	2
nbq	2
nbt	憨
nbu	2
nbv	2
nbx	2
nby	忣
nca	2
ncb	2
ncd	以柔克刚
nce	快马加鞭
ncf	性能超群
ncg	惨遭
nch	2
nci	惨淡
ncl	2
ncn	怪异
nco	2
ncp	心驰神往
ncq	2
ncr	以观后效
nct	怪物
ncu	惨状
ncw	性能价格比
ncx	2
ncy	怕难为情
nda	尽在其中
ndb	怀孕
ndc	书面通知
ndd	恹
nde	那还用说
ndf	剧场
ndg	憾
ndh	忧虑
ndi	2
ndj	怀里
ndk	忧患
ndl	剧团
ndm	以太网
ndn	居民
ndq	居多
ndr	书面报告
nds	剧本
ndt	情不自禁
ndu	剧痛
ndw	怀念
ndx	剧组
ndy	已成为
nea	懚
nec	2
nee	愶
nef	必须增强
neg	心胸开阔
neh	㥰
nei	必须掌握
nej	必须是
nel	2
nen	尽力尽责
neo	2
nep	懓
ner	必须看到
net	民用航空
neu	必须遵循
nev	2
new	惯用伎俩
nex	必须贯彻
ney	心力交瘁
nfa	改进工作
nfc	怯
nfd	层面
nfe	2
nff	惊魂未定
nfg	导致
nfh	忓
nfi	屚
nfj	导电
nfk	必需品
nfm	导购
nfn	愤慨
nfo	㤸
nfp	悖
nfq	迅猛
nfr	导热
nft	导向
nfu	悻
nfv	发动群众
nfw	导体
nfx	导线
nga	懒散
ngb	发现了
ngc	刁难
ngd	情感
nge	那边
ngf	快速增长
ngg	那天
ngh	那些
ngi	心理学
ngj	那里
ngk	丮
ngm	怲
ngn	快速发展
ngo	2
ngp	发表社论
ngq	改正错误
ngr	以下的
ngs	司机
ngt	那种
ngu	情况
ngv	情妇
ngw	司令
ngx	情绪
ngy	发表谈话
nha	收藏
nhb	丑陋
nhc	収
nhd	
nhe	收受
nhf	遐
nhg	丑恶
nhh	戄
nhi	收治
nhj	悼
nhk	心目中
nhl	收转
nhm	眉山
nhn	疏导
nho	蛋类
nhp	收容
nhq	疏忽
nhr	蛋白
nhs	遐想
nht	收入
nhu	收养
nhw	收集
nhx	收缩
nhy	收效
nia	2
nib	2
nie	悄
nif	飞沙走石
nig	尿素
nii	氹
nik	2
nil	劈波斩浪
nim	以小见大
nin	恍惚
nio	2
nip	憆
niq	尼泊尔
nis	司法权
nit	尿片
niu	司法部门
niv	2
niw	2
niy	2
njb	2
njc	发电能力
njd	尽最大努力
njf	悝
njg	惿
njh	丱
njk	民盟中央
njl	愠
njm	㥥
njn	慢慢
njo	2
njp	心旷神怡
njq	展览馆
njr	㤤
njs	惈
njt	尼日利亚
nju	发电站
njv	2
njw	发明创造
njx	䎈
njy	心里话
nka	韍
nkb	书呆子
nkc	壁垒
nke	劈腿
nkf	心中无数
nkg	壁画
nkh	愦
nkk	懆
nkl	2
nkm	屌
nkn	悞
nko	2
nkp	2
nkq	怳
nks	2
nkt	♀
nku	避
nkv	心口如一
nkw	怾
nkx	2
nky	发号施令
nla	慖
nlb	2
nlc	2
nld	屇
nlf	2
nlg	愄
nlh	2
nli	2
nlj	2
nll	2
nlm	2
nln	惭愧
nlo	2
nlp	翴
nlq	2
nlt	2
nly	㦒
nma	㥏
nmb	2
nmc	2
nmd	惴
nmf	尸骨未寒
nmg	怞
nmh	㕞
nmi	屓
nmj	㞯
nmk	2
nml	2
nmm	屭
nmn	惆怅
nmo	2
nmq	2
nms	2
nmt	2
nmu	刷新
nmv	2
nmw	收购价
nmx	2
nna	已获
nnb	发展阶段
nnc	2
nnd	发展成为
nne	层层加码
nnf	发展规划
nng	尸
nnh	忸
nni	发展水平
nnk	发展中国家
nnl	快车
nnm	居民购买力
nnn	忋
nno	书库
nnq	书包
nnr	快捷
nns	书本
nnt	书籍
nnu	局部
nnv	已婚
nnw	己任
nnx	已经
nny	㤈
nob	2
noc	2
noe	2
nog	㦠
noj	2
nok	2
nol	2
nom	2
non	慷慨
noo	憦
nop	2
noq	2
nor	2
nos	戂
not	2
nou	心烦意乱
nov	屡
npa	2
npb	2
npd	心神不安
npf	买空卖空
npg	心安理得
npi	2
npj	慏
npk	2
npl	居安思危
npn	避之惟恐不及
npo	2
npp	收容审查
npq	忱
npr	2
nps	㤖
npt	愘
npu	2
npv	2
npw	屄
npx	2
npy	发案率
nqa	怟
nqd	疏忽大意
nqe	惂
nqf	必然规律
nqg	以色列
nqh	2
nqi	恌
nqj	必然是
nqk	怐
nql	2
nqn	必然性
nqo	㥌
nqq	㞔
nqr	心狠手辣
nqs	2
nqv	
nqw	展销会
nqy	鸤
nra	㦻
nrb	忷
nrd	以势压人
nre	2
nrg	惶
nrh	㥴
nrl	2
nrm	以失败而告终
nrn	发扬民主
nro	2
nrp	2
nrq	惞
nrr	情报所
nrs	情报检索
nrt	局势稳定
nru	发挥着积极作用
nrv	2
nrw	发挥优势
nry	以提高经济效益为中心
nsb	2
nsc	尽可能地
nsd	屡禁不绝
nse	2
nsf	飞檐走壁
nsg	异想天开
nsk	2
nsl	2
nsm	2
nsn	敢想敢干
nsp	2
nsq	2
nsr	那样的
nss	飞机票
nst	书本知识
nsu	2
nsv	2
nsw	2
nsx	2
nsy	以权谋私
nta	改革
ntb	发出
ntc	性能
ntd	发布
nte	必须
ntf	屐
ntg	发现
nth	怍
nti	收入水平
ntj	愎
ntk	恪
ntl	属国
ntm	发财
ntn	属性
nto	屦
ntp	改写
ntq	改名
ntr	书生气
nts	发票
ntt	发生
ntu	发送
ntv	尽管如此
ntw	居委会
ntx	改组
nty	改变
nua	屏幕
nub	屏障
nuc	飞驰
nud	㞐
nue	憪
nuf	买卖
nug	㥃
nuh	悦目
nui	民意测验
nuj	习题
nuk	飞跃
nul	惮
num	2
nun	憧憬
nuo	2
nur	局部的
nus	收音机
nut	飞船
nuu	劈头盖脸
nuv	翣
nuw	居首位
nux	民间组织
nuy	发病率
nva	憳
nvb	2
nvc	怓
nvd	敢怒不敢言
nvf	翆
nvh	2
nvi	㥆
nvj	2
nvk	慨叹
nvm	2
nvo	2
nvq	2
nvr	2
nvs	恰好相反
nvu	2
nvv	心如刀绞
nvx	2
nvy	以退为进
nwa	居住区
nwc	恱
nwd	惟有
nwe	鹨
nwf	憏
nwg	愉
nwh	2
nwi	夬
nwj	忦
nwl	居全国首位
nwm	2
nwn	愉快
nwo	2
nwp	心领神会
nwr	惊人的成就
nws	恘
nwt	恰逢
nwv	恰好
nww	收件人
nwy	惟
nxb	必经阶段
nxc	2
nxd	尼龙
nxe	惯用
nxg	已经开始
nxi	情绪激昂
nxj	改弦易辙
nxk	2
nxl	2
nxm	2
nxo	2
nxp	必经之地
nxq	2
nxr	2
nxs	2
nxt	懝
nxu	导弹部队
nxw	惨绝人寰
nxx	已经引起了
nxy	已经充分证明
nya	民族工业
nyb	改变了
nyc	㤝
nyd	心愿
nye	尽力
nyf	民族地区
nyg	以下
nyh	以上
nyi	乄
nyj	心里
nyk	咫
nyl	民族团结
nyn	心
nyo	民族精神
nyp	心安
nyq	以免
nyr	以后
nys	民主权利
nyt	尽管
nyu	㣺
nyv	民主建设
nyw	以
nyx	民族经济
nyy	忄
oaa	烒
oac	剫
oad	煤耗
oae	粪肥
oaf	度过
oag	䉺
oah	烥
oai	广东省
oaj	度量
oak	火药味
oal	庿
oam	煤炭
oan	炬
oao	庶
oap	精英赛
oaq	炼铁
oar	烘托
oas	2
oat	烧香
oau	席间
oav	2
oaw	烘
oay	2
obc	2
obd	2
obe	2
obh	邩
obi	2
obj	2
obk	2
obl	2
obo	2
obp	2
obq	2
obr	2
obt	2
obu	2
obv	2
obx	庭院经济
oby	2
oca	序幕
ocb	2
occ	2
oce	㷁
ocf	2
och	2
ocj	2
ock	炲
ocl	2
ocn	序
oco	2
ocp	2
ocq	2
ocr	2
ocs	2
ocu	2
ocv	2
ocx	2
ocy	糔
oda	爄
odb	庆阳
odd	燎原
ode	煳
odf	广大干部群众
odg	䊀
odh	炐
odi	广大党员
odj	库存量
odk	烦躁
odl	2
odm	庆典
odn	应有尽有
odo	烣
odp	广大农村
odr	庞大的
ods	㢊
odu	燎
odv	庞杂
odw	广大人民群众
odx	类比
ody	应成为
oeb	粰
oec	2
oed	粗大
oee	焩
oeg	应用于
oeh	㶲
oek	2
oel	应用软件
oem	2
oen	火力发电厂
oeo	粗粮
oer	熎
oet	应用科学
oev	2
oew	粗俗
oey	精力充沛
ofa	燌
ofb	2
ofc	度过难关
ofd	糯
ofe	2
off	烓
ofg	庄严
ofh	㶥
ofj	2
ofk	爧
ofl	烤鸭
ofm	煵
ofn	燽
ofo	粗声粗气
ofp	䊦
ofr	2
ofs	2
oft	庄稼
ofv	2
ofw	庱
ofy	庒
oga	精巧
ogb	邺
ogc	庢
ogd	精确
oge	精力
ogf	广开才路
ogj	精明
ogk	精品
ogl	2
ogm	炳
ogn	业已
ogo	糟糕
ogp	精密
ogq	精锐
ogr	精兵
ogs	㶬
ogt	精简
ogu	黻
ogv	精灵
ogw	精华
ogx	精细
ogy	精良
oha	㢒
ohb	2
ohc	2
ohe	火上加油
ohf	2
ohg	2
ohi	火上浇油
ohk	店
ohn	2
oho	2
ohq	火眼金睛
ohr	2
ohs	2
ohu	2
ohv	2
ohw	2
oib	应承
oic	应能
oid	廉洁奉公
oie	应力
oif	广泛支持
oig	广泛开展
oii	广泛深入
oij	应当是
oik	2
oil	2
oin	广泛性
oip	糛
oiq	应负
oir	应邀
ois	应酬
oit	＋
oiv	2
oiw	应从
oix	2
oiy	应试
oja	数易其稿
ojc	2
ojd	火冒三丈
ojf	廛
ojg	炟
oji	㎏
ojj	爞
ojk	2
ojl	煴
ojm	㷒
ojo	糊里糊涂
ojp	2
ojq	㷎
ojs	㷄
ojt	焺
oju	火电站
ojv	燳
ojw	2
ojx	焜
ojy	燝
oka	2
okc	2
okd	2
okh	2
oki	2
okj	2
okk	焒
okl	2
okm	㶽
oko	2
okp	2
okr	燥热
oks	2
okt	2
oku	2
okv	2
okw	㡶
okx	2
ola	烟花
olb	2
old	库存
olf	烟雾
olg	煨
olh	䊫
olj	2
olk	庘
olm	2
olq	2
ols	焑
olu	火车头
olv	熡
olw	粉墨登场
olx	2
oma	燶
omb	2
omc	2
omd	火山灰
omg	腐败现象
omh	籼
omi	2
oml	2
omm	粣
omn	㢐
omq	2
omr	2
oms	2
omu	焹
omv	2
omw	腐败分子
omx	精雕细琢
omy	烿
ona	2
onb	废除
onc	2
ond	数以百计
onf	廜
ong	数以万计
onh	废旧
oni	废水
onj	麟
onk	断路
onm	2
onn	断层
ono	麒麟
onp	燃眉之急
onq	废铁
onr	熠
ont	废物
onu	熤
onw	炔
onx	废纸
ony	废话
ooa	火炬项目
oob	糭
ood	糖厂
oof	烾
oog	火速
ooh	敥
ooi	灯火辉煌
ooj	火星
ook	2
oon	爆炸性
ooo	焱
oop	靡靡之音
ooq	㷠
oor	火热
oot	火种
oou	炎症
oov	糠
oow	火候
oox	火线
ooy	火炬计划
opa	迷惑
opb	2
opd	庆祝大会
ope	㶶
opf	粽
opg	唐家璇
opi	庆祝活动
opj	熐
opk	熍
opm	熔岩
opo	熔炉
opp	数字视频
opq	焥
opr	迷失
ops	迷醉
opt	烢
opu	精神状态
opv	2
opw	数字化
opx	炨
opy	精神文明
oqa	粼
oqb	底子
oqc	2
oqd	庞然大物
oqe	廨
oqf	炮声
oqg	焕然一新
oqh	焔
oqi	庣
oql	2
oqn	庖
oqo	燃烧
oqp	2
oqq	底色
oqr	炮制
oqs	2
oqt	遴选
oqu	精锐部队
oqv	2
oqw	灼伤
oqx	底细
oqy	㶤
orb	烂摊子
orc	应邀参加
ord	应接不暇
ore	2
org	煌
orh	䉼
orj	广播电台
orl	摩托罗拉
orn	熂
oro	数据库系统
orp	2
orq	焮
orr	2
ort	数据处理
orv	2
orx	廏
ory	广播讲话
osa	2
osb	2
osd	粗枝大叶
ose	床边
osf	麻城
osg	磨灭
osh	灯具
osi	灯光
osj	䊤
osk	炣
osm	2
osn	2
oso	灯火
osp	2
osq	火树银花
osr	磨损
oss	磨
osu	麻痹
osw	麻袋
osx	麻纺
osy	炢
ota	广种薄收
otb	炧
otd	粉身碎骨
ote	烐
otf	庭
otg	熄灭
oth	熄
oti	庄稼汉
otj	2
otk	业务员
otl	烅
otm	炿
otn	籺
oto	烽火
otq	烙铁
ott	庭长
otu	业务部
otw	炸伤
otx	烸
oty	炇
oub	断章取义
ouc	2
oud	㡴
oue	精疲力尽
ouf	炓
oug	糕
oui	烂漫
ouj	燱
ouk	廍
oul	熷
oum	2
oup	2
our	摩拳擦掌
ous	精装本
out	2
ouu	粒状
ouv	劆
ouw	席卷全球
oux	焍
ova	燖
ovc	2
ovd	数码
ove	煺
ovf	数十
ovg	数万
ovh	数目
ovi	数学
ovj	数日
ovn	2
ovo	数度
ovp	数额
ovq	2
ovr	数控
ovs	2
ovt	灱
ovv	2
ovw	赓
owa	2
owb	腐化堕落
owc	炂
owd	粉碎
owe	业余爱好者
owf	府
owg	庩
owi	迷信活动
owj	庎
owk	2
own	糇
owp	2
owq	粉饰
ows	腐朽
owt	粉笔
owu	粉状
owv	㥹
oww	鹰
owx	粉红
owy	座谈
oxa	2
oxb	2
oxc	2
oxd	廎
oxf	2
oxg	2
oxi	纇
oxj	䊧
oxl	2
oxm	2
oxn	2
oxo	2
oxp	2
oxq	2
oxs	2
oxu	糑
oxx	粗纤维
oxy	2
oya	粮草
oyc	焴
oyd	广大
oye	庡
oyf	廊坊
oyg	炷
oyi	粮油
oyk	焞
oyl	粮田
oyn	煽
oyo	粮库
oyq	精讲多练
oyr	摩肩接踵
oys	粮棉
oyt	广告
oyu	广阔
oyv	廊
oyw	炕
oyy	灬
paa	空荡荡
pab	密切联系群众
pad	宽大
paf	密切协作
pag	赛事
pah	塞上
pai	农工党
paj	农艺师
pal	塞车
pam	㝤
pan	宽慰
pao	宽广
pap	宽裕
paq	字斟句酌
par	密切的联系
pas	密切配合
pat	赛程
pau	宽阔
paw	寨
pba	实际工作
pbb	军队院校
pbc	㝡
pbe	2
pbf	实际需要
pbg	突出表现
pbh	字眼
pbm	㝮
pbn	实际收入
pbo	2
pbp	2
pbr	实际操作
pbs	字根
pbt	实际行动
pbu	突出问题
pby	实际效果
pca	2
pcc	2
pcd	寄予厚望
pce	2
pcf	客观需要
pcg	客观事实
pci	灾难深重
pcj	2
pcl	2
pcm	2
pcn	客观性
pcp	客观实际
pcq	2
pcs	2
pct	客观条件
pcu	宻
pcv	2
pcw	2
pcy	宏观调控能力
pda	2
pdc	宏观
pdd	宏大
pde	宥
pdf	㝒
pdg	宽大政策
pdh	害
pdi	2
pdl	宏图
pdm	2
pdn	害怕
pdp	寄宿
pdq	豁然
pdr	割据
pds	密不可分
pdt	容不得
pdu	祸不单行
pdw	完成任务
pdy	割让
pea	农工
pec	2
ped	实力雄厚
pef	农场
peg	农事
pei	农学
pej	家用电器
pel	军用车辆
pem	2
pen	实用性
pep	宜宾
peq	补助金
per	实用技术
pes	农机
pet	农牧
peu	实用新型
pev	农奴
pew	农会
pey	实用主义
pfa	祸起萧墙
pfb	守卫
pfc	2
pfd	神志不清
pfe	冡
pff	实地考察
pfg	宗教政策
pfh	寘
pfi	守法
pfj	宗师
pfl	宗教团体
pfn	被动局面
pfo	2
pfp	实干家
pfq	冠
pfs	2
pft	宯
pfu	完善
pfw	宗教信仰
pfx	完毕
pfy	守望
pga	宝藏
pgb	写出
pgc	宝鸡
pgd	富有
pge	冢
pgf	㝉
pgg	定于
pgh	家具
pgi	军事演习
pgj	家电
pgk	家中
pgl	富国
pgm	室内
pgn	家属
pgo	宝库
pgp	富裕
pgq	室外
pgr	宣扬
pgs	定要
pgt	宇航
pgu	家门
pgv	宾至如归
pgw	家公
pgx	富强
pgy	定义
phc	2
phd	2
phf	官场
phg	寂静
phi	2
phj	2
phl	2
phm	寊
phn	逭
pho	2
phs	2
phw	官僚
phx	2
phy	官房
pia	2
pid	2
pif	宪法规定
pig	2
pih	2
pii	2
pil	2
pim	2
pin	2
pip	2
piq	2
piy	额满为止
pja	2
pjc	2
pje	2
pjf	2
pjg	寓于
pjl	2
pjm	䴁
pjo	宴席
pjp	审视
pjq	2
pjr	寓所
pjs	审核
pju	审美
pjw	定量分析
pjy	审议
pka	2
pkb	2
pkc	2
pkh	2
pki	2
pkk	实践中
pkl	2
pkq	察哈尔右翼前旗
pkr	宝贵的经验
pks	宲
pkt	初中生
pku	宝贵资源
pkw	2
pky	家喻户晓
pla	军工
plb	军队
plc	2
pld	军威
ple	军服
plg	军事
plh	农转非
pli	农田灌溉
plj	军师
plk	军史
pll	军车
plm	2
pln	军转民
plp	军容
plq	2
pls	军校
plt	祖国和平统一
plu	军阀
plv	寠
plw	军令
plx	军费
ply	军旅
pma	2
pmb	2
pmc	2
pmd	寷
pme	2
pmf	穿山越岭
pmh	2
pmi	2
pmm	2
pmn	2
pmo	2
pmp	2
pmr	2
pms	2
pmt	2
pmu	2
pmw	2
pmx	2
pmy	2
pna	突尼斯
pnd	密布
pne	蜜月
pnf	密云
png	富民政策
pnh	寤
pni	2
pnj	农民日报
pnk	2
pnl	寍
pnn	突发性
pnp	家属宿舍
pnq	农民负担
pns	密林
pnt	密
pnu	密闭
pnw	密集
pnx	密级
pny	密谋
poa	灾荒
pob	穿凿附会
poc	家庭矛盾
pod	家庭成员
pof	家庭教师
pog	农业政策
poi	2
poj	安度晚年
pok	2
pol	农业国
pom	家庭财产
pon	灾情
poo	2
pop	实业家
por	农业投入
pos	农业机械化
pot	农业生产
pou	冞
pov	㝩
pow	农业贷款
pox	家庭经营
poy	军火商
ppa	空军基地
ppb	宾客盈门
ppd	之三
ppe	农家肥料
ppf	之声
ppg	之下
pph	祖祖辈辈
ppj	2
ppk	之路
ppn	礼宾司
ppo	密密麻麻
ppp	冠军赛
ppq	之久
ppr	之势
pps	之极
ppt	安安稳稳
ppu	之间
ppw	被害人
ppy	富裕户
pqa	2
pqb	
pqc	2
pqd	额尔古纳
pqe	2
pqg	瓭
pqh	2
pqi	沊
pqj	2
pqk	寃
pql	2
pqo	2
pqp	冤案
pqq	额外负担
pqr	2
pqs	豁免权
pqt	2
pqu	安危冷暖
pqv	宛如
pqw	䧵
pqx	穿针引线
pqy	㝌
pre	2
prf	空白支票
prg	寒气逼人
prh	空白点
pri	神气活现
prj	2
prk	2
prm	2
prn	实质性
pro	2
prp	实打实
prs	穷凶极恶
prt	安排生产
pru	官兵关系
prv	2
prw	2
prx	冟
pry	寄希望于
psb	2
psc	2
psd	宁愿
pse	2
psf	宁城
psg	农村政策
psi	宁海
psk	2
psl	㿾
psm	2
pso	2
psq	穿梭外交
pss	审查核准
pst	宁德
psv	神机妙算
psx	宁乡
pta	农牧区
ptb	实行了
ptc	牢骚
ptd	客厅
pte	客服
ptf	客运
ptg	字处理
pth	㝰
pti	安徽省
ptk	客
ptl	牢固
ptm	2
ptn	实行改革
pto	额度
ptp	客家
ptq	神秘色彩
ptr	宪兵
pts	客票
ptt	客舱
ptu	军备竞赛
ptv	2
ptw	被告人
ptx	2
pty	被称为
pua	初期
pub	裤子
puc	裰
pud	褥
pue	实力
puf	宰
pug	裱
puh	补
pui	初学
puj	褐
puk	实践
pul	被困
pum	衲
pun	裾
puo	褛
pup	初审
puq	褐色
pur	褫
pus	襻
put	衽
puu	裥
puv	裙
puw	袱
pux	初级
puy	衤
pva	安葬
pvb	安阳
pvc	2
pvd	頞
pve	2
pvf	安南
pvg	安平
pvi	安溪
pvj	2
pvl	安国
pvm	2
pvn	安慰
pvo	安庆
pvp	安宁
pvq	安危
pvr	安丘
pvs	安检
pvt	安乐
pvu	案头
pvv	2
pvw	案件
pvy	安详
pwa	空
pwb	冗
pwc	社会矛盾
pwd	宿
pwe	社会力量
pwf	罕
pwg	窀
pwh	宏伟目标
pwi	社会治安综合治理
pwj	容易
pwk	窜
pwl	穷国
pwm	罕见
pwn	社会发展
pwo	窲
pwp	空军
pwq	穸
pwr	窳
pws	安全可靠
pwt	窄
pwu	㓁
pwv	窘
pww	窬
pwx	窈
pwy	社会主义
pxa	2
pxb	宆
pxd	2
pxe	2
pxf	2
pxg	㼠
pxj	2
pxk	补给品
pxl	2
pxm	2
pxn	2
pxo	2
pxq	2
pxs	2
pxt	守纪律
pxv	2
pxw	家乡人
pxx	2
pya	社区
pyb	审议了
pyc	审议通过
pyd	祓
pye	祝贺
pyf	㝘
pyg	祆
pyh	祉
pyi	礼堂
pyj	视野
pyk	祸
pyl	视图
pym	视同
pyn	冖
pyo	神庙
pyp	祝福
pyq	祧
pyr	㝑
pys	祸根
pyt	福利
pyu	禅
pyv	福建
pyw	礼仪
pyx	实施细则
pyy	宀
qaa	鉽
qab	名落孙山
qad	错落有致
qaf	错过
qag	钱其琛
qah	舛
qai	銾
qaj	错
qak	错鄂
qal	鑖
qam	鉔
qan	铽
qap	错案
qaq	多劳多得
qar	链式反应
qas	2
qat	匈牙利
qau	钄
qav	鍣
qaw	错位
qay	鈛
qba	夕阳工业
qbc	鋷
qbd	迎面
qbe	2
qbf	负隅顽抗
qbg	釨
qbh	卬
qbj	狼子野心
qbk	乌孜别克
qbl	盌
qbm	㠾
qbn	夗
qbo	2
qbp	迎宾
qbr	怨气
qbt	争取和平
qbu	迎着
qbv	妴
qbw	迎合
qbx	2
qby	钉子户
qcc	鎟
qce	銿
qcg	色素
qch	2
qci	色泽
qcj	2
qcm	2
qcn	针对性
qcp	2
qcs	2
qcv	2
qcw	鋑
qcy	色调
qda	䤻
qdb	危险
qdc	危难
qdd	锲而不舍
qde	鋹
qdf	铤而走险
qdg	鉐
qdh	钚
qdi	鱼龙混杂
qdj	匎
qdk	2
qdl	2
qdm	名不见经传
qdn	铁石心肠
qdo	2
qdp	名存实亡
qdq	铸铁
qdr	然后
qds	急不可耐
qdt	铸造
qdu	镢
qdv	2
qdw	犹太人
qdy	釱
qea	解散
qeb	触及
qed	触礁
qee	角膜
qef	锊
qeg	鈅
qeh	解
qei	解渴
qej	触电
qem	2
qep	多办实事
qeq	触角
qer	鎐
qet	釛
qeu	解闷
qev	鋖
qew	多边合作
qex	2
qey	解说
qfa	鐼
qfc	鈘
qfd	镇压
qfe	2
qff	急起直追
qfg	猛增到
qfh	㚈
qfi	銢
qfj	2
qfk	名震中外
qfl	鑟
qfn	鋕
qfp	镇宁
qfq	钱包
qfs	2
qft	铐
qfu	针头
qfv	2
qfw	外地人
qfx	针织
qga	鲽
qgb	印
qgc	鳋
qgd	鲅
qge	匍
qgf	鲮
qgg	鲆
qgh	钲
qgi	金碧辉煌
qgj	鲤
qgk	匐
qgl	鲢
qgm	鳢
qgn	鲺
qgo	鳙
qgp	独到之处
qgq	印象
qgr	留下的
qgs	金融机构
qgt	稣
qgu	鳝
qgv	鲻
qgw	鲶
qgx	铺张
qgy	鲂
qha	外区
qhb	钻孔
qhc	外观
qhd	钻研
qhe	外力
qhf	钻井
qhg	䤠
qhh	钁
qhi	外流
qhj	外景
qhk	外号
qhl	外界
qhn	外层
qho	2
qhp	饱眼福
qhq	外销
qhr	钻探
qhs	外相
qht	外科
qhu	外资
qhv	2
qhw	外人
qhx	外线
qhy	钋
qib	名誉院士
qic	2
qie	销毁
qif	名誉教授
qig	逃到
qih	覜
qii	金沙江
qij	留学归国人员
qik	逃跑
qim	销赃
qin	逃避
qio	2
qip	迩
qiq	逃逸
qir	多少年来
qis	名誉权
qit	留学生
qiu	淾
qiw	留学人员
qix	2
qiy	名誉主席
qjb	，
qje	2
qjf	贸易赤字
qjg	锝
qjh	鉮
qjj	亀
qjk	﹚
qjl	鎾
qjn	贸易壁垒
qjo	2
qjp	迿
qjq	铿锵
qjt	触景生情
qju	贸易总额
qjv	2
qjw	贸易保护主义
qjx	䥪
qjy	贸易谈判
qka	名著
qkb	免职
qkc	2
qkd	勉励
qke	劬
qkf	铁路运输
qkg	名列
qkh	钟
qki	名酒
qkk	锷
qkm	铞
qkn	免收
qko	㗮
qkp	名家
qkq	免
qkr	斪
qks	钟楼
qkt	名称
qku	名单
qkv	2
qkw	名优
qkx	勉强
qky	名义
qla	2
qlb	2
qld	锢
qle	2
qlf	锣鼓
qlg	犯罪事实
qli	狂轰滥炸
qll	包围圈
qlm	2
qln	錷
qlo	2
qlp	犯罪案件
qlq	镯
qlr	外国势力
qls	2
qlt	犯罪行为
qlu	2
qlw	犯罪分子
qly	外国语
qma	錪
qmc	2
qmd	负面
qme	镚
qmf	负起
qmg	铜
qmh	2
qmi	钢水
qmm	銏
qmn	鐹
qmp	2
qmq	钢锭
qmr	负担
qms	钢板
qmt	钢管
qmw	负债
qmx	2
qna	馍
qnb	饵
qnc	馂
qnd	饭碗
qne	馊
qnf	饽
qng	䦀
qnh	镅
qni	饱满
qnj	刨
qnk	饮品
qnl	乌黑
qnm	馈赠
qnn	钆
qno	饭店
qnp	包袱
qnq	饱
qnr	饩
qns	包机
qnt	饿
qnu	馐
qnv	饶恕
qnw	馀
qny	鈊
qoa	鏣
qob	魥
qoc	魣
qod	爒
qoe	鰀
qof	魭
qog	鑆
qoh	鮎
qoi	灳
qoj	鯣
qok	鱓
qol	鮂
qom	鮋
qon	印度尼西亚
qoo	鑅
qop	镂空
qoq	鏻
qor	鮊
qos	鯂
qot	魞
qou	镰
qov	镛
qow	魜
qox	鮄
qoy	銤
qpa	鑳
qpb	鳏寡孤独
qpc	2
qpd	名额有限
qpf	鋎
qpg	镓
qpi	2
qpj	2
qpk	2
qpm	2
qpn	鑏
qpq	多灾多难
qpr	金字招牌
qpt	逃之夭夭
qpu	2
qpv	铁案如山
qpw	镩
qpx	独家经营
qpy	鎺
qqa	金花
qqb	金子
qqc	铯
qqd	多达
qqe	多彩
qqf	多元
qqg	镥
qqi	铫
qqj	金星
qqk	金川
qqm	金刚
qqn	金属
qqo	金库
qqp	金额
qqq	鑫
qqr	多年
qqs	多样
qqt	多种
qqu	钧
qqv	多好
qqw	多个
qqx	勉勉强强
qqy	釸
qrb	胷
qrc	猴年马月
qrd	忽而
qre	甮
qrf	负担过重
qrg	多年来
qrh	釽
qri	铢
qrj	曶
qrk	铁器
qrl	铁轨
qrm	铁岭
qrn	匆忙
qro	2
qrp	铁窗
qrq	匆匆
qrr	鑕
qrs	锦西
qrt	乌拉特前旗
qru	银质奖
qrv	2
qrw	铁人
qrx	锦纶
qry	锦旗
qsa	䥮
qsc	2
qsd	争权夺利
qse	2
qsg	独树一帜
qsk	鎶
qsm	2
qso	䥔
qsp	留校察看
qsq	2
qsr	鑻
qst	2
qsu	2
qsv	2
qsw	多极化
qsx	2
qsy	锡林郭勒盟
qta	猫
qtb	猛
qtc	猱
qtd	犹
qte	猊
qtf	锤
qtg	狭
qth	独具
qti	狭小
qtj	狮
qtk	狷
qtl	猬
qtm	狈
qtn	勹
qto	锹
qtp	狩
qtq	狍
qtr	锇
qts	猜想
qtt	獯
qtu	獐
qtv	卿
qtw	猞
qtx	狴
qty	鉌
qua	外资项目
qub	镜子
qud	锩
que	鎆
quf	钭
qug	鉝
quh	2
qui	乌兰浩特
quj	锏
quk	锫
qul	独立国
qun	独立性
qup	独立富强
quq	多姿多彩
qus	包装材料
qut	独立自主
quu	解决问题
quv	鎌
quw	外资企业
qux	独立经营
qva	急切
qvb	争取
qvc	匓
qvd	迎刃而解
qve	急用
qvf	急需
qvg	键
qvh	皱
qvi	争当
qvk	银川
qvl	银团
qvm	鎻
qvn	釚
qvo	2
qvr	争气
qvs	银根
qvt	釖
qvu	银奖
qvv	儿媳妇
qvw	多媒体
qvy	争议
qwb	2
qwc	鈠
qwd	锻压
qwf	欠款
qwg	镎
qwh	鎀
qwi	鉩
qwj	狂风暴雨
qwk	孵化器
qwn	独创性
qwo	饮食业
qwp	铅字
qwq	多伦多
qwr	急人所急
qws	銝
qwt	铅笔
qwu	销售部
qwv	鵭
qww	欠佳
qwx	饱食终日
qwy	釟
qxb	2
qxc	2
qxd	2
qxe	2
qxf	鏆
qxg	䤸
qxh	鈟
qxi	锦绣河山
qxj	鉘
qxk	针织品
qxl	2
qxm	乌纱帽
qxn	2
qxo	2
qxp	2
qxr	2
qxx	钢丝绳
qya	鸟语花香
qyc	锍
qyd	多方面
qye	留用
qyf	久远
qyg	外交政策
qyh	鸟瞰
qyi	勺
qyj	留影
qyk	镐
qyl	岛国
qym	岛屿
qyn	岛
qyo	鸟类
qyp	外交官
qyq	贸然
qyr	外商投资
qys	2
qyt	卵
qyu	镝
qyv	贸
qyw	钪
qyx	留给
qyy	留言
raa	后勤工作
rab	找出
rad	制药厂
rae	撕毁
raf	迫切需要
rag	找到
rah	挋
rai	缺医少药
raj	摸
rak	掝
ral	披荆斩棘
ram	拒贿
ran	拣
rao	手工业
rap	描写
raq	捞钱
rar	手工操作
ras	描述
rat	搭乘
rau	反其道而行之
rav	找寻
raw	拱
rax	描绘
ray	措施
rba	插队落户
rbb	提出了
rbc	摄
rbe	2
rbf	报考
rbg	报表
rbh	㧄
rbi	扬子江
rbj	提出申请
rbk	凶器
rbl	报界
rbn	报以
rbo	报业
rbp	报案
rbq	报名
rbr	摄制
rbs	摘取桂冠
rbt	报告
rbu	报关
rbv	2
rbw	摄像
rby	报效
rca	反攻
rcb	瓜子
rcc	搡
rcd	反而
rce	㨢
rcf	反对者
rcg	反击
rch	反战
rci	反对党
rcj	瓜果
rck	反响
rcl	反思
rcn	皅
rco	瓜类
rcp	反之
rcq	返销
rcr	把手
rcs	返校
rct	反复
rcu	把关
rcv	2
rcw	择优
rcx	杀鸡给猴看
rcy	払
rda	扩大共识
rdb	扩大了
rdc	郄
rdd	扑面而来
rde	希腊
rdf	拜
rdg	撼
rdh	看不上眼
rdi	拔尖
rdj	掩映
rdk	看不顺眼
rdl	抚古思今
rdm	颀
rdn	拓展
rdo	推而广之
rdp	拓宽
rdq	挎包
rdr	所有制
rds	所有权
rdt	扩大生产
rdu	㚖
rdv	技压群雄
rdw	揍
rdx	抛砖引玉
rdy	希望
rea	揑
reb	拉肚子
rec	接受能力
red	捧腹大笑
ree	热腾腾
ref	搜索
reg	抈
reh	搜
rei	披肝沥胆
rek	拁
rel	搜罗
rem	2
ren	2
reo	授精
rep	拥军
req	援外
rer	拥护
res	搜查
ret	劧
reu	授奖
rev	援建
rew	摆脱贫困
rex	拉脱维亚
rfa	技艺
rfb	揭示了
rfc	技能
rfd	拔地而起
rfe	扶助
rff	挂
rfg	看起来
rfh	遁
rfi	反动派
rfj	擀
rfk	撷
rfl	接二连三
rfm	拷贝
rfn	技改
rfo	指示灯
rfp	按规定
rfq	挂钩
rfr	抗干扰
rfs	扶植
rft	年增长
rfu	年过半百
rfv	持刀
rfw	撵
rfx	质疑
rfy	持证
rga	后勤
rgb	卮
rgc	后台
rgd	掭
rge	捕
rgf	后者
rgg	后来
rgh	拉开战幕
rgi	热烈掌声
rgj	搬弄是非
rgk	捂
rgl	白天黑夜
rgm	拉开帷幕
rgn	后悔
rgo	拉开序幕
rgp	皇家
rgq	打击犯罪
rgr	后盾
rgs	拉开档次
rgt	后备
rgu	抨
rgv	后退
rgw	后代
rgx	后继
rgy	皇帝
rha	摅
rhb	排除
rhc	看台
rhd	年成
rhe	掯
rhf	年
rhg	看到
rhh	年龄
rhi	排污
rhj	年鉴
rhk	年中
rhl	年轮
rhm	看见
rhn	看书
rho	年度
rhp	看完
rhq	排印
rhr	看看
rhs	看样
rht	看待
rhu	年产
rhv	㨗
rhw	年会
rhx	年终
rhy	爬
ria	㦵
rib	热泪盈眶
ric	2
rid	抄袭
rie	推波助澜
rif	扮演者
rig	拘泥于
rii	泉水
rij	排水量
rik	振兴中华
rim	2
rio	2
rip	撑
riq	2
rir	搅拌
ris	反法西斯
rit	搅乱
riu	撑着
riv	抄录
riw	挡住
rix	鼄
riy	搞活市场
rja	㩧
rjb	提出
rjc	2
rjd	热电厂
rje	擝
rjf	捍
rjg	抇
rjh	抻
rji	提法
rjj	提早
rjl	揾
rjm	2
rjn	担忧
rjp	按时完成
rjq	担负
rjr	抓紧抓好
rjs	质量标准
rjt	批量生产
rju	提问
rjv	2
rjw	担任
rjx	提纯
rjy	提交
rka	操劳
rkb	扣除
rkd	接踵而至
rke	捐
rkf	损坏
rkg	失足青少年
rkh	拦路虎
rki	2
rkj	︶
rkk	捛
rkl	2
rkm	捐赠
rkn	扣发
rko	2
rkp	操守
rkq	鬼哭狼嚎
rkr	扣押
rks	拐棍
rkt	捐躯
rku	后遗症
rkv	2
rkw	损伤
rkx	操练
rky	拐弯
rla	2
rld	舞厅
rle	年轻力壮
rlf	畠
rlg	掴
rlh	捙
rll	攌
rlm	2
rln	扭转局面
rlo	2
rlp	摙
rlq	擉
rlr	摆手
rlu	舞姿
rlw	年轻化
rlx	捆绑
rma	缸
rmb	抽出
rmc	2
rmd	制成
rme	制服
rmf	制动
rmg	制表
rmh	帛
rmi	缺水
rmj	㓡
rmk	制品
rml	㩄
rmm	罁
rmn	皑
rmo	抽烟
rmp	抽空
rmq	缼
rmr	缺损
rms	抽样
rmt	缺乏
rmu	罐头
rmv	2
rmw	制作
rmx	罆
rmy	制剂
rna	搌
rnb	掘
rnc	所能
rnd	氪
rne	氮肥
rnf	拨款
rng	挧
rnh	据此
rni	气流
rnj	氲
rnk	擗
rnl	指导思想
rnm	所见
rnn	癿
rno	气度
rnp	撰写
rnq	排忧解难
rnr	扬
rns	气概
rnt	氡
rnu	㣻
rnv	拟建
rnw	抉
rnx	拨给
rny	抋
roa	扩散
rod	执迷不悟
roe	2
rof	失业者
roi	2
rol	2
rom	反腐败
ron	制度改革
roo	白炽灯
rop	搪塞
roq	撛
ros	攠
rot	㨩
rou	扩音
rov	搪
row	失业保险
rox	反应强烈
roy	失业率
rpa	迫切
rpb	探险
rpc	2
rpd	廹
rpe	按月
rpf	探索
rpg	近来
rph	据初步统计
rpi	挖潜
rpj	近日
rpk	探路
rpm	看守内阁
rpn	持之以恒
rpp	迫害
rpq	按键
rpr	控制
rps	打字机
rpt	控告
rpu	拒之门外
rpv	探寻
rpw	探
rpy	探望
rqa	朱镕基
rqb	皃
rqc	魁
rqd	抵达
rqe	魅力
rqf	挑起
rqg	撸
rqh	挑战
rqi	欣赏
rqj	据外电报道
rqk	拘
rql	抽象思维
rqm	气急败坏
rqn	兜
rqq	抱怨
rqr	抑制
rqs	的哥
rqt	抵御
rqu	抱歉
rqv	挥金如土
rqw	换代
rqy	捣
rra	抓获
rrb	打扫卫生
rrc	皈
rrd	白面
rre	折腾
rrf	掀起
rrg	㿟
rrh	抙
rri	白酒
rrj	抓紧
rrk	踅
rrl	手推车
rrn	白昼
rro	拼搏精神
rrp	扎扎实实
rrq	魄
rrr	拍摄
rrs	拍板
rrt	控制系统
rru	据报道
rrv	年年如此
rrw	扫描仪
rrx	白费
rry	誓
rsa	打工
rsb	技术职称
rsc	技术难关
rsd	技术研究
rse	技术力量
rsf	技术支持
rsg	打开
rsh	技术上
rsi	打法
rsj	揸
rsk	技术员
rsl	刹车
rsm	打败
rsn	技术发展
rso	打断
rsp	打字
rsq	打包
rsr	技术推广
rss	技术档案
rst	打入
rsu	技术咨询
rsv	打杂
rsw	技术创新
rsx	手榴弹
rsy	技术交流
rta	手工
rtb	播出
rtc	白条鸡
rtd	挢
rte	手脚
rtf	挺
rtg	手表
rth	擤
rti	年利润
rtj	托里
rtk	手足
rtl	插图
rtm	看得见
rtn	扬长避短
rto	揪
rtp	搬家
rtr	手指
rts	手机
rtt	
rtu	白血病
rtv	捼
rtw	招待会
rtx	反复强调
rty	敀
rua	拉萨
rub	批准了
ruc	年产能力
rud	掷
rue	拉力
ruf	投资者
rug	拌
ruh	手疾眼快
rui	投资渠道
ruj	揞
ruk	接口
rul	接轨
rum	接见
run	接收
ruo	接应
rup	提前完成
ruq	投资银行
rur	拼搏
rus	拉丁
rut	接待
ruu	拉美
ruv	搛
ruw	拼命
rux	接线
ruy	投资商
rva	热切
rvb	扫除
rvc	揤
rvd	势如破竹
rve	热爱
rvf	招远
rvg	热烈
rvi	热潮
rvj	执照
rvk	招呼
rvm	热贴
rvn	扏
rvo	热度
rvp	热裤
rvq	抛锚
rvr	热气
rvt	捃
rvu	热闹
rvw	抛售
rvx	招引
rvy	热
rwa	失落
rwb	推出
rwc	操作台
rwd	ァ
rwe	反作用
rwf	推动
rwg	拴
rwh	失眠
rwi	扮演
rwj	失明
rwk	失踪
rwl	反侵略战争
rwm	推崇
rwn	指令性计划
rwo	失业
rwp	失窃
rwq	扎伊尔
rwr	近几年来
rws	投标
rwt	操作系统
rwu	投资
rwv	掰
rww	投保
rwx	あ
rwy	推
rxa	旣
rxb	指出
rxc	兵强马壮
rxd	提纲挈领
rxe	白细胞
rxf	指示
rxg	指责
rxi	批注
rxj	拂
rxk	摾
rxl	白纸黑字
rxn	指导
rxq	指名
rxr	指控
rxs	操纵杆
rxt	批复
rxu	批准
rxw	按比例
rxx	揩
rxy	据统计
rya	提高工作效率
ryb	撤出
ryc	㧤
ryd	掠夺
rye	挔
ryf	抗震
ryg	护理
ryh	制高点
ryi	抗洪
ryj	抗日
ryk	掠
ryl	撤回
rym	2
ryn	掮
ryo	2
ryp	抗灾
ryq	抗争
ryr	提高质量
rys	据调查
ryt	㧍
ryu	抗病
ryv	撤退
ryw	掖
ryx	搐
ryy	投放市场
saa	模式
sab	棋子
sac	概莫能外
sad	椹
sae	橵
saf	杢
sag	框
sah	枒
sai	松花江
saj	横竖
sak	横跨
sal	西欧国家
sam	横幅
san	枻
sao	核工业
sap	横穿
saq	杠铃
sar	模拟
sas	模样
sat	横向
sav	櫹
saw	株式会社
sax	本世纪末
say	㭶
sba	本职工作
sbb	极限
sbc	棷
sbd	极大
sbe	极力
sbf	极坏
sbg	栮
sbh	䢶
sbi	㮀
sbk	2
sbn	㭯
sbp	2
sbq	2
sbr	可耻的下场
sbt	相联系
sbu	极差
sbw	杰出代表
sbx	2
sby	极为
sca	相对落后
scb	橘子
scc	槡
scd	相对而言
sce	权力
scf	柽
scg	相对来说
sch	2
sci	2
scj	2
sck	检验员
scm	2
scn	懋
sco	2
scp	2
scs	树林
sct	树种
scu	权益
scv	2
scw	可能会
scx	2
scy	杈
sda	配套工程
sdb	杯子
sdc	柭
sdd	㰁
sde	栯
sdf	可耕地
sdg	柘
sdh	楔
sdj	要不是
sdl	2
sdm	顶峰
sdn	配套改革
sdq	要不然
sdr	配套技术
sds	极有可能
sdt	要不得
sdu	橛
sdv	2
sdw	椿
sdx	顶级
sdy	杕
sea	檓
seb	棴
sec	2
sed	2
see	栛
sef	㭩
seg	枂
seh	㯒
sel	2
sem	2
sen	2
seo	2
seq	棿
ser	榣
ses	棌
set	朸
seu	㮳
sey	2
sfa	桂花
sfb	村子
sfc	枟
sfd	票友
sff	垔
sfg	甄
sfh	植
sfi	标
sfj	标明
sfk	核武器
sfl	机动车
sfn	村民
sfo	村庄
sfp	桂冠
sfq	飘逸
sfr	标兵
sfs	桂林
sft	栲
sfu	标准
sfw	植保
sfx	杜绝
sfy	标识
sga	醛
sgb	相互了解
sgc	桎
sgd	酉
sge	本月
sgf	酝
sgg	酾
sgh	西
sgi	西湖
sgj	梗
sgk	酲
sgl	配置
sgm	柄
sgn	朽
sgo	桠
sgp	西安
sgq	杌
sgr	本报
sgs	酝酿
sgt	酶
sgu	枰
sgv	桱
sgw	醮
sgx	酵母
sgy	醇
sha	榩
shb	相隔
shc	相通
shd	相左
she	相貌
shf	相干
shg	杫
shh	欔
shi	想法
shj	相遇
shk	禁止吸烟
shl	可卡因
shm	相同
shn	栌
shp	相视
shq	核战争
shr	相近
shs	想要
sht	相处
shu	相差
shv	2
shw	相似
shx	相继
shy	相识
sia	枯水期
sib	2
sif	飘洋过海
sig	桄
sih	2
sik	柏油路
sio	极少数人
sip	档案
siq	想当然
sir	想当年
sis	顶梁柱
sit	核潜艇
siu	相当普遍
siv	西沙群岛
siw	2
six	2
sja	柳暗花明
sjb	棍子
sjc	查对
sjf	覃
sjg	机遇与挑战
sjh	柛
sji	榥
sjj	椙
sjk	2
sjl	槾
sjo	2
sjq	㭿
sjr	要坚持
sjs	查禁
sjt	榄
sju	查阅
sjv	2
sjw	2
sjx	栧
sjy	查证
skb	可取
skc	可观
skd	可不
ske	可爱
skf	可喜
skg	可恶
skh	可悲
skj	歌星
skk	可贵
skl	2
skm	歌曲
skn	可恨
skq	㰤
skr	歌手
sks	歌
skt	可行
skw	机器人
skx	可疑
sky	可望
slb	2
slc	2
sld	棝
slf	檡
slg	椭圆形
slh	檌
sli	2
slj	2
slk	2
sll	欙
slm	2
slo	2
slp	槤
slq	㯮
slr	2
slt	棞
slu	2
slw	榲
sma	檂
smc	2
smd	椯
smf	柟
smg	桐
smi	可见光
smj	2
smk	2
sml	2
smm	樱
smn	楇
smo	2
sms	桐柏
smt	2
smu	棡
smv	2
smw	梣
smy	枬
snb	㐉
snd	可以达到
sng	可以理解
snh	朻
sni	榍
snk	檘
snl	2
snm	2
snn	杞
sno	2
snr	核心技术
sns	杨树
snt	柲
snu	榌
snw	可以休矣
sny	可以说
soa	櫎
sob	㯶
sod	林业厅
soe	2
sof	枯燥无味
sog	檏
soh	2
soi	2
sok	2
sol	2
som	2
son	可燃性
soo	橩
soq	㭽
sor	㯅
sos	楼梯
sot	枯燥乏味
sou	粟
sov	楼群
sow	椨
soy	楼主
spa	2
spc	2
spd	槣
spe	椬
spf	朴实无华
spg	椗
spi	2
spj	榠
spl	楎
spm	2
spn	相容性
spo	2
spp	权宜之计
spq	档案馆
sps	检察机关
spt	楁
spu	榟
spw	榨
spy	西宁市
sqa	桃花
sqb	栁
sqc	栬
sqd	檐
sqe	槲
sqg	西乌珠穆沁旗
sqh	2
sqi	桃源
sqj	2
sqk	枸
sql	构图
sqo	櫯
sqp	2
sqr	楤
sqs	桃李
sqt	构造
sqv	棦
sqw	杜尔伯特
sqx	2
sqy	杓
sra	板式
srb	板子
src	柧
srd	歌舞厅
sre	㭛
srf	根据地
srg	栀
srh	杽
sri	株洲
srj	蜤
srk	2
srl	棉田
srm	㰃
srn	概括性
sro	核反应堆
srp	棉袄
srq	模拟键盘
srr	樊
srs	板材
srt	歌舞升平
sru	攀亲
srv	2
srw	可操作性
srx	棉纺
sry	柝
ssa	禁区
ssb	根本出路在于
ssc	2
ssd	根本原因
sse	禁用
ssf	林场
ssg	禁毒
ssh	禁止
ssi	桃李满天下
ssj	木星
ssk	木器
ssl	榃
ssm	梦见
ssn	根本性
sso	麓
ssp	村村寨寨
ssq	禁锢
ssr	机械手
sss	木
sst	植树造林
ssu	林立
ssv	栩栩如生
ssw	棼
ssx	梦幻
ssy	机械设备
sta	☆
stb	格子
std	栝
ste	梅县
stf	杵
stg	想得到
sth	想入非非
sti	植物油
stj	梸
stk	枝繁叶茂
stl	覆辙
stm	栴
stn	可靠性
sto	相适应
stp	可乘之隙
stq	杯盘狼藉
str	2
sts	醉生梦死
stt	本科生
stu	覆盖
stw	机务段
stx	本系统
sty	柇
sua	西装革履
sub	样子
sud	覆盖面
sue	椾
suf	西北地区
sug	柆
suh	顶头上司
sui	栤
suj	标准时
suk	样品
sul	机关团体
sum	2
sun	可塑性
suq	西北角
sur	相关技术
sus	榇
sut	楌
suu	西北部
suv	槏
suw	本单位
sux	样张
suy	极端主义
sva	樳
svb	根子
svc	楖
sve	概貌
svf	要地
svg	要求
svh	要目
svi	根源
svj	要紧
svk	柖
svl	椔
svm	2
svo	根底
svp	要案
svq	桚
svr	概括
svs	要想
svt	要么
svu	要闻
svv	榋
svw	要人
svy	概论
swa	机工
swb	枞阳
swc	检验
swd	机耕
swe	2
swf	机场
swg	栓
swh	机具
swi	检举
swj	机电
swk	枪口
swl	松软
swm	2
swn	槌
swo	枪炮
swp	机密
swq	橙色
swr	机制
sws	检查
swt	机身
swu	检疫
swv	机灵
sww	枞
swx	机组
swy	朲
sxa	2
sxb	2
sxc	2
sxd	相比而言
sxf	－
sxg	梯级开发
sxi	2
sxj	柫
sxm	2
sxn	杛
sxo	2
sxq	2
sxr	檰
sxs	楷模
sxt	2
sxu	核弹头
sxv	2
sxw	机组人员
sxx	枇
sxy	㭃
sya	校花
syb	柱子
syc	核试验
syd	校友
sye	西方舆论界
syf	校址
syg	校正
syh	2
syk	椋
syl	檩
syn	核心
syo	〢
syp	核实
syq	橠
syr	西方的价值观
sys	⑾
syt	校长
syu	榜首
syv	本该如此
syw	杭
syx	核弹
syy	术语
taa	各项工作
tab	升降
tac	2
tad	簸
tae	升腾
taf	长城
tag	箧
tah	篚
tai	长沙
taj	繁荣昌盛
tak	笸
tal	䅦
tam	篝
tan	长期性
tao	长度
tap	升空
taq	长久
tar	长年
tas	升格
tat	长期稳定
tau	长期斗争
tav	彻
taw	筮
tax	私营经济
tay	牫
tbb	㐌
tbd	向隅而泣
tbe	2
tbf	䇯
tbg	翻了一番
tbh	自卫战争
tbi	篜
tbk	2
tbl	2
tbm	笜
tbn	䄬
tbo	等出席
tbp	迤
tbr	得出的
tbs	自卫权
tbt	透彻
tbu	透着
tbw	透风
tbx	2
tby	透亮
tca	私营
tcb	私了
tcc	智勇双全
tcd	知难而进
tcf	径直
tcg	私下
tch	2
tcj	2
tck	秮
tcl	2
tcm	2
tcn	私心
tco	2
tcp	2
tcq	2
tcr	敌对势力
tct	私利
tcu	私立
tcw	智能化
tcy	很难说
tda	矩
tdb	造成了
tdc	敌对
tdd	科研成果
tde	智力
tdf	重大进展
tdg	秙
tdh	第三步
tdi	籍
tdj	刮
tdk	知
tdl	笼罩
tdm	辞典
tdn	稽
tdo	适度
tdp	适宜
tdq	鸹
tdr	重大的
tds	科研机构
tdt	筹
tdu	辞
tdv	辞退
tdw	矬
tdx	矧
tdy	知识
tea	艨
teb	艋
tec	舥
ted	盘古
tee	艘
tef	智力支持
teg	䄴
teh	船上
tei	艄
tej	艒
tek	舯
tel	稻田
tem	舢
ten	务必
teo	艔
tep	笾
teq	租金
ter	竻
tes	舾
tet	牞
teu	艏
tev	舠
tew	船
tex	航线
tey	舫
tfa	特区
tfb	选取
tfc	移动通信
tfd	
tfe	选用
tff	玍
tfg	特殊
tfh	㸩
tfi	科教兴国
tfj	竿
tfk	造
tfl	德国
tfm	选购
tfn	毯
tfo	第二炮兵
tfp	迁
tfq	选
tfr	先后
tfs	选票
tft	先生
tfu	穑
tfw	奥运会
tfx	等级
tfy	告诉
tga	管理工作
tgb	第一阶段
tgc	重叠
tgd	重大
tge	管理办法
tgf	行动
tgg	行政
tgh	惩
tgi	物理学
tgj	穗
tgk	衙
tgl	甥
tgm	箦
tgn	征收
tgo	行业
tgp	行家
tgq	行销
tgr	管理制度
tgs	秣
tgt	＿
tgu	生产
tgv	重建
tgw	每一个
tgx	第一线
tgy	征文
tha	重点工程
thb	鼻子
thc	怎能
thd	臭
the	延边
thf	䇛
thg	䄳
thh	衢
thi	算法
thj	算是
thk	牌号
thl	劓
thm	彼岸
thn	自己
tho	延庆
thp	延安
thq	自销
thr	自制
ths	版本
tht	自身
thu	自尊
thv	重点建设
thw	延伸
thx	自强
thy	自豪
tia	毛泽东
tib	臭小子
tic	短波通信
tid	稍有
tie	筲
tif	科学地
tig	衍
tih	重温旧梦
tii	长江流域
tij	篞
tik	长江口
til	生活困难
tim	科学内涵
tin	自觉性
tio	微波炉
tip	科学实验
tiq	长治久安
tir	科学技术
tis	航海模型
tit	香港特别行政区
tiu	科学普及
tiv	血流如注
tiw	科学化
tix	选举结果
tiy	长沙市
tja	身临其境
tjb	得了
tjd	乍暖还寒
tje	得力
tjf	微量元素
tjg	筛
tjh	馡
tji	利润
tjj	馤
tjk	得逞
tjl	利国
tjn	复发
tjo	透明度
tjp	复赛
tjq	得名
tjr	得失
tjs	稞
tjt	犁
tju	利益
tjv	千里迢迢
tjw	得分
tjx	箟
tjy	复议
tka	积蓄
tkb	各队
tkd	积压
tke	和县
tkf	㕿
tkg	程
tkh	㸪
tki	特别注意
tkj	和煦
tkk	和顺
tkl	积累
tkm	筼
tkn	和局
tko	各类
tkp	复员军人
tkq	各色
tkr	和气
tks	种植
tkt	各自
tku	和亲
tkv	种群
tkw	雒
tkx	特别强调
tky	和谈
tla	自圆其说
tlb	血防
tlc	笝
tld	甶
tle	血腥
tlf	盉
tlg	箅
tli	血汗
tlk	备足
tll	䉪
tlm	簤
tln	衄
tlo	备料
tlp	备案
tlq	囱
tlr	我国的
tls	管辖权
tlt	第四季度
tlu	积累资金
tlv	备好
tlw	备份
tlx	血缘
tly	备课
tma	身世
tmb	向阳
tmd	射
tme	行贿受贿
tmf	稠
tmg	牰
tmh	身上
tmi	微小
tmj	㟀
tmk	靠山吃山
tml	秧田
tmm	微山
tmn	向导
tmo	微粒
tmp	稠密
tmq	笕
tmr	向后
tms	向西
tmt	奥秘
tmu	向前
tmv	微妙
tmw	身份
tmx	微弱
tmy	身高
tna	物尽其用
tnb	乐队
tnd	黎民百姓
tne	知心朋友
tnf	特快专递
tng	乐于
tnh	犌
tni	自民党
tnk	徫
tnl	乐园
tnm	乐山
tnn	䄫
tno	乐业
tnp	秘密
tnr	税收制度
tns	徇情枉法
tnt	秘书长
tnu	乐章
tnw	身心健康
tnx	身怀绝技
tny	各民主党派
toa	䉀
tob	䣋
toc	适应能力
tod	行业不正之风
toe	延庆县
tof	秋雨
tog	翻开
toh	2
toi	循序渐进
toj	稥
tol	番
tom	㡑
ton	悉
too	彻底粉碎
toq	秋色
tor	秋后
tot	翻番
tou	翻阅
tov	媝
tow	翻修
tox	彻底结束
toy	翻译
tpa	知之甚多
tpb	牸
tpc	2
tpd	重视不够
tpe	秾
tpf	先富起来
tpg	管理
tph	稳定上升
tpi	航空学院
tpj	䈿
tpk	垂帘听政
tpl	私家车
tpm	2
tpn	稳定局势
tpr	航空兵
tps	笑容可掬
tpt	稽察特派员
tpu	管道
tpw	航空公司
tpx	航空母舰
tpy	簶
tqa	彽
tqb	自负盈亏
tqd	奥尔布赖特
tqe	稳妥
tqf	移栽
tqg	物理
tqi	物流
tqj	衡量
tqk	称号
tql	稳固
tqn	重金属
tqo	物料
tqp	自然灾害
tqq	物色
tqr	笏
tqs	复印机
tqt	黧
tqu	自然资源
tqv	筝
tqw	物体
tqx	䆋
tqy	移交
tra	箝
trb	我院
trc	筢
trd	科技成果
tre	科技力量
trf	科技进步
trg	䄸
trh	㸫
tri	科技兴农
trj	程控电话
trk	复制品
trl	科技界
trm	物质财富
trn	科技情报
trp	选拔赛
trq	籀
trr	我所
trs	我校
trt	科技管理
tru	科技奖
trv	2
trw	我们
trx	鹅
try	程控交换机
tsa	重要贡献
tsb	条子
tsc	很可能
tsd	积极态度
tsf	＾
tsg	徆
tsh	㣔
tsi	䈾
tsj	重要影响
tsk	笴
tsl	积极因素
tsm	条幅
tsn	重要性
tsp	䉘
tsq	籕
tsr	积极的
tss	重要标志
tst	重要条件
tsu	重要意义
tsv	2
tsw	条例
tsx	重要组成部分
tsy	重要讲话
tta	牧区
ttb	牛鼻子
ttc	积重难返
ttd	篷
tte	笑脸
ttf	牦
ttg	
tth	笮
tti	长篇小说
ttj	往往是
ttk	笔顺
ttl	丿
ttm	䉠
ttn	夂
tto	各种类型
ttp	自我完善
ttq	笔名
ttr	短短的
tts	息息相关
ttt	彳
ttu	特等奖
ttv	自身建设
ttw	管委会
tty	秝
tua	生产工艺
tub	生产队
tuc	重头戏
tud	生产厂家
tue	生产力
tuf	科
tug	剩下
tuh	生产上
tui	简洁
tuj	螽
tuk	简史
tul	乘车
tun	向前发展
tup	科室
tuq	得道多助
tur	科技
tus	乘机
tut	税务
tuu	简单
tuv	乐善好施
tuw	简便
tux	剩
tuy	税率
tva	复杂劳动
tvb	2
tvc	穊
tvd	稳如泰山
tve	簋
tvf	很坏
tvg	犍
tvi	很少
tvj	很早
tvk	委员
tvl	犣
tvm	2
tvn	复杂性
tvp	重建家园
tvq	很久
tvr	复杂的
tvs	2
tvt	很重
tvu	怎好意思
tvv	委婉
tvw	复杂化
tvx	很弱
tvy	征婚启事
twa	剩余劳动力
twb	行使职权
twc	我们欢迎
twd	我们有
twe	身体力行
twf	各个地区
twg	答
twh	物价上涨
twi	黍
twj	答题
twk	长途跋涉
twl	我们国家
twm	长途贩运
twn	签发
two	答应
twp	签字
twq	每分钟
twr	我们希望
tws	我们相信
twt	生命科学
twu	筹集资金
twv	処
tww	各个领域
twx	生命线
twy	稔
txa	第七
txb	入乡随俗
txc	2
txd	敏感
txe	每月
txf	第十
txg	第一
txh	䇙
txi	各级党委
txj	利比里亚
txl	各级团组织
txm	䈫
txn	繁忙
txq	敏锐
txr	每年
txt	敏
txu	每次
txv	繁杂
txw	系统集成
txx	秕
txy	毓
tya	特效药
tyb	自谋职业
tyc	勶
tyd	千方百计
tyf	入境
tyg	往来
tyh	入睡
tyi	汆
tyj	往里
tyk	篙
tyl	往回
tym	入内
tyn	犏
tyo	入库
typ	简言之
tyq	入狱
tyr	入手
tys	笔记本电脑
tyt	牥
tyu	知识产权保护
tyv	备忘录
tyw	各族人民
tyx	自主经营
tyy	德高望重
uaa	辛勤劳动
uab	并联
uac	瓶颈
uad	并不
uae	并用
uaf	并未
uag	冮
uah	冴
uai	并举
uaj	竎
uak	瘽
ual	新世界
uam	奠基典礼
uan	并发
uap	痨
uaq	㿃
uar	并按
uas	新花样
uat	总工程师
uau	并立
uav	剙
uaw	总工会
uax	冻结
uay	并请
ubb	2
ubc	2
ubd	普降大雨
ube	凝聚力
ubf	普及教育
ubg	普降瑞雪
ubh	问及此事
ubi	逆流
ubk	疖
ubp	立陶宛
ubq	闻名
ubr	2
ubt	逆
ubu	逆差
ubw	新陈代谢
ubx	2
uby	普及率
uca	痛苦
ucc	䦤
ucd	美观大方
ucf	闯进
ucg	闯
uch	2
ucj	2
uck	痛哭
ucl	2
ucm	2
ucn	痛快
uco	凴
ucp	2
ucq	冶金
ucr	痛斥
uct	闯入
ucu	疤痕
ucw	竣
ucx	2
ucy	普通话
uda	关切
udb	郑
udc	决不能
udd	㽽
ude	头脑
udf	状元
udg	㓈
udh	痞
udi	
udj	并不是
udk	减员
udl	送回
udm	卷曲
udn	关心
udo	准确度
udp	闼
udq	关键
udr	瓣
uds	辣椒
udt	意大利
udu	状况
udv	减退
udw	决不会
udx	送给
udy	辩
uea	前世
ued	前面
uee	剪彩
uef	前进
ueg	前来
ueh	痈
uei	瘦小
uej	剪
uek	痂
uem	剪贴
uen	头脑发热
ueo	前座
uep	阌
ueq	前夕
uer	前后
ues	2
uet	前身
ueu	㒸
uev	剪刀
uew	瘐
uex	剪纸
uey	前言
ufa	辛苦
ufb	养老院
ufc	养鸡
ufd	䦌
ufe	新老用户
uff	痔
ufg	养殖
ufh	竍
ufi	冰雪消融
ufj	凌晨
ufk	閈
ufl	装车
ufm	美元贬值
ufn	痣
ufo	㸉
ufp	凌空
ufq	斗争
ufr	装卸
ufs	装机
uft	装备
ufu	关起门来
ufv	半封建
ufw	凌
ufx	首都经济
ufy	养育
uga	羡慕
ugb	着陆
ugc	羧
ugd	闩
uge	瘃
ugf	美元
ugg	善于
ugh	着
ugi	美学
ugj	判
ugk	癞
ugl	阑
ugm	羰
ugn	翔
ugo	羔
ugp	美军
ugq	羝
ugr	
ugs	着想
ugt	着重
ugu	羡
ugv	凄
ugw	病人
ugx	痍
ugy	美方
uha	㿖
uhc	站台
uhd	痱
uhe	2
uhg	前些天
uhh	着眼点
uhi	2
uhj	并非易事
uhk	䇂
uhn	㾎
uho	2
uhp	2
uhq	送旧迎新
uhr	冷战后
uhs	冷眼相看
uht	疲惫
uhu	阔步前进
uhw	新旧体制
uhx	冷战结束后
uhy	新旧交替
uia	首当其冲
uic	2
uid	资源丰富
uie	䇌
uif	普法教育
uig	冰球
uih	2
uii	㽷
uij	2
uik	阔叶
uil	产油国
uim	冰雕
uip	闛
uir	前清后欠
uis	冰柜
uit	冰箱
uiu	冰冷
uiv	2
uix	2
uiy	立党为公
uja	章节
ujb	间隙
ujc	2
ujd	意愿
uje	尊师爱生
ujf	章
ujg	音速
ujh	头晕目眩
uji	痋
ujj	问题是
ujk	意味
ujl	意思
ujm	韶山
ujn	童心
ujo	前景广阔
ujp	阅览室
ujq	竭
ujr	童年
ujs	㾧
ujt	意向
uju	韶关
ujv	间杂
ujw	新时代
ujy	意义
uka	总共
ukb	部队
ukc	总能
ukd	总厂
uke	冲毁
ukf	总裁
ukg	总理
ukh	总督
uki	总汇
ukj	问题
ukk	闾
ukl	新中国
ukm	总帐
ukn	总局
uko	产品数量
ukp	总额
ukq	竞
ukr	兑换
uks	剖析
ukt	新品种
uku	总部
ukw	总体
ukx	总结
uky	冲剂
ula	兽医
ulb	部署了
ulc	2
uld	曾在
ule	曾用
ulf	单干
ulg	痹
ulh	2
ulj	曾
ulk	閳
ull	美国国务卿
ulm	2
uln	曾以
ulp	前车之鉴
ulq	单色
ulr	单打
uls	单机
ult	单身
ulu	单产
ulw	单个
ulx	曾经
uly	曾为
uma	癑
umb	2
umc	2
umd	㾄
ume	㾶
umf	㾆
umg	凒
umi	閴
umj	2
umk	閊
uml	2
umn	意见书
ump	2
umq	2
umr	2
ums	2
umt	意见和要求
umu	弊病
umv	2
umw	端坐
umx	2
umy	凋谢
una	首发式
unb	决出
und	新局面
ung	新发现
unh	决战
uni	半壁江山
unj	2
unk	决口
unm	2
unn	决心
unp	决赛
unq	前怕狼后怕虎
unr	关心的
uns	2
unt	总收入
unu	并发症
unv	关心群众
unw	瘳
uny	总书记
uoa	塑料薄膜
uob	普陀
uoc	判断能力
uod	塑料厂
uog	产业政策
uoh	2
uoi	疢
uoj	普照
uok	2
uom	2
uon	2
uoo	资料库
uop	资料完整
uoq	2
uor	塑料制品
uot	2
uou	普兰
uow	产业集团
uox	病魔缠身
uoy	普京
upa	2
upb	决定了
upc	2
upe	竩
upf	冲突地区
upg	2
uph	䦡
upi	新安江
upl	痛定思痛
upm	2
upn	决定性
upq	㽸
ups	决赛权
upt	差额选举
upv	2
upw	决定作用
upx	㾃
upy	2
uqa	将其
uqb	养儿防老
uqc	竞争能力
uqd	㾣
uqe	资助
uqf	竞争者
uqg	凎
uqh	头昏眼花
uqi	资源
uqj	关键时刻
uqk	瓷器
uqm	资金周转
uqn	关键性
uqo	次数
uqp	盗窃
uqq	奖金
uqr	)
uqs	桨
uqt	〓
uqu	曾多次
uqv	竫
uqw	次
uqx	2
uqy	疚
ura	总后勤部
urb	2
urc	㽿
urd	新的历史条件下
ure	意气用事
urf	闻所未闻
urg	总的来说
uri	闎
url	2
urn	新年快乐
uro	2
urp	2
urq	瘣
urr	总指挥部
urs	新技术产业
urt	间接税
uru	总投资额
urv	兿
urw	意气风发
urx	2
ury	总的说来
usa	新药
usb	闲聊
usd	新春
use	新股
usf	新增
usg	遵
ush	亲眼
usi	新兴
usj	新星
usk	閅
usl	美术界
usn	新书
usp	奠定
usq	新鲜
usr	新的
uss	半机械化
ust	尊重
usu	新闻
usv	新娘
usw	新华
usx	新颖
usy	资本市场
uta	产区
utb	产出
utc	道德观念
utd	痴
ute	閁
utf	首都
utg	关系到
uth	道
uti	产生深远影响
utj	产量
utk	产品
utl	䦗
utm	关系网
utn	首届
uto	首席
utp	关系密切
utq	产销
utr	新科技
uts	首先要
utt	首先
utu	首次
utv	产妇
utw	首创
utx	亲身经历
uty	道义
uua	新闻工作
uub	新闻出版
uud	闁
uuf	立志
uug	竝
uuh	2
uui	北冰洋
uuj	癔
uuk	新产品
uul	瘅
uum	2
uun	新闻发言人
uuo	首次应邀
uup	半决赛
uuq	闭关锁国
uur	阅兵
uus	阐述
uut	资产管理公司
uuu	新闻单位
uuv	新闻媒体
uuw	总产值
uuy	立刻
uvc	2
uvd	兼有
uve	兼办
uvf	美好未来
uvg	亲如一家
uvh	2
uvj	2
uvl	2
uvm	2
uvo	兼
uvp	妆容
uvq	2
uvr	亲如手足
uvs	2
uvt	美好生活
uvu	歉意
uvv	2
uvw	闲杂人员
uvx	2
uwa	疫苗
uwb	益阳
uwc	准予
uwd	立体感
uwe	半个月
uwf	冷却
uwg	阕
uwh	总体上
uwi	闪光
uwj	准时
uwk	病从口入
uwl	蠲
uwn	瘊
uwo	总人数
uwp	新华社记者
uwq	产供销
uwr	飒
uws	冷酷
uwt	新途径
uwu	阀门
uwv	鴗
uww	痊愈
uwx	准绳
uwy	閄
uxa	冀东
uxb	凝聚
uxd	背面
uxe	癌细胞
uxf	新纪元
uxg	丠
uxh	递
uxi	新经济
uxj	曾经是
uxk	弟兄
uxl	总编辑
uxn	背心
uxo	䉾
uxp	凝视
uxq	背包
uxr	总结报告
uxs	北票
uxt	凝重
uxu	北美
uxv	新纪录
uxw	总结会
uxx	孳
uxy	北方
uya	辛亥革命
uyb	北京卫戍区
uyd	誾
uye	咨询服务
uyf	北方地区
uyg	疰
uyh	并肩战斗
uyi	新方法
uyj	北京电视台
uyk	门口
uyl	递交国书
uym	凉山
uyn	普遍性
uyo	门类
uyp	北京军区
uyq	凛然
uyr	普遍推广
uys	á
uyt	咨询委员会
uyu	门诊部
uyv	㾗
uyw	瘀
uyx	差旅费
uyy	门诊
vaa	嬺
vac	2
vad	娸
vae	2
vaf	姏
vag	如获至宝
vah	姫
vai	2
vaj	㛭
vak	嫨
val	㜴
vam	媖
van	媟
vao	2
vas	2
vat	嫕
vau	孏
vav	㝷
vaw	媒介
vax	2
vba	2
vbb	好孩子
vbc	娵
vbd	好奇
vbe	好用
vbf	好坏
vbg	㛅
vbh	媸
vbi	好汉
vbj	2
vbk	好听
vbm	2
vbn	好书
vbp	娘子军
vbq	好象
vbr	好看
vbs	㛆
vbt	好处
vbu	好意
vbv	好好
vbw	好像
vbx	妇孺皆知
vby	好话
vca	暨
vcb	孥
vcc	既能
vcd	砮
vce	努力
vcf	2
vcg	始末
vch	2
vci	怒江
vcj	即时
vck	怒吼
vcl	即墨
vcm	胬
vcn	妑
vco	怒火
vcp	始祖
vcr	拏
vcs	既要
vct	娭
vcu	即将
vcv	奴隶
vcw	即便
vcx	始终
vcy	即刻
vdb	2
vdd	2
vde	姷
vdf	好大喜功
vdg	妬
vdh	妦
vdk	2
vdl	2
vdm	媔
vdn	好奇心
vdq	娔
vdr	好帮手
vds	怒不可遏
vdu	嫴
vdv	姑姑
vdw	娇艳欲滴
vdx	2
vdy	2
vea	恳切
veb	嫂子
vec	2
ved	退还
vef	退款
veg	媛
vei	努力学习
vej	2
vek	㚳
vem	嬹
ven	退居
veo	2
vep	嫒
veq	婗
ver	退换
ves	婇
vet	退役
veu	姐弟
vev	姐姐
vew	退化
vex	㜎
vey	恳请
vfa	彟
vfc	妘
vfd	群起而攻之
vff	九十二
vfg	九十五
vfh	娬
vfi	寻常
vfj	妌
vfk	寻呼
vfl	寻思
vfn	嬦
vfo	2
vfp	嬄
vfq	妧
vfr	九十年代
vfs	妙趣横生
vft	媎
vfu	嫱
vfv	妹妹
vfw	女士们
vfy	九十六
vga	㛞
vgb	建院
vgc	2
vgd	建厂
vge	婧
vgf	㚥
vgg	建于
vgh	退一步说
vgi	建党
vgj	姮
vgk	嫩
vgl	婳
vgm	姉
vgn	2
vgo	召开座谈会
vgp	建军
vgq	煭
vgr	建制
vgs	建树
vgt	建造
vgu	召开新闻发布会
vgv	嫉恶如仇
vgw	九一八事变
vgx	嫊
vgy	建议
vha	嫭
vhb	2
vhc	2
vhd	婔
vhe	2
vhf	2
vhg	賮
vhk	㚲
vhl	2
vho	2
vhp	2
vhs	2
vhu	2
vhv	媫
vhx	2
vib	剥削阶级
vic	2
vid	既没有
vie	娋
vif	2
vih	好学上进
vii	剥削
vij	剥
vim	2
vin	隶属
vip	嫦
vir	录制
vit	录入
viu	录音
viw	刀光剑影
vja	2
vjc	2
vjd	好景不长
vje	2
vjf	娌
vjg	群星璀璨
vjh	媢
vji	巢湖
vjl	嫚
vjn	2
vjo	2
vjp	2
vjr	2
vjs	剿
vjt	2
vju	2
vjv	妒贤嫉能
vjw	2
vjy	如是说
vka	如东
vkb	邵阳
vkc	如能
vkd	恕不
vke	劭
vkf	叴
vkg	娱
vkh	如上
vkj	如是
vkk	嬠
vkm	如同
vkn	好吃懒做
vkp	如实
vkq	㚾
vks	桇
vkv	2
vkw	如今
vkx	如约
vky	女中豪杰
vlc	2
vld	婟
vle	媦
vlf	嫼
vlg	嬛
vlk	2
vll	2
vln	巡回展示
vlo	2
vlr	巤
vls	2
vlt	2
vlu	2
vlx	姻缘
vly	2
vmb	2
vmc	2
vmd	婩
vme	2
vmf	姌
vmg	娉
vmh	帇
vmk	2
vml	2
vmm	孆
vmn	2
vmp	2
vmq	2
vmr	2
vms	2
vmt	2
vmu	2
vmw	孈
vmx	2
vnb	刀子
vnc	2
vnd	退避三舍
vne	2
vnf	㚨
vng	彐
vnh	媚
vni	㜨
vnj	2
vnk	媁
vnl	2
vnm	2
vnn	巛
vno	2
vnp	2
vnq	2
vnt	娓
vnu	怒发冲冠
vnv	好心好意
vnw	好心人
voa	嫬
vob	2
voc	灵验
vod	灵寿
voe	2
vof	㛇
vog	2
voh	2
vok	妒火中烧
vol	2
voo	嬫
vop	㜆
vos	嫲
vot	灵敏
vou	嬚
vov	嫝
vow	彛
voy	2
vpa	建军节
vpb	2
vpc	2
vpd	2
vpf	㛡
vpg	嫁祸于人
vpj	好容易
vpk	2
vpl	巡逻
vpm	䢜
vpn	嬣
vpo	㛽
vpp	巡礼
vpq	妉
vpr	嫁接
vpt	巡航
vpv	廵
vpw	㚮
vpx	婉约
vpy	既定方针
vqa	婚期
vqc	2
vqd	㜣
vqe	2
vqg	好逸恶劳
vqh	2
vqk	姁
vql	2
vqm	嫓
vqr	忍饥挨饿
vqs	2
vqt	㚹
vqu	婚前
vqv	既然如此
vqw	如狼似虎
vqx	2
vqy	妁
vra	2
vrb	2
vre	2
vrf	2
vrg	姤
vrh	姩
vri	逮捕法办
vrj	2
vrk	2
vrl	女扮男装
vrn	2
vro	2
vrp	2
vrs	2
vrv	2
vry	嬓
vsa	建材工业
vsc	2
vsd	2
vse	2
vsf	杂志
vsg	灵机一动
vsh	㜀
vsi	2
vsj	㜤
vsl	2
vsm	2
vsn	2
vsp	寻根究底
vsr	杂质
vst	杂乱
vsu	杂音
vsv	嫖娼
vsw	杂念
vsy	杂文
vta	群英
vtb	建筑队
vtc	2
vtd	妖
vte	九月
vtf	九十
vtg	九万
vth	妰
vti	娱乐活动
vtj	群星
vtk	君
vtm	姠
vtn	姊
vto	灵敏度
vtq	群岛
vtr	娇气
vtt	九千
vtu	姑息养奸
vtv	建筑群
vtw	群体
vtx	好处费
vty	九州
vua	妇产医院
vuc	2
vud	婘
vue	嫺
vuf	㛨
vug	录音带
vuh	2
vui	2
vuj	嬂
vuk	婄
vum	2
vun	2
vuo	2
vuq	2
vur	寻章摘句
vus	录音机
vut	馗
vuv	嫉妒
vuw	㜋
vux	嫌疑
vva	妇女节
vvb	女孩
vvc	2
vvd	婚姻大事
vve	2
vvf	女士
vvg	奻
vvi	娽
vvj	2
vvk	㜉
vvl	2
vvo	2
vvp	奴隶社会
vvq	妇女儿童
vvr	女兵
vvs	2
vvt	妇科
vvu	女将
vvv	妇女
vvw	妇人
vvx	妇女组织
vvy	女郎
vwa	群众工作
vwb	2
vwc	妐
vwd	2
vwe	2
vwf	群众运动
vwg	群众来信
vwh	2
vwi	群众举报
vwj	即便是
vwk	媬
vwm	2
vwn	娰
vwo	2
vwq	如坐针毡
vwr	她们的
vws	㛊
vwt	群众生活
vwu	好几次
vwv	妢
vww	召集人
vwy	群众文化
vxa	2
vxb	2
vxd	始终不渝的
vxe	2
vxf	2
vxh	2
vxi	2
vxj	始终是
vxk	2
vxl	2
vxm	2
vxo	2
vxp	2
vxs	2
vxw	嫌疑人
vxx	媘
vxy	娹
vya	妖言惑众
vyb	2
vyc	㛩
vyd	建设有中国特色的社会主义
vye	㛄
vyf	建言献策
vyg	建设事业
vyh	2
vyi	丸
vyj	2
vyk	婛
vyl	妙语连珠
vyn	妒
vyo	2
vyp	建设祖国
vyq	女主角
vyr	2
vys	2
vyt	妫
vyu	建设部
vyv	奿
vyw	妔
vyx	㜅
vyy	婉言谢绝
waa	侙
wab	公共卫生
wad	代码
wae	借用
waf	垡
wag	代表
wah	任期目标责任制
wai	公共汽车
waj	偃
wak	借口
wal	全世界的
wam	偀
wan	借书
waq	僭
war	供热
was	供述
wat	人工智能
wau	化工部
wav	2
waw	代价
wax	借给
way	代
wba	保卫工作
wbb	作出了
wbc	2
wbd	仍不
wbf	仍未
wbg	佴
wbh	仍旧
wbi	创举
wbj	仍是
wbk	2
wbm	㑁
wbn	创收
wbo	仓库
wbq	保险金
wbr	作出的
wbs	保障机制
wbt	创造
wbu	创立
wbv	作出努力
wbw	创作
wbx	保险费
wby	化险为夷
wca	公式
wcb	凤阳
wcc	傪
wcd	公布
wce	公用
wcf	公元
wcg	公开
wci	公演
wcj	风驰电掣
wck	佁
wcl	公署
wcn	公司
wco	傌
wcp	公害
wcq	兊
wcr	公报
wcs	颂歌
wct	侔
wcu	殳
wcv	2
wcw	傩
wcx	公约
wcy	仏
wda	分布式
wdb	伌
wdd	优厚
wde	全面加强
wdf	优越
wdg	仨
wdh	颂古非今
wdi	人大常委会
wdj	佰
wdk	传感器
wdl	2
wdm	侕
wdn	全面发展
wdo	集成度
wdp	全面实现
wdq	全面解决
wdr	优质
wds	低成本
wdt	俦
wdu	优美
wdv	全面建设
wdw	俸
wdx	全面贯彻落实
wdy	㐲
wea	使用范围
web	使用了
wec	俷
wed	使用不当
wef	优胜者
weg	借助于
weh	信用卡
wej	伽师
wek	代用品
wel	2
wen	使用情况
weo	2
wep	僢
weq	佣金
wer	使用手册
wes	倸
wet	保加利亚
weu	人力资源
wew	创办人
wex	傒
wey	合肥市
wfa	会期
wfb	付出
wfc	伎
wfd	伟大
wff	侍
wfg	仕
wfh	仠
wfi	佘
wfj	癷
wfk	舒
wfl	八十四
wfm	会同
wfn	伟
wfp	儒家
wfq	会馆
wfr	八十年代
wfs	分支机构
wft	什么
wfu	传递
wfv	传媒
wfw	伟人
wfx	佳绩
wfy	会议
wga	全区
wgb	例子
wgc	侄
wgd	全面
wge	愈
wgf	亼
wgg	仼
wgh	合眼
wgi	敛
wgj	便是
wgk	使
wgl	全国
wgm	债
wgn	佤
wgo	企事业单位
wgp	便宜
wgq	傲
wgr	余年
wgs	途
wgt	途径
wgu	全部
wgv	登录
wgw	命令
wgx	全乡
wgy	叙谈
wha	停止工作
whd	俳
whe	2
whf	风餐露宿
whg	修理
whh	众目睽睽
whj	倬
whk	修路
whl	候车
whn	修改
who	个数
whp	修补
whq	修饰
whr	个把
whs	借此机会
wht	悠
whu	个头
whv	修好
whw	个人
whx	佌
why	修订
wia	化学工业
wid	停滞不前
wie	依法办事
wif	化学元素
wig	从小到大
wii	依法治理
wij	八小时
wik	2
wim	全党同志
win	传染性
wio	贪污腐化
wip	傥
wiq	2
wir	储油罐
wis	合法权利
wit	化学物质
wiu	尒
wiw	依法追究刑事责任
wiy	㲻
wja	儤
wjd	介面
wje	2
wjf	伸进
wjg	介于
wjh	风景点
wji	假日酒店
wjj	倡
wjn	供电局
wjp	2
wjq	偶然
wjr	伸手
wjs	但要
wjt	供电系统
wjv	2
wjw	假冒伪劣商品
wjx	伸缩
wjy	假日旅游
wka	全员劳动生产率
wkb	保险
wkc	众口难调
wkd	促成
wke	保驾
wkf	促进
wkg	俣
wkh	仲
wki	保洁
wkj	保暖
wkk	侃
wkl	会员国
wkm	保山
wko	食品店
wkp	保安
wkq	促销
wkr	保持
wks	堡
wkt	保税
wku	保单
wkv	保姆
wkw	促使
wkx	集中统一
wky	命中率
wla	全国工商联
wlb	2
wld	全国三八红旗手
wle	侽
wlf	停车场
wlg	伵
wlh	俥
wli	2
wlj	2
wlk	2
wll	儽
wlm	2
wln	偲
wlp	全国冠军
wlq	㒔
wlr	侵略扩张
wls	2
wlt	全国各族人民
wlw	全国人大常委会
wlx	分界线
wly	传输方式
wma	@
wmb	会见了
wmd	⑴
wme	侧脸
wmf	仙境
wmg	伷
wmh	催眠
wmj	仚
wmk	」
wml	贪财图利
wmm	2
wmn	仙居
wmo	2
wmq	⑺
wms	◆
wmt	催生
wmu	2
wmw	⒌
wmx	2
wmy	●
wna	领导工作
wnb	颁发了
wnc	全局观念
wnd	人民大会堂
wne	便民服务
wnf	领导干部
wng	追求
wnh	似懂非懂
wni	人民法院
wnj	假冒
wnk	追踪
wnl	人民团体
wnm	领导岗位
wnn	㐶
wnp	人民军队
wnq	人民解放军
wnr	领导的
wns	领导机关
wnt	人民币
wnu	假装
wnv	人民群众
wnw	全心全意为人民服务
wnx	追缴
wny	伈
woa	儣
wob	儍
woc	2
wod	健康有序
woe	2
wof	停火协议
wog	风靡一时
woi	企业法
wok	创业史
wol	创业园
won	健康情况
woo	僗
wop	人类社会
wor	健康的
wos	2
wot	人类生活
wou	俯首
wov	傏
wow	伙伴
wox	企业经营承包制
woy	侎
wpa	住宅区
wpb	从实际情况出发
wpd	从容不迫
wpe	人定胜天
wpf	俒
wpg	追究刑事责任
wph	公安战士
wpi	人之常情
wpj	2
wpl	㑮
wpn	儜
wpo	2
wpp	传家宝
wpr	侦察兵
wps	住宅楼
wpt	贫穷和落后
wpu	公安部门
wpw	全社会
wpx	全神贯注
wpy	保守主义
wqa	低落
wqb	尣
wqd	低压
wqe	2
wqf	人多地少
wqg	低下
wqi	您
wqj	依然是
wqk	佝
wql	2
wqn	偶然性
wqo	低度
wqp	低空
wqq	合金钢
wqr	﹙
wqs	。
wqt	低等
wqu	低头
wqv	您好
wqw	低价
wqx	僧多粥少
wqy	集贸市场
wra	保护区
wrb	风险
wrc	风骚
wrd	保持克制
wre	售后服务
wrf	㒶
wrg	凰
wrh	㐿
wri	侏
wrj	风暴
wrk	风口
wrl	风车
wrm	釜山
wrn	今年以来
wro	风靡
wrp	风灾
wrq	傀
wrr	今年的
wrs	便携机
wrt	风向
wru	父亲
wrv	父女
wrw	爸爸
wrx	保护母亲河
wry	保护主义
wsa	何其
wsb	体院
wsd	分析研究
wsf	体协
wsg	価
wsh	价格上涨
wsi	何尝
wsj	何时
wsk	售票员
wsl	债权国
wsm	体贴
wsn	便可以
wso	烋
wsp	体察
wsq	体外
wsr	体操
wss	从根本上
wst	体积
wsu	休闲
wsw	价格低廉
wsy	体育
wta	任期
wtb	作了
wtc	人生观
wtd	几百
wte	作用
wtf	凭
wtg	几天
wth	亻
wti	值得注意
wtj	信息量
wtk	信息中心
wtl	俄国
wtm	作曲
wtn	仡
wto	创造精神
wtp	伤害
wtq	任免
wtr	几年
wts	优先权
wtt	＄
wtu	信息产业
wtv	依靠群众
wtw	几个
wtx	体系结构
wty	作为
wua	含辛茹苦
wub	位子
wud	伴有
wue	倍加
wuf	亿美元
wug	伴
wuh	2
wuj	偣
wuk	化妆品
wul	位置
wum	俯首帖耳
wun	位居
wuo	倍数
wup	2
wuq	佽
wur	登门拜访
wus	偤
wut	休养生息
wuu	创新意识
wuv	从善如流
wuw	从总体上
wux	代总统
wuy	人道主义
wva	分工
wvb	分院
wvc	伮
wvd	分布
wvf	分支
wvg	㚢
wvh	分步
wvi	分泌
wvj	分明
wvk	佋
wvl	贫困
wvm	岔
wvn	忿
wvo	分类
wvp	分之
wvq	分解
wvr	分担
wvs	分配
wvt	分行
wvu	分部
wvv	分娩
wvw	分会
wvx	分级
wvy	分为
wwa	坐落
wwb	伧
wwc	价值观
wwd	人大
wwe	佾
wwf	侩
wwg	偷
wwh	令人瞩目
wwi	人治
wwj	任何时候
wwk	欲
wwl	从轻
wwm	个人崇拜
wwn	怂
wwo	人数
wwp	人家
wwq	价钱
wwr	合作制
wws	人权
wwt	人物
wwu	人次
wwv	人群
www	人
wwx	集体经济
wwy	仈
wxa	华东
wxb	介绍了
wxc	传统观念
wxd	化石
wxe	货架
wxf	华南
wxg	华丽
wxi	倾注
wxj	华里
wxk	倾听
wxl	货轮
wxm	佛山
wxn	倾心
wxp	华容
wxq	倾销
wxr	㒙
wxs	货票
wxt	货物
wxu	化疗
wxw	华侨
wxx	仳
wxy	他强调
wya	储蓄
wyb	住院
wyc	领
wyd	Б
wye	食用
wyf	詧
wyg	隹
wyh	会议上
wyi	а
wyj	含量
wyk	售
wyl	停车
wym	偏见
wyn	含
wyo	鹪
wyp	住宅
wyq	停留
wyr	禽
wys	停机
wyt	伪
wyu	亽
wyv	全文如下
wyw	伉
wyx	集结
wyy	雠
xaa	经营范围
xab	经营承包责任制
xac	2
xad	经营有术
xae	繖
xaf	经营者
xag	红豆
xah	弬
xai	红光
xaj	红果
xak	红叶
xal	緢
xam	緓
xan	绁
xao	红灯
xap	红安
xaq	繱
xar	张牙舞爪
xas	经营权
xat	经营管理
xau	绕道
xaw	䌋
xay	经营方式
xba	2
xbc	䋼
xbd	2
xbe	2
xbf	♀
xbg	㝀
xbh	弢
xbi	2
xbj	2
xbl	2
xbn	毑
xbo	2
xbp	2
xbq	2
xbr	2
xbs	䋪
xbv	2
xbw	级风
xbx	㢽
xca	弪
xcb	2
xcc	经验
xcd	经验丰富
xcf	经验教训
xcg	经理
xch	2
xci	经常
xck	緿
xcl	2
xcm	经由
xcn	紦
xcq	经销
xcr	绝对的
xcs	2
xct	经验和教训
xcu	经验总结
xcw	绝对领导
xcx	经络
xcy	经商
xda	2
xdc	绝不能
xdd	强硬态度
xde	绑架
xdf	缛
xdg	縅
xdh	绝不止于此
xdi	䋘
xdj	絔
xdl	2
xdm	缅
xdn	紌
xdo	2
xdq	缅甸
xdr	绑扎
xds	弱不禁风
xdu	组成部分
xdv	强压怒火
xdw	綊
xdy	紎
xea	缓期
xeb	綒
xec	2
xed	绊脚石
xee	弸
xeg	缓
xeh	䌐
xej	绷紧
xek	绥中
xem	2
xeo	2
xep	绥宁
xeq	幼儿
xer	䌊
xet	糼
xeu	缓冲
xev	组建
xew	组件
xex	缓缓
xey	2
xfa	2
xfb	引进了
xfc	贯通
xfd	结石
xfe	2
xff	疆域
xfg	结束
xfh	㢨
xfi	頴
xfj	结晶
xfk	缬
xfm	结帐
xfn	纬
xfo	纬度
xfp	红十字会
xfq	引进外资
xfr	比去年同期增长
xfs	结核
xft	贯彻
xfu	结冰
xfv	续建
xfw	结合
xfx	绘声绘色
xfy	结论
xga	2
xgb	结束了
xgc	絰
xgd	㢧
xge	蠡
xgf	纡
xgg	统一到
xgh	絚
xgi	纷至沓来
xgj	絙
xgk	綀
xgl	统一思想
xgm	弻
xgn	统一性
xgo	缙
xgp	统一安排
xgq	绚丽多彩
xgr	强烈的
xgs	强烈要求
xgt	统一管理
xgu	统一部署
xgv	緁
xgw	纯化
xgx	统一经营
xgy	强烈谴责
xhc	㢭
xhd	比上不足
xhf	引起
xhh	彏
xhi	引水
xhj	引申
xhk	绰号
xhn	引发
xhp	2
xhq	繉
xhr	比上年增长
xht	引向
xhu	引资
xhv	2
xhx	经上级批准
xhy	引诱
xia	经济基础
xib	经济联合
xic	2
xid	经济研究
xie	经济腾飞
xif	经济增长率
xig	经济政策
xih	经济战线
xii	经济学家
xil	弾
xim	緔
xin	经济改革
xio	2
xip	经济社会
xiq	经济危机
xir	经济技术
xis	经济杠杆
xit	经济特区
xiu	经济问题
xiv	䋝
xiw	经济体制
xix	经济组织
xiy	经济衰退
xja	彃
xje	费力
xjf	绅士
xjg	费事
xjj	刜
xjl	缆车
xjm	鄪
xjn	费心
xjo	2
xjp	2
xjq	费钱
xjr	2
xjt	㪄
xjx	缆绳
xjy	2
xka	强攻
xkb	绳子
xkd	强硬
xke	强力
xkf	绳索
xkg	缉毒
xkh	缋
xkj	强
xkk	絽
xkn	细嚼慢咽
xkp	2
xkq	2
xkr	强迫
xks	强权
xkt	织物
xku	强盗
xkw	强化
xkx	张口结舌
xky	引吭高歌
xla	细节
xld	比较而言
xle	细腻
xlf	比较支持
xlg	缳
xlh	2
xli	比较满意
xlk	絗
xll	纝
xln	细心
xlo	2
xlp	比较完善
xlt	比较复杂
xlu	比较关心
xlw	编辑人员
xlx	细纱
xly	2
xma	繷
xmb	2
xmc	2
xmg	
xmh	纲目
xmi	2
xmj	2
xmk	䌹
xml	2
xmm	红彤彤
xmo	纳粹
xmp	2
xmr	䋄
xms	纳西
xmt	纳税
xmu	纳凉
xmv	2
xmw	纲领
xmx	弱肉强食
xmy	2
xna	纠葛
xne	母爱
xnf	结发夫妻
xng	䋚
xnh	纽
xni	䌵
xnj	练习题
xnl	2
xnm	2
xnn	幻
xno	弹尽粮绝
xnp	纠察
xnq	2
xnr	䌌
xns	幻想
xnt	纯收入
xnu	纯收益
xnv	母女
xnw	纪念
xnx	纠纷
xny	引以为戒
xod	熲
xoe	2
xog	䌜
xoh	2
xoi	2
xoj	纒
xok	2
xon	継
xoo	緂
xop	2
xos	䌕
xot	毕业生
xou	2
xov	䌅
xow	继任
xox	鬻
xoy	毋庸讳言
xpd	縖
xpe	2
xpf	比赛规则
xpg	绽开
xpi	张家港
xpm	2
xpn	䌏
xpo	2
xpq	綩
xps	张冠李戴
xpt	缩微
xpu	终审判决
xpv	2
xpw	综合
xpx	比赛结果
xpy	绝密文件
xqa	绿色革命
xqb	2
xqc	绝对
xqd	约有
xqf	绝境
xqg	约束
xqh	绝非
xqi	弥漫
xqj	约旦
xqk	绝路
xqn	2
xqp	约定
xqr	绝热
xqs	绝顶
xqt	绝种
xqu	纸浆
xqv	绝妙
xqw	经贸合作
xqx	绝缘
xqy	经销商
xra	缴获
xrb	緵
xrd	絺
xre	2
xrf	䋸
xrg	弧形
xri	缐
xrj	2
xrk	2
xrl	䌗
xrp	缓兵之计
xrr	强制措施
xrs	2
xrt	维护和平
xru	维护着
xrv	强手如云
xrw	紩
xrx	缴费
xsa	2
xsb	2
xse	2
xsf	緸
xsg	强权政治
xsh	缃
xsi	2
xsj	2
xsk	䋍
xsl	2
xsm	2
xso	䌚
xsp	2
xss	綝
xst	2
xsw	䋱
xsx	2
xsy	结构调整
xta	绛
xtb	缝隙
xtd	缝
xte	张力
xtf	缵
xtg	终于
xth	终止
xti	纪律涣散
xtj	乡里
xtk	张口
xtl	疑团
xtn	纥
xtp	终究
xtq	弱智儿童
xtr	终年
xts	乡村
xtt	终生
xtu	终端
xtv	郷
xtw	组委会
xtx	终结
xty	编造谎言
xua	弱项
xuc	2
xud	弹奏
xue	彅
xuf	紏
xug	缮
xuk	縂
xul	缯
xun	弹道导弹
xuo	2
xuq	䌪
xur	2
xus	繜
xut	弱智
xuu	弹道
xuv	㢺
xuw	乡亲们
xux	绨
xuy	弹劾
xva	绿荫
xvb	2
xvc	2
xvd	2
xve	縁
xvf	彇
xvg	䋖
xvi	绍兴
xvj	纪录影片
xvk	绿叶
xvm	2
xvn	强奸民意
xvo	繍
xvp	强弩之末
xvr	2
xvt	㓜
xvu	2
xvv	2
xvw	结婚登记
xvx	2
xvy	纨
xwa	2
xwb	综合防治
xwc	纵观
xwd	纪念碑
xwe	综合服务
xwf	结合起来
xwg	缏
xwh	縧
xwi	综合治理
xwj	纵览
xwk	纪念品
xwl	综合国力
xwm	纪念邮票
xwn	缒
xwo	纵火
xwp	结合实际
xwq	纷争
xwr	维持
xwt	纵向
xwu	维新
xwv	䳇
xww	维修
xwx	纷纷
xwy	强化训练
xxa	组织工作
xxc	组织观念
xxd	缘故
xxe	红细胞
xxf	组织者
xxg	缘
xxh	紖
xxi	组织活动
xxj	继续坚持
xxk	比喻
xxl	缔约国
xxn	弜
xxo	纺织业
xxp	组织实施
xxr	比拟
xxs	缝纫机
xxt	毕生
xxu	组织部
xxv	继续努力
xxw	比分
xxx	纰
xxy	比率
xya	统计工作
xyb	结识了
xyc	㣃
xyd	＞
xyf	统考
xyg	统计表
xyh	编目
xyj	緕
xyk	编号
xyl	繵
xyn	编导
xyp	编审
xyq	编钟
xyr	编制
xys	红旗飘飘
xyt	编程
xyu	统计资料
xyv	2
xyw	统计分析
xyx	纺织
xyy	统计
yaa	诫
yab	谋取
yad	谌
yae	诱惑力
yaf	旁若无人
yag	诓
yah	试点
yai	刻苦学习
yaj	试题
yak	諽
yal	试车
yan	讵
yao	2
yap	郊区农村
yaq	刻苦钻研
yar	试制
yas	试想
yat	试行
yau	计划单列
yaw	文艺创作
yax	计划纲要
yay	试剂
yba	2
ybb	讘
ybd	充耳不闻
ybf	斊
ybg	为了更好的
ybh	詜
ybj	2
ybl	2
ybo	2
ybp	2
ybq	2
ybr	2
ybs	2
ybt	谋取私利
ybu	2
ybv	2
ybx	2
yby	为了方便群众
yca	试验区
ycc	諁
ycd	译成
yce	诵
ycf	育才
ycg	这对于
yci	充当
yck	充足
ycl	诈骗罪
ycn	袤
yco	褭
ycp	试验室
ycq	交通银行
ycr	充气
ycs	弃权
yct	育种
ycu	交通部门
ycv	2
ycw	交通便捷
ycy	交通肇事
yda	䜔
ydb	á
ydc	文不对题
ydd	享有盛名
yde	䛫
ydf	毫不动摇地
ydg	离不开
ydh	说不上
ydi	说不清
ydj	夜不归宿
ydk	放大器
ydl	2
ydm	言不由衷
ydn	诚心
ydp	刻不容缓
ydq	诚然
ydr	调研报告
yds	高不可攀
ydt	望而生畏
ydu	诚意
ydw	诚信
ydx	䛋
ydy	说大话
yea	譭
yeb	2
yec	2
yed	交朋友
yee	裒
yef	说服教育
yeg	䚴
yei	高朋满座
yej	施用量
yel	2
yem	亹
yen	2
yeo	2
yep	衣冠
yer	妄加指责
yes	2
yet	衣物
yeu	主办单位
yev	2
yew	六月份
yey	妄加评论
yfa	市场营销
yfb	就地取材
yfc	市场预测
yfd	六十三
yfe	认真办理
yff	诖
yfg	讲求
yfh	讦
yfi	讲学
yfj	计量
yfk	认真吸取
yfl	六十四
yfm	諵
yfn	讳
yfo	主动精神
yfp	讲究
yfq	讲解
yfr	六十年代
yfs	市场机制
yft	计算
yfu	房地产
yfv	诸暨
yfw	市场化
yfx	计费
yfy	対
yga	主攻
ygb	评聘
ygc	誈
ygd	主页
yge	诼
ygf	主干
ygg	高于一切
ygh	这一点
ygi	评测
ygj	证明
ygk	变速器
ygl	六一国际儿童节
ygm	主峰
ygn	主导
ygo	市政府
ygp	证实
ygq	主角
ygr	证据
ygs	主机
ygt	评选
ygu	证券
ygv	主妇
ygw	评价
ygx	主编
ygy	评论
yha	放眼世界
yhc	诐
yhd	就此而言
yhe	2
yhg	訨
yhi	2
yhk	詀
yhn	盲目发展
yhq	斍
yhr	这些年来
yhs	2
yht	盲目乐观
yhu	试点单位
yhw	为非作歹
yhx	訿
yhy	谦虚谨慎
yia	旅游区
yid	说法不一
yie	旅游胜地
yif	高兴地说
yig	交流与合作
yih	旅游点
yii	充满活力
yij	交流电
yik	文学遗产
yil	旅游团
yim	2
yin	谨小慎微
yip	文学家
yiq	2
yir	充满希望
yis	充满机遇
yit	訬
yiu	主流产品
yiv	2
yiw	交流会
yix	高消费
yiy	方法论
yjb	齐聚
yjc	2
yjd	为时不晚
yjf	文明城市
yjg	文明素质
yjh	䚯
yji	刘淇
yjj	亣
yjk	谩骂
yjl	就是因为
yjm	2
yjn	齐心
yjo	2
yjp	文明礼貌
yjq	课外
yjr	交易所
yjs	裹
yjt	齐备
yju	文明单位
yjv	2
yjw	交易会
yjx	䛖
yjy	就是说
yka	高工
ykb	熟
ykc	高能
ykd	享有
yke	享受
ykf	京城
ykg	衰
ykh	谴
yki	就
ykj	高昂
ykk	瓤
ykl	畗
ykm	敲
ykn	京剧
yko	就业
ykp	毫
ykq	烹饪
ykr	就近
yks	高校
ykt	高等
yku	误差
ykw	就会
ykx	训练
yky	商品房
ylb	为国出力
yld	2
yle	认罪服罪
ylf	颤动
ylg	譞
yli	䜚
ylj	2
ylk	禀
ylm	2
ylo	2
ylq	忘恩负义
yls	2
ylw	畒
ylx	2
yly	为国为民
yma	市区
ymb	调子
ymc	2
ymd	市面
ymf	市场
ymg	调整
ymh	市
ymi	2
ymk	调遣
yml	调车
ymm	调幅
ymn	市属
ymo	市府
ymp	谋财害命
ymq	诺贝尔奖
ymr	调制
yms	调配
ymt	市长
ymu	调头
ymv	2
ymw	调集
ymx	2
ymy	市郊
yna	启蒙
ynb	邙
ync	永驻
ynd	遍布
yne	望
ynf	记者
yng	词
ynh	扉
yni	昶
ynj	遍野
ynk	赢
ynl	京剧团
ynm	扁
ynn	忘
yno	肇庆
ynp	永安
ynq	为避免
ynr	高蛋白
yns	房顶
ynt	亥
ynu	悥
ynv	妄
ynw	谬
ynx	夜以继日
yny	訫
yoa	变革
yob	商业职工
yoc	主席台
yod	变成
yoe	弯腰
yof	谈起
yog	变形
yoi	就业渠道
yoj	变量
yok	弯路
yol	变黑
yom	脔
yon	变异
yoo	燮
yop	谜
yoq	鸾
yor	变换
yos	就业机会
yot	高度重视
you	㪰
yov	亦即
yow	商业企业
yox	变幻
yoy	变为
ypa	2
ypb	这实际上是
ypd	言之有物
ype	䢍
ypf	变被动为主动
ypg	为实现
yph	这点
ypj	这里
ypl	这回
ypm	2
ypn	诧异
ypp	旅客之家
ypq	訦
ypr	2
yps	衣冠楚楚
ypt	这种
ypu	请客送礼
ypv	2
ypw	这位
ypy	文字说明
yqa	许多工作
yqc	2
yqd	谵
yqe	诋毁
yqf	言犹未尽
yqg	话锋一转
yqh	2
yqi	户外活动
yqk	调解员
yql	2
yqm	㪱
yqn	袌
yqq	誃
yqr	敲锣打鼓
yqs	2
yqt	调解委员会
yqu	肩负着
yqv	诤
yqw	调解人
yqy	许多方面
yra	齐抓共管
yrb	离子
yrd	证据确凿
yre	2
yrf	讲排场
yrg	离开
yrh	謕
yri	诛
yrk	调兵遣将
yrm	离岗
yrn	离异
yrp	请提宝贵意见
yrq	义乌
yrr	义气
yrs	交换机
yrt	肩挑重担
yru	诉状
yrv	离婚
yrw	交接仪式
yry	诉讼
ysa	主要工作
ysb	主要职责
ysd	调查研究
yse	变本加厉
ysf	蛮横无理
ysg	调查表明
ysh	主要目的
ysi	交相辉映
ysj	主要是
ysk	高标号
ysl	主权国
ysm	订购
ysn	调查发现
ysp	2
ysq	订金
ysr	调查报告
yss	调查核实
yst	主要特征
ysu	订阅
ysv	主要媒体
ysw	订货
ysx	调查组
ysy	订户
yta	施工
ytb	诱
ytc	为难
ytd	旖
yte	膂
ytf	诰
ytg	放下
yth	诈
yti	高等学校
ytj	放映
ytk	计算器
ytl	放置
ytm	旃
ytn	为
yto	为数
ytp	为之
ytq	旅馆
ytr	计算技术
yts	计算机网络
ytt	旌
ytu	为首
ytv	孪生姐妹
ytw	为例
ytx	谢绝
yty	訸
yua	誁
yud	敲门砖
yue	商用
yuf	说过
yug	谰
yuh	谦虚
yui	访问学者
yuj	说明
yuk	商品
yul	帝国
yum	商贩
yun	商情
yuo	商业
yup	旁
yuq	商贸
yur	高新技术产业
yus	商机
yut	商务
yuu	说道
yuw	商人
yuy	证券市场
yva	良苦
yvb	2
yvc	郎
yve	詪
yvg	旔
yvj	䜈
yvk	郎中
yvm	2
yvn	良性
yvo	2
yvr	良好的祝愿
yvs	记录本
yvt	良知
yvu	2
yvw	离退休人员
yvx	2
yvy	良方
ywa	郊区
ywb	高分子
ywc	讼
ywd	A
ywe	六月
ywf	论坛
ywg	诠
ywh	论点
ywi	刘华清
ywj	交易
ywk	文化中心
ywl	交界
ywm	认购
ywn	充分发挥
ywo	效应
ywp	谈何容易
ywq	交错
ywr	效
yws	认可
ywt	设备
ywu	於
ywv	文化娱乐
yww	谶
ywx	讹
ywy	㫃
yxa	变幻莫测
yxb	详细了解
yxc	2
yxd	高级顾问
yxf	高级专员
yxg	训练班
yxi	紊
yxj	䛍
yxl	鄐
yxm	2
yxo	高纬度
yxp	高级农艺师
yxq	2
yxs	2
yxt	壅
yxu	畜产
yxw	高级人民法院
yxx	高级经济师
yxy	誸
yya	文艺
yyb	讨论了
yyc	讨论通过
yyd	这方面的
yye	谈恋爱
yyf	设计者
yyg	亠
yyi	文学
yyj	这就是
yyk	谆
yyl	方圆
yym	议购
yyn	讠
yyo	讲话精神
yyp	文字
yyq	许许多多
yyr	文摘
yys	文本
yyt	方向
yyu	谛
yyv	斏
yyw	文件
yyx	详详细细
yyy	议论
