AAA	工
AAB	戒除
AAD	匿
AAE	勤勤懇懇
AAF	苷
AAG	戒毒
AAH	芽
AAI	工党
AAJ	剗
AAK	戒
AAL	盞
AAM	蘣
AAN	葉
AAO	工序
AAP	工運
AAQ	苉
AAR	芭蕾舞
AAS	工棚
AAT	蘙
AAU	戔
AAV	苆
AAW	匶
AAX	警戒線
AAY	式
ABA	若隱若現
ABC	菆
ABD	䔺
ABE	蘟
ABF	茸
ABG	蔯
ABH	邛
ABI	蒸
ABK	莻
ABL	䓝
ABM	茁
ABN	芤
ABO	臨陣磨槍
ABR	艿
ABT	蓀
ABU	薩
ABV	匜
ABW	蔭
ABY	芨
ACA	匥
ACB	芭
ACC	蔘
ACD	英勇奮鬥
ACE	蓪
ACF	茅臺
ACG	戎馬一生
ACH	英勇獻身
ACI	茅台酒
ACK	苔
ACL	䓿
ACN	茅
ACO	世態炎涼
ACP	醫務室
ACR	勤務兵
ACS	難能可貴
ACT	戎馬生涯
ACU	英勇善戰
ACW	荾
ACY	芆
ADA	蔵
ADB	苊
ADC	蕻
ADD	藞
ADE	戎
ADF	苦
ADG	葳
ADH	茬
ADI	藉
ADJ	菴
ADK	若
ADL	基因
ADM	項
ADN	藏
ADO	甚廣
ADP	荙
ADQ	基金
ADR	蒝
ADS	基本
ADT	藶
ADU	芖
ADV	基建
ADW	基
ADX	茂
ADY	莽
AEA	功臣
AEB	菔
AEC	萉
AED	蕦
AEE	荔
AEF	巭
AEG	苴
AEH	苚
AEI	散光
AEJ	薶
AEK	茄
AEL	醫學界
AEM	虋
AEN	散居
AEO	功底
AEP	蕣
AEQ	萖
AER	藐
AES	菜
AET	功
AEU	蕂
AEV	荽
AEW	萸
AEX	蒵
AEY	功率
AFA	蕡
AFB	邯
AFC	蓋
AFD	甘
AFE	蘎
AFF	芏
AFG	七十五
AFH	蒖
AFI	蒜
AFJ	芉
AFK	薹
AFL	蕾
AFM	貳
AFN	芌
AFO	䓇
AFP	荸
AFQ	芫
AFR	七十年代
AFS	某
AFT	著
AFU	蓻
AFV	七十九
AFW	芙
AFX	區域經濟
AFY	弍
AGA	華
AGB	芚
AGC	荎
AGD	菾
AGE	莆
AGF	芋
AGG	七一
AGH	廿
AGI	莍
AGJ	蕙
AGK	蔌
AGL	薑
AGM	黃
AGN	七
AGO	區政府
AGP	巧家
AGQ	葬
AGR	戒毒所
AGS	茉
AGT	廾
AGU	葬送
AGV	莖
AGW	蕐
AGX	荑
AGY	匤
AHA	蘆
AHB	監聽
AHC	賢能
AHD	菲
AHE	貢獻力量
AHF	芷
AHG	菽
AHH	蘋
AHI	芷江
AHJ	蘋果
AHK	熙
AHL	蓾
AHM	牙雕
AHN	緊
AHO	蔝
AHP	雅安
AHQ	莧
AHR	堅持
AHS	緊要
AHT	牙
AHU	邪道
AHV	工具書
AHW	藈
AHX	茈
AHY	某些方面
AIA	茳
AIB	匯聚
AIC	菭
AID	落成
AIE	菹
AIF	蔆
AIG	薄
AIH	菠
AII	莎
AIJ	蕩
AIK	藻
AIL	薀
AIM	落网
AIN	薄情
AIO	落座
AIP	莐
AIQ	萢
AIR	蒎
AIS	菏
AIT	落
AIU	汞
AIV	菬
AIW	匯
AIX	薄弱
AIY	茫
AJA	蓽
AJB	蕞
AJC	萬能
AJD	莫
AJE	萌
AJF	昔
AJG	萬一
AJH	㓚
AJI	划清
AJJ	菖
AJL	蔓
AJM	萬
AJN	臨時性
AJO	草料
AJP	逪
AJQ	葛
AJR	斮
AJS	菒
AJT	葃
AJU	邁開
AJV	郾
AJW	鵲
AJX	菎
AJY	草率
AKA	勤苦
AKB	葺
AKC	勤務
AKD	叵
AKE	莂
AKF	革
AKG	勤
AKH	匱
AKI	苦口婆心
AKJ	或是
AKK	觀
AKL	觀眾
AKM	蒷
AKN	勤快
AKO	鞭炮
AKP	其中之一
AKQ	勤勉
AKR	觀看
AKS	切中要害
AKT	鞭策
AKU	燕
AKV	區劃
AKW	荶
AKX	韁繩
AKY	燕京
ALA	蔮
ALB	蘻
ALC	藣
ALD	茵
ALE	莮
ALF	苗
ALG	葨
ALH	世界上
ALI	世界水平
ALJ	莗
ALK	匣
ALL	藟
ALM	蕒
ALN	葸
ALP	夢
ALQ	鹋
ALR	蔪
ALS	世界杯
ALT	菌
ALU	蔨
ALV	藪
ALW	苬
ALX	蘿
ALY	藅
AMA	蕽
AMB	工農聯盟
AMC	英勇
AMD	英
AME	蓇
AMF	苖
AMG	茼
AMH	匝
AMJ	荝
AMK	苘
AML	英國
AMM	蘡
AMN	萵
AMO	工農業總產值
AMP	共同富裕
AMQ	英名
AMR	共同推出
AMS	英模
AMT	共同利益
AMU	貢
AMV	共同努力
AMW	芮
AMX	共同維護
AMY	英文
ANA	苠
ANB	芑
ANC	難以預料
AND	巨
ANF	蔚
ANG	巨型
ANH	蔬
ANI	基層黨組織
ANJ	螶
ANK	蘗
ANL	世界
ANM	貰
ANN	蕊
ANO	巨鹿
ANP	迣
ANQ	蔚然
ANR	歡快的
ANS	枼
ANT	苾
ANU	芯
ANV	世
ANW	蓼
ANX	苨
ANY	忒
AOA	蔗
AOC	勤勞勇敢
AOD	蓭
AOE	蕿
AOF	工業城市
AOG	薱
AOI	工業污染
AOJ	蔊
AOK	工業品
AOL	工業界
AON	薦
AOO	菼
AOP	蒾
AOQ	菧
AOR	䕇
AOS	蘑
AOT	工業生產
AOU	炗
AOV	菮
AOW	蓙
AOX	工業總產值
AOY	工業產值
APA	藆
APB	茡
APC	莫之能御
APD	菪
APE	萓
APF	莞
APG	萱
APH	菅
API	蒙混
APJ	蓂
APK	觀察員
APL	葷
APM	蒙山
APN	蔤
APO	萬家燈火
APP	觀察家
APQ	菀
APR	堅實的
APS	苧
APT	蒙自
APU	芝
APV	荌
APW	蓉
APX	緊密結合
APY	鑒定證書
AQA	蠶
AQB	苑
AQC	芶
AQD	薝
AQE	萏
AQF	菳
AQG	葡
AQH	敬獻
AQI	敬酒
AQJ	荀
AQK	敬
AQL	敬畏
AQM	萯
AQN	苞
AQO	菊
AQP	帶
AQQ	茤
AQR	萄
AQS	匹配
AQT	蕕
AQU	芕
AQV	匹
AQW	芡
AQX	基金組織
AQY	芍
ARA	若無其事
ARB	葼
ARC	葩
ARD	菝
ARE	蘤
ARF	苩
ARG	茊
ARH	㔸
ARI	茱
ARJ	芹
ARK	匠
ARL	蕪
ARM	菗
ARN	芞
ARO	藥廠
ARP	菦
ARQ	蒐
ARR	藠
ARS	蔱
ART	萆
ARU	艾
ARV	萔
ARW	苵
ARX	藥
ARY	薂
ASA	藲
ASB	帶來了
ASC	基本矛盾
ASD	基本原理
ASE	基本力量
ASF	茜
ASG	苯
ASH	葙
ASI	基本法
ASJ	艼
ASK	苛
ASL	基本思想
ASM	基本內容
ASN	基本情況
ASO	基本精神
ASP	萙
ASQ	基本金
ASR	菥
ASS	菻
AST	基本特征
ASU	㭉
ASV	葽
ASW	萊
ASX	草木皆兵
ASY	蒁
ATA	醫藥
ATB	莠
ATC	醫務
ATD	醫
ATE	蒩
ATF	芊
ATG	董
ATH	蓰
ATI	葕
ATJ	莉
ATK	茖
ATL	蓖
ATM	薇
ATN	藝術性
ATO	蕃
ATP	攻守
ATQ	藜
ATR	莪
ATS	蓬松
ATT	蕧
ATU	䒘
ATV	萎
ATW	蓯
ATX	蘩
ATY	攻
AUA	荓
AUB	蒴
AUC	革新能手
AUD	菤
AUE	蘢
AUF	苙
AUG	蘭
AUH	莘縣
AUI	薪水
AUJ	薏
AUK	菩
AUM	蔽
AUN	蕄
AUP	莫逆之交
AUQ	茨
AUR	藱
AUS	薪
AUT	蒺
AUV	蒹
AUW	藺
AUX	苝
AUY	蘭州
AVA	蕁
AVB	艽
AVC	莭
AVD	菇
AVE	茛
AVF	蕭
AVG	茟
AVH	藎
AVI	菉
AVJ	切題
AVK	茹
AVL	菑
AVM	蕭山
AVN	切忌
AVO	䔥
AVP	菷
AVQ	切勿
AVR	芀
AVT	切
AVU	切開
AVV	茘
AVW	切分
AVX	切斷
AVY	芄
AWA	茷
AWB	芁
AWC	蓊
AWD	茯
AWE	共用
AWF	蔡
AWG	葵
AWH	莜
AWI	苶
AWJ	芥
AWK	葆
AWL	輂
AWM	苮
AWN	恭
AWO	花粉
AWP	革命家
AWQ	花色
AWR	拲
AWS	茶
AWT	荏
AWU	共
AWV	芬
AWW	巫
AWX	花
AWY	恐
AXA	葒
AXB	芎
AXC	苰
AXD	堅強有力
AXE	苭
AXF	荮
AXG	莼
AXH	苐
AXI	蘊涵
AXJ	茀
AXK	蔃
AXL	蘊
AXM	蒳
AXN	緊張局勢
AXP	世紀之交
AXQ	葯
AXT	薌
AXU	苺
AXW	蒶
AXX	茲
AYA	芳草
AYB	工商聯
AYC	茺
AYD	A
AYE	蘐
AYF	䓂
AYG	莫衷一是
AYH	芳齡
AYI	弋
AYJ	藹
AYK	蒿
AYL	工商界
AYM	貣
AYN	荒
AYO	荒唐
AYP	匾額
AYQ	工商銀行
AYR	芳
AYS	其主要原因是
AYT	蔟
AYU	蒂
AYV	莨
AYW	萃
AYX	蓄
AYY	荒郊
BAA	防范工作
BAB	職工隊伍
BAD	陿
BAF	職工教育
BAG	職工再就業
BAJ	隁
BAK	聝
BAN	聚苯乙烯
BAO	取其精華去其糟粕
BAP	限期完成
BAR	防范措施
BAT	孤芳自賞
BAW	孤苦伶仃
BAY	聀
BBA	孕期
BBB	子
BBC	陬
BBD	孜孜不倦
BBF	孕
BBG	孖
BBH	耶
BBI	子洲
BBM	聉
BBN	阤
BBO	聶榮
BBP	孔孟之道
BBQ	耶穌
BBR	孫子兵法
BBT	孺子牛
BBU	子弟
BBV	子女
BBW	孩子們
BBX	子彈
BBY	孕育
BCA	取巧
BCB	郰
BCE	取胜
BCF	埾
BCG	陳巴爾虎旗
BCH	聚餐
BCI	聚
BCJ	取暖
BCK	孡
BCL	盈
BCM	聚財
BCN	聚居
BCO	焣
BCQ	阭
BCR	聚攏
BCS	棸
BCT	取得
BCU	聚首
BCV	娶
BCW	陖
BCX	取締
BCY	取
BDA	隋
BDB	阨
BDC	耾
BDD	隨感
BDE	陏
BDF	呄
BDG	隇
BDH	阫
BDI	承
BDJ	陌
BDK	隨口
BDM	聏
BDN	隨心
BDP	取長補短
BDQ	承包
BDR	承接
BDS	陭
BDT	陝
BDU	隔三差五
BDV	承建
BDW	陜
BDX	承繼
BDY	出面交涉
BEA	隱
BEB	阻隔
BEC	承受能力
BED	阻礙
BEE	阻力
BEF	阻截
BEG	䎳
BEH	阻止
BEI	隱沒
BEJ	隱晦
BEK	隱患
BEL	阻擊
BEN	隱居
BEP	阻塞
BEQ	聣
BER	孟加拉
BET	阞
BEU	隱痛
BEV	隠
BEW	隱含
BEX	附加費
BEY	隱諱
BFA	隫
BFB	陳規陋習
BFC	耺
BFD	孺
BFE	陸架
BFF	隢
BFH	陡
BFI	陵水
BFJ	阱
BFK	聐
BFL	聴
BFM	陡峭
BFN	隯
BFP	陸軍
BFQ	阮
BFS	陸橋
BFT	陼
BFW	陵
BFX	陸續
BFY	出土文物
BGA	陳舊
BGB	出現了
BGC	阿爾巴尼亞
BGD	孒
BGE	聙
BGF	聽
BGG	隔天
BGH	耳
BGI	耳光
BGJ	陳
BGK	隔
BGL	聽眾
BGM	陋
BGN	隔壁
BGO	陳腐
BGP	陋室
BGQ	阢
BGR	陳年
BGS	耳机
BGT	聽從
BGU	隔音
BGV	陘
BGW	隬
BGX	隔絕
BGY	隔离
BHA	隵
BHB	芔
BHC	陂
BHD	陫
BHG	阯
BHH	陟
BHI	障眼法
BHK	屮
BHN	鼐
BHP	除此之外
BHQ	䧋
BHS	隨處可見
BHW	㞣
BIA	孤掌難鳴
BIB	函
BID	函大
BIE	陗
BIF	函索
BIG	丞
BIH	耳濡目染
BII	氶
BIJ	隙
BIM	函購
BIP	隚
BIR	函授
BIS	丞相
BIT	隲
BIU	尕
BIW	函件
BIY	阥
BJA	防暴警察
BJB	,
BJC	聰明能幹
BJD	也是不可能的
BJF	聰明才智
BJG	陽
BJH	刵
BJI	陽光
BJK	(
BJM	隅
BJN	陽性
BJP	除暴安良
BJQ	陰暗角落
BJR	陽泉
BJS	陽西
BJU	陽新
BJV	也是如此
BJW	陽信
BJX	隰
BJY	及時調整
BKA	隕落
BKB	隨叫隨到
BKC	亟
BKD	出口成章
BKE	䧎
BKF	叾
BKG	聖
BKH	聵
BKJ	出口量
BKK	出口品
BKL	出口國
BKM	隕
BKP	出口額
BKQ	出口貿易
BKT	亟待
BKW	出口創匯
BKY	出口商品
BLB	孟子
BLE	勐
BLF	孟
BLG	䧃
BLH	陣
BLI	孟津
BLK	阻擊戰
BLL	聯繫點
BLM	聚眾賭博
BLO	陣營
BLP	除四害
BLU	陣痛
BLV	聯繫群眾
BLW	聯繫人
BLX	陣線
BLY	陣亡
BMA	出世
BMB	出院
BMC	出台
BMD	出厂
BME	聘用
BMF	祟
BMG	聘
BMH	出處
BMI	出海
BMJ	出題
BMK	出口
BML	出界
BMM	孾
BMN	出局
BMO	糶
BMP	出家
BMQ	欪
BMR	出手
BMS	出格
BMT	出版
BMU	出差
BMV	出嫁
BMW	出售
BMX	出線
BMY	孭
BNB	孔子
BND	恥辱
BNF	阠
BNG	乃至
BNH	卩
BNI	孔雀
BNJ	也是
BNK	隦
BNL	也罷
BNN	孔
BNO	聚乙烯
BNQ	了解
BNR	隨心所欲
BNS	也要
BNT	也行
BNU	孞
BNV	也好
BNW	出以公心
BNX	了結
BNY	恥
BOA	職業工會
BOB	出席了
BOC	耿馬
BOD	出席大會
BOE	職業學校
BOF	耿直
BOG	䧤
BOK	除塵器
BOL	職業輔導
BON	防火牆
BOO	出席座談會
BOP	出席宴會的
BOQ	隣
BOR	職業技術教育
BOU	職業道德
BOV	䧜
BOW	出席人
BOY	耿
BPA	院落
BPB	院子
BPD	䢊
BPE	辸
BPF	院
BPG	聢
BPI	阿富汗
BPJ	陀螺
BPK	陪審員
BPN	聹
BPP	孤家寡人
BPQ	耽
BPR	院所
BPS	院校
BPT	出神入化
BPU	䏁
BPV	迆
BPW	聜
BPX	陀
BPY	院方
BQA	阺
BQB	了解了
BQD	聸
BQE	陷
BQF	聊城
BQG	了解到
BQH	陥
BQI	聎
BQK	陶器
BQN	孢
BQO	陱
BQP	除夕之夜
BQQ	陊
BQR	陶
BQS	陶醉
BQT	聊
BQU	陶瓷
BQW	承包人
BQX	承包經營
BQY	承包商
BRA	孤苦
BRC	孤
BRD	出手不凡
BRE	孤兒
BRF	孤老
BRG	隍
BRI	陎
BRK	孤單
BRM	䎺
BRN	限制性
BRP	孤寂
BRQ	隗
BRR	附近的
BRS	聚氨酯
BRT	陴
BRU	孤立
BRV	孤女
BRW	阿拉伯
BSF	陻
BSG	䧈
BSH	耵
BSI	陝西省
BSJ	刴
BSK	阿
BSL	▁
BSO	隨機應變
BSQ	陳述句
BST	阿根廷
BSU	朶
BSV	阿姨
BSW	阿爸
BTA	降
BTB	艸
BTC	防御能力
BTD	聒
BTE	隆重舉行
BTF	陲
BTG	隆
BTH	阼
BTI	降水
BTJ	隆昌
BTK	聥
BTL	聰
BTM	隩
BTN	阣
BTO	出版業
BTP	出版社
BTQ	亟待解決
BTR	取得的
BTS	降格
BTT	隆重
BTU	出乎意料
BTV	孫女
BTW	孼
BTX	孫
BTY	孜
BUA	聠
BUB	陰差陽錯
BUC	職務
BUD	障礙
BUE	隧
BUF	阧
BUG	職責
BUH	耳聞目睹
BUI	隧洞
BUJ	障
BUK	陪
BUM	陪同
BUN	陶冶情操
BUO	陪床
BUP	陪客
BUQ	防疫針
BUR	子弟兵
BUS	職權
BUT	隡
BUU	隧道
BUV	隒
BUW	隘
BUY	隊旗
BVA	限期
BVE	限
BVF	隱姓埋名
BVG	限于
BVH	孻
BVI	䎼
BVJ	隟
BVK	䧂
BVO	限度
BVP	限定
BVR	限制
BVW	限价
BVY	限於
BWA	除草
BWB	除了
BWC	聡
BWD	隂
BWE	聄
BWF	附
BWG	除
BWH	除非
BWI	除法
BWJ	陰影
BWK	聆听
BWL	聯合國
BWM	聯合體
BWN	隖
BWO	附庸
BWP	除害
BWQ	除外
BWR	附近
BWS	陰極
BWT	聚合物
BWU	出人意料
BWV	聁
BWW	附件
BWX	聯合組織
BWY	陰
BXA	聯歡
BXB	聯防
BXC	階級矛盾
BXD	聯邦
BXE	聈
BXG	墬
BXH	聯絡處
BXI	乸
BXJ	聯盟
BXK	聯絡員
BXL	聯繫
BXM	聰穎過人
BXN	階層
BXO	聯營
BXP	聯賽
BXQ	聯名
BXR	聯接
BXS	聯想
BXU	聯絡部
BXV	聯姻
BXW	聯合
BXX	陛
BXY	聯誼
BYA	及其
BYB	孩子
BYC	防務
BYD	限產壓庫
BYE	孩兒
BYF	埅
BYG	防毒
BYH	防止
BYI	及
BYJ	也就是
BYK	聤
BYN	孩
BYO	防火
BYP	防守
BYQ	孩儿
BYR	孩提
BYS	及格
BYT	防
BYU	隮
BYV	防災
BYW	阬
BYX	防線
BYY	﨤
CAA	巴勒斯坦
CAB	參觀了
CAD	駐華大使
CAG	馬鞍形
CAH	預期目標
CAJ	弁
CAL	參觀團
CAM	馬鞍山
CAN	參觀展覽
CAR	參觀指導
CAW	鴘
CAY	參觀遊覽
CBJ	牟取暴利
CBT	牟取私利
CBW	馬耳他
CBY	預防為主
CCA	參觀
CCB	又及
CCC	參
CCD	又有
CCE	參加
CCF	參考
CCG	又一
CCH	參見
CCI	參演
CCJ	又是
CCK	參戰
CCL	參數
CCN	參展
CCO	駐馬店
CCP	斚
CCR	參拜
CCS	又要
CCU	㕕
CCV	又如
CCW	桑拿
CCY	厸
CDC	能不能
CDG	巴布亞新幾內亞
CDI	驕奢淫逸
CDJ	奙
CDK	馬大哈
CDL	畚
CDM	貵
CDT	巴不得
CDW	馬不停蹄
CEA	參加革命
CEB	參加了
CED	能否
CEE	能力
CEF	䏍
CEG	勇于
CEH	通
CEI	能源
CEJ	能量
CEK	通路
CEL	通車
CEM	通山
CEN	勇敢
CEO	態度
CEP	通宵
CEQ	勇猛
CER	勇气
CES	通榆
CET	通知
CEU	通道
CEV	通婚
CEW	通信
CEX	態
CEY	通商
CFA	圣賢
CFD	頚
CFF	圣地
CFI	圣洁
CFJ	圣明
CFK	圣戰
CFN	通報情況
CFO	圣火
CFQ	能者多勞
CFR	通報批評
CFU	巴士站
CFV	參考書
CFW	圣人
CFX	圣母
CFY	圣誕
CGA	馬列著作
CGB	䯅
CGC	骉
CGD	馬到成功
CGF	骦
CGJ	驲
CGK	䯄
CGL	骃
CGO	馬爾康
CGP	骔
CGR	勇于探索
CGT	驅逐艦
CGU	骍
CGV	骎
CGW	骙
CGY	馬列主義
CHA	騎虎難下
CHC	能上能下
CHG	預處理
CHN	預見性
CHO	能見度
CHQ	覌
CIA	能源工業
CII	台港澳
CIQ	能源危机
CIR	通常的
CIU	厼
CIV	能源建設
CIW	能源供應
CJF	巴里坤
CJP	參照實行
CJT	參照物
CKA	怠工
CKB	邰
CKE	台胞
CKF	台南
CKG	瓵
CKH	台上
CKI	台港
CKJ	刣
CKK	台中
CKM	台山
CKN	怠
CKO	炱
CKP	迨
CKQ	㰧
CKS	枲
CKU	辝
CKX	巼
CKY	台商
CLC	騙買騙賣
CLH	駁回上訴
CLU	圅
CMA	通過鑒定
CMB	通過了
CME	通過學習
CMI	通過決議
CMJ	岊
CMU	貟
CMY	通過討論
CNA	預期
CNB	預防
CNC	能屈能伸
CND	預感
CNF	巴塘
CNG	巴青
CNH	務
CNI	巴掌
CNK	巴中
CNL	柔軟
CNM	務農
CNN	予以
CNO	預料
CNP	予以安排
CNQ	預兆
CNR	矛盾
CNS	巴西
CNT	巴黎
CNU	柔道
CNW	柔情似水
CNX	柔弱
CNY	厶
COA	驅
COB	驟
COC	騷
COD	騎
COE	駔
COF	驍
COG	驪
COH	驢
COI	馬
COJ	騍
COK	駛
COL	騾
COM	騁
CON	驏
COO	騼
COP	駝
COQ	駒
COR	駁
COS	驃
COT	驕
COU	驥
COV	駋
COW	驗
COY	駐
CPF	參賽者
CPR	參審製度
CPT	參軍入伍
CPY	務實效
CQA	馳名世界
CQB	允
CQF	驟然增多
CQK	馳名中外
CQS	驗鈔機
CQW	駐外使館
CQX	巴解組織
CQY	允許
CRE	矛盾加劇
CRF	巴拉圭
CRI	矛盾激化
CRS	馬拉松
CRT	勇挑重擔
CSB	台柱子
CSD	巴林右旗
CSF	通權達變
CSS	馬來西亞
CSU	能歌善舞
CSY	勇攀高峰
CTA	預算草案
CTB	牟取
CTD	矣
CTF	勇往直前
CTG	牟
CTK	驅動器
CTM	預算內
CTN	能動性
CTP	牟定
CTQ	預算外資金
CTR	通行無阻
CTT	牟利
CTV	通知書
CTX	預算編製
CTY	通行證
CUD	參差不齊
CUG	勇斗歹徒
CUY	巴音郭楞
CVF	驕嬌二氣
CWA	通信工程
CWB	駭人聽聞
CWC	巴拿馬
CWE	通貨膨脹
CWF	通信地址
CWI	桑拿浴
CWJ	通俗易懂
CWK	通信員
CWM	通信网
CWP	通信安全
CWR	通信兵
CWT	逡
CWV	鳮
CWW	預備會議
CWX	通信網
CWY	通俗讀物
CXC	又紅又專
CXW	通緝令
CYA	通州區
CYB	叉子
CYC	能文能武
CYD	參謀長
CYE	叉腰
CYF	通訊地址
CYI	巴彥淖爾盟
CYJ	蚤
CYK	通訊員
CYL	叉車
CYP	通訊社
CYQ	通訊錄
CYR	勇於探索
CYT	通訊系統
CYU	駐京部隊
CYW	勇於創新
CYX	通訊網絡
CYY	㕚
DAA	碊
DAB	左聯
DAD	碪
DAE	毻
DAF	左
DAG	矼
DAH	砑
DAI	左派
DAJ	勵
DAK	奩
DAL	礣
DAM	砸
DAN	碟
DAO	大工業
DAP	礞
DAQ	長期貿易
DAR	砹
DAS	尤其要
DAT	有期徒刑
DAU	面臨新的挑戰
DAV	砌
DAW	礤
DAX	成功經驗
DAY	䂝
DBA	克孜勒蘇柯爾克孜
DBB	不了了之
DBC	原子能
DBD	頋
DBE	大陸架
DBF	耷
DBG	矷
DBH	䂙
DBI	太陽光
DBJ	㚎
DBM	布隆迪
DBN	胡子眉毛一把抓
DBO	破除迷信
DBP	厄運
DBQ	不了解
DBR	有限的
DBS	有隙可乘
DBT	太陽系
DBW	有限公司
DBX	原子彈
DBY	砐
DCA	硁
DCB	夿
DCC	磣
DCD	镽
DCE	鬃
DCF	友協
DCG	瓺
DCH	肆虐
DCI	不能滿足
DCK	唘
DCL	鬆軟
DCM	不能同意
DCN	翃
DCO	碼
DCP	不能容忍
DCQ	镹
DCR	镻
DCS	鬍來
DCT	镺
DCU	友
DCV	肆
DCW	雄
DCX	鬆弛
DCY	犮
DDA	礪
DDB	砈
DDC	套
DDD	磊
DDE	大力
DDF	磭
DDG	砳
DDH	碶
DDI	大小
DDJ	奭
DDK	大中
DDL	大田
DDM	碩
DDN	厖
DDO	大米
DDP	大家
DDQ	大多
DDR	磢
DDS	碕
DDT	礰
DDU	㚐
DDV	大姐
DDW	硤
DDX	厐
DDY	夶
DEA	戫
DEB	有限
DEC	長矛
DED	有感
DEE	硼
DEF	有
DEG	砠
DEH	砽
DEI	長江
DEJ	有時
DEK	耐用品
DEL	不加思索
DEM	胡同
DEN	有情
DEO	有底
DEP	憂
DEQ	磶
DER	夯
DES	有机
DET	劯
DEU	長
DEV	有如
DEW	鶘
DEX	磎
DEY	有效
DFA	奔
DFC	磕
DFD	圧
DFE	辱
DFF	奎
DFG	三十一
DFH	矸
DFI	奈
DFJ	夲
DFK	厈
DFL	礌
DFM	不規則
DFN	刳
DFO	硳
DFP	成才之路
DFR	有志气
DFS	礵
DFT	奢
DFU	大聲疾呼
DFV	三十九
DFW	砆
DFX	春雨綿綿
DFY	大城市
DGA	研
DGB	砘
DGC	厔
DGD	硏
DGE	硺
DGF	在一起
DGG	三
DGH	古
DGI	石油
DGJ	硬
DGK	感
DGL	礓
DGM	磧
DGN	瓳
DGO	烕
DGP	研究
DGQ	厫
DGR	研制
DGS	砞
DGT	丆
DGU	砰
DGV	威
DGW	硬件
DGX	戌
DGY	砡
DHA	戛
DHB	存
DHC	破
DHD	慧
DHE	甭
DHF	在
DHG	歪
DHH	夒
DHI	不
DHJ	不是
DHK	否
DHL	盃
DHM	碵
DHN	不必
DHO	在座
DHP	丰富
DHQ	硯
DHR	存折
DHS	嫑
DHT	夏
DHU	不准
DHV	契
DHW	鴀
DHX	不比
DHY	在京
DIA	耩
DIB	耔
DIC	耙
DID	耨
DIE	硝
DIF	耕
DIG	硄
DIH	耜
DII	耒
DIJ	耦
DIK	長江口
DIL	耬
DIM	厰
DIN	有法必依
DIO	耱
DIP	礃
DIQ	長治久安
DIR	在黨的領導下
DIS	耓
DIT	砂
DIU	泵
DIV	耗盡
DIW	耠
DIX	耭
DIY	耪
DJA	大量工作
DJB	厚
DJD	皕
DJE	壓
DJF	百
DJG	碭
DJH	砷
DJI	在日常生活中
DJJ	夰
DJK	厭戰
DJL	碩果纍纍
DJM	石景山
DJN	奄
DJO	厘米
DJP	厚禮
DJQ	碣
DJR	大量的
DJS	壓榨
DJT	厬
DJU	厚道
DJV	百姓
DJW	百余
DJX	礘
DJY	厚望
DKA	有口難辯
DKB	不足取
DKD	大吃大喝
DKE	大中學校
DKF	右
DKG	大中型
DKH	三足鼎立
DKI	大中小
DKJ	夼
DKK	磾
DKL	有中國特色社會主義
DKM	磒
DKN	右翼
DKP	不足之處
DKR	厛
DKS	歷史機遇
DKT	右邊
DKU	不中意
DKW	三中全會
DKX	厑
DKY	成品率
DLA	不畏艱險
DLB	在國際上
DLD	百思不得其解
DLE	鬍思亂想
DLF	礋
DLG	碨
DLH	硨
DLI	大國沙文主義
DLK	厙
DLL	礧
DLM	在國內外
DLP	三連冠
DLS	硱
DLT	碅
DLV	大眾媒介
DLW	㎎
DLX	磥
DLY	大眾文學
DMA	碘
DMB	冇
DMC	而又
DMD	碳
DME	磆
DMF	碉
DMG	硐
DMH	面目
DMI	大同小异
DMJ	而
DML	布置
DMM	原則同意
DMN	硙
DMO	大幅度
DMP	面容
DMQ	面包
DMR	不同的
DMS	碋
DMT	面向
DMU	頁
DMV	不同尋常
DMW	硶
DMX	面紗
DMY	砃
DNA	碾
DNB	乭
DND	臧
DNE	尨
DNF	成都
DNG	䎁
DNH	嘏
DNI	碿
DNJ	成果
DNK	尵
DNL	成因
DNM	尳
DNN	盛情
DNP	成家
DNQ	尥
DNR	磖
DNS	成本
DNT	尰
DNU	怘
DNV	尢
DNW	尬
DNX	盛
DNY	尤
DOA	礦
DOC	砿
DOD	三座大山
DOE	磷肥
DOF	灰土
DOG	礏
DOI	礦渣
DOJ	灰暗
DOL	盔
DOM	礦山
DON	耐磨性
DOO	磱
DOQ	灰色
DOR	灰白
DOS	礳
DOT	礦物
DOU	灰
DOV	磄
DOW	百廢俱興
DOX	硝煙彌漫
DOY	不應該
DPA	研究工作
DPB	研究院
DPD	硡
DPE	百家爭鳴
DPF	碂
DPG	碹
DPI	遼寧省
DPJ	大容量
DPK	研究中心
DPL	不容置疑
DPM	確山
DPN	面容憔悴
DPO	石家庄
DPP	研究室
DPQ	碗
DPR	研究所
DPS	研究机构
DPT	碦
DPU	研究部署
DPV	百家姓
DPW	確
DPX	砣
DPY	破案率
DQA	砥
DQB	克隆
DQD	兢
DQE	勀
DQF	兙
DQG	碒
DQH	大名鼎鼎
DQI	三角洲
DQJ	剋
DQK	㚚
DQL	大多數
DQM	克山
DQN	砲
DQO	砲火
DQP	确定
DQQ	奓
DQR	克拉
DQT	兛
DQU	不久前
DQV	碀
DQW	砍
DQX	砲彈
DQY	矽
DRA	大白菜
DRB	研制出
DRC	㼋
DRD	研制成功
DRE	原貌
DRF	碷
DRG	砶
DRH	斫
DRI	原
DRJ	有的是
DRK	爽口
DRL	原因
DRM	厒
DRN	有所改善
DRO	原料
DRP	原定
DRQ	磈
DRR	爽
DRS	原本
DRT	碑
DRU	愿意
DRV	磤
DRW	成年人
DRX	礫
DRY	礉
DSA	奇葩
DSB	不可限量
DSC	有可能
DSD	不可不
DSE	有机肥料
DSF	磦
DSG	硒
DSH	矴
DSI	大西洋
DSJ	碴
DSK	奇
DSL	不可思議
DSM	奇峰
DSN	奇怪
DSO	原材料
DSP	不相容
DSQ	不可多得
DSR	不可缺少
DSS	礎
DST	奇特
DSU	㚓
DSV	奇妙
DSW	硹
DSX	有機結合
DSY	不要忘記
DTA	厇
DTB	邦
DTD	硚
DTE	有生力量
DTF	厜
DTG	有利于
DTH	砟
DTI	大街小巷
DTJ	故里
DTK	硌
DTL	硇
DTM	礇
DTN	矻
DTO	磻
DTP	砭
DTQ	大自然
DTR	硪
DTS	歷來
DTT	歷
DTU	不知道
DTV	不咎既往
DTW	磫
DTX	故鄉
DTY	故
DUA	硑
DUB	厥
DUD	㕇
DUE	礀
DUF	辜
DUG	砬
DUH	眘
DUI	遼河
DUJ	遼
DUK	碚
DUL	磳
DUM	三部曲
DUN	磁性
DUO	有關精神
DUP	而立之年
DUQ	有關負責人
DUR	有益的
DUS	磸
DUT	不道德
DUU	冭
DUV	磏
DUW	大部分
DUX	磁
DUY	磋商
DVD	不妨礙
DVE	硍
DVF	砕
DVG	硉
DVI	碌
DVJ	大好時機
DVL	在群眾中
DVM	友好周
DVO	友好精神
DVP	大災之年
DVQ	不盡然
DVS	原始森林
DVT	碯
DVU	不好意思
DVV	大姑娘
DVW	友好合作
DVX	成群結隊
DVY	友好訪問
DWA	砼
DWB	奉承
DWC	砓
DWD	碫
DWE	舂
DWF	磜
DWG	奏
DWH	大体上
DWI	
DWJ	春
DWK	古今中外
DWL	不假思索
DWM	泰山
DWN	磓
DWO	夏令營
DWP	百分之
DWQ	大伙儿
DWR	砜
DWS	不僅要
DWT	秦
DWU	春意
DWV	鴣
DWW	雁
DWX	百分比
DWY	奪
DXA	不斷鞏固
DXB	㔫
DXD	不約而同
DXE	不斷加強
DXF	砒霜
DXG	不斷更新
DXH	成績斐然
DXI	不斷深入
DXJ	砩
DXK	成績單
DXL	有比較才能有鑒別
DXM	不斷豐富
DXN	䂗
DXO	有線廣播
DXP	不斷完善
DXQ	破紀錄
DXR	不斷提高
DXT	礙
DXU	不斷前進
DXW	不斷發展
DXX	砒
DXY	砪
DYA	有效期
DYB	太陽
DYC	硫
DYD	飆
DYE	在京舉行
DYF	有效地
DYG	砫
DYH	唇亡齒寒
DYI	太
DYJ	成交量
DYK	礅
DYL	盇
DYM	長方體
DYN	碥
DYO	硛
DYP	迏
DYQ	成交金額
DYR	有效措施
DYS	太极
DYT	碎片
DYU	磅
DYV	硠
DYW	碎
DYX	戍
DYY	砇
EAA	加工工業
EAB	與世隔絕
EAC	加工能力
EAD	臟
EAE	腊月
EAF	膩
EAG	肛
EAH	臔
EAI	胨
EAJ	舁
EAK	膒
EAL	貓
EAM	朠
EAN	脦
EAO	加工廠
EAP	朦
EAQ	辭舊迎新
EAR	膜拜
EAS	腊梅
EAU	舉世聞名
EAV	㥯
EAW	臒
EAY	膵
EBA	服藥
EBB	郛
EBC	服
EBD	采取有效措施
EBE	服用
EBF	孚
EBG	䏪
EBI	乳汁
EBJ	爭取時間
EBK	乳品
EBL	服輸
EBM	朏
EBN	乳
EBQ	采取多种形式
EBR	采取措施
EBT	嗠
EBW	服侍
EBY	乳房
ECA	服務項目
ECB	辭職
ECC	腏
ECD	肥大
ECE	肥胖
ECF	肥城
ECG	肥豬
ECH	服務處
ECI	肥沃
ECJ	蜰
ECK	胎
ECL	肥田
ECM	亂
ECN	肥
ECO	肥料
ECP	服務社
ECQ	胎儿
ECR	肥皂
ECS	肥西
ECT	服務行業
ECU	肥美
ECV	辭退
ECW	朘
ECX	服務網
ECY	肞
EDA	膸
EDB	受不了
EDC	肱
EDD	胸有成竹
EDE	脹
EDF	胯
EDG	加在一起
EDH	胚
EDI	亂砍濫伐
EDJ	貊
EDK	爭奪戰
EDL	學成回國
EDM	須
EDN	肬
EDO	脄
EDQ	膽大包天
EDR	學有所成
EDS	䐀
EDT	力不從心
EDU	膫
EDW	腠
EDY	肽
EEA	月薪
EEB	脬
EEC	月台
EED	朋友
EEE	月
EEF	舀
EEG	朋
EEH	膄
EEI	月光
EEK	月中
EEM	服服帖帖
EEN	愛學習
EEO	月底
EEP	月初
EEQ	腉
EER	脫胎換骨
EES	肝膽相照
EET	肋
EEV	脮
EEW	鵬
EEX	膎
EEY	月亮
EFA	膹
EFB	肚子
EFC	肢
EFD	臑
EFE	膨脹
EFF	胿
EFG	肚
EFH	肝
EFI	毀滅
EFJ	肼
EFK	膨
EFM	腩
EFN	肟
EFO	肝炎
EFP	脖
EFQ	朊
EFR	與去年同期相比
EFS	毀林
EFT	豺
EFU	寽
EFV	膤
EFW	毀
EFX	毀約
EFY	肘
EGA	助工
EGB	肫
EGC	胵
EGD	且
EGE	助
EGF	助教
EGG	助理
EGH	舉止
EGI	脙
EGJ	刞
EGK	膈
EGL	舉國
EGM	肺
EGN	舉
EGO	肺炎
EGP	䢐
EGQ	用一句話來說
EGR	助手
EGS	䏞
EGT	舉行
EGU	胓
EGV	脛
EGW	雎
EGX	胰
EGY	譽為
EHA	臚
EHC	叟
EHD	腓
EHE	用力
EHF	用地
EHG	胩
EHH	臞
EHI	用水
EHJ	用量
EHK	用
EHM	與此同時
EHN	用以
EHO	用煤
EHP	用家
EHQ	覓
EHR	用手
EHS	用來
EHU	辵
EHV	用盡
EHW	用途
EHX	頿
EHY	用房
EIA	䝣
EIE	䏴
EIG	胱
EII	盥洗
EIJ	肺活量
EIL	盥
EIM	䐝
EIN	毀滅性
EIP	膛
EIR	脳
EIT	䏚
EIU	加油站
EIV	膽小如鼠
EIW	膌
EJF	貍
EJG	腸
EJH	刖
EJI	力量源泉
EJJ	蠫
EJL	腸胃
EJM	腢
EJO	力量對比
EJP	力量之源
EJR	腥气
EJS	腂
EJT	腥
EJW	興旺發達
EJX	䐊
EKA	加工
EKB	架子
EKC	駕
EKD	加大
EKE	加力
EKF	加熱
EKG	加
EKH	膭
EKI	加深
EKJ	加盟
EKK	臊
EKL	加固
EKM	賀
EKN	乫
EKO	加料
EKP	迦
EKQ	加印
EKR	賀年
EKS	架
EKT	毠
EKU	架次
EKV	妿
EKW	嗧
EKX	加強
EKY	袈
ELA	膕
ELB	愛國陣線
ELD	胭
ELE	舅
ELF	爵士
ELG	輿
ELH	胛
ELI	愛國激情
ELN	腮
ELO	肥田粉
ELP	愛國運動
ELQ	臅
ELS	膽固醇
ELT	愛國衛生運動
ELU	腸胃病
ELV	爵
ELW	膃
ELX	舅母
ELY	輿論
EMA	腆
EMB	興隆
EMD	胦
EME	興學
EMF	爯
EMG	興
EMH	帠
EMI	興海
EMJ	興旺
EMK	興嘆
EML	受賄罪
EMM	興山
EMN	腡
EMO	興業
EMP	受賄案
EMT	興和
EMU	興辦
EMV	興建
EMW	肭
EMY	興衰
ENB	㐍
END	腒
ENE	力爭
ENF	膠南
ENG	腛
ENH	腵
ENI	脲
ENJ	力量
ENK	䑀
ENL	力圖
ENM	學習體會
ENN	劜
ENO	力度
ENQ	加以解決
ENR	甩掉
ENS	愛民模範
ENT	力
ENU	鼠
ENV	甩
ENW	膠
ENX	胒
ENY	臎
EON	膔
EOO	腅
EOQ	膦
EOT	愛勞動
EOU	䊆
EOV	膅
EOW	腑
EOY	脒
EPA	臗
EPB	受阻
EPC	受
EPD	迌
EPE	受用
EPF	腙
EPG	腚
EPI	受潮
EPJ	興安盟
EPL	腪
EPM	受賄
EPN	愛
EPP	受害
EPQ	腕
EPR	受控
EPS	與之相比
EPU	受益
EPV	胺
EPW	腔
EPY	受雇
EQA	胝
EQB	兒
EQC	脃
EQD	脆
EQE	胸脯
EQF	彩色電視機
EQH	兒戲
EQI	朓
EQJ	彩色照片
EQK	朐
EQL	膽略
EQN	胞
EQO	舄
EQP	胸襟
EQQ	䏧
EQR	胸
EQS	兒歌
EQT	兒科
EQU	胸部
EQV	胞妹
EQW	肷
EQX	脆弱
EQY	豹
ERA	學期
ERB	朡
ERC	胍
ERD	脪
ERE	脈
ERF	腯
ERG	胉
ERH	肵
ERI	腺
ERJ	學時
ERK	乳制品
ERL	膴
ERM	繇
ERN	脾性
ERO	學業
ERP	覺察
ERQ	貌
ERR	學
ERS	脎
ERT	脾
ERU	學問
ERV	力挫群雄
ERW	胅
ERX	學費
ERY	學說
ESA	膝蓋
ESB	采取
ESD	采礦
ESE	采用
ESF	膘
ESH	股票上市
ESI	采油
ESJ	彩虹
ESK	胢
ESL	彩車
ESM	采購
ESO	采煤
ESP	采寫
ESQ	彩色
ESR	采摘
ESS	彩票
EST	腰身
ESU	彩卷
ESV	腰
ESW	膝
ESX	采納
ESY	䝗
ETA	胮
ETB	胣
ETD	膖
ETE	貈
ETF	脡
ETG	腫
ETH	臼
ETI	腹瀉
ETJ	腹
ETK	胳
ETL	貔
ETM	䐿
ETN	噕
ETO	膰
ETP	胜利完成
ETT	彡
ETU	腹部
ETV	腇
ETW	胜任
ETX	脢
ETY	豸
EUA	胼
EUB	胖子
EUD	騰
EUE	朧
EUF	受益者
EUG	胖
EUH	妥善處理
EUI	臆測
EUJ	臆
EUK	䏽
EUL	兒童團
EUM	勝過
EUN	騰飛
EUP	妥善安置
EUQ	妥善解決
EUR	兒童樂園
EUS	臆想
EUT	臆造
EUV	膁
EUW	膉
EUX	臆斷
EUY	滕州
EVA	墾區
EVB	爭取
EVC	䐚
EVD	爭奪
EVE	腿
EVF	妥
EVG	肗
EVH	爭
EVI	腦海
EVK	貂
EVL	臘
EVM	爭購
EVN	肍
EVP	爭冠
EVR	爭氣
EVS	爭相
EVT	腦
EVU	妥善
EVV	兒媳婦
EVW	鵎
EVY	肒
EWA	受人欺凌
EWB	脫險
EWC	股
EWD	腶
EWE	胗
EWF	肸
EWG	臉
EWH	腳步
EWI	臾
EWK	脫
EWL	脫困
EWM	肌肉
EWN	肌
EWO	脫粒
EWP	貌合神离
EWQ	股金
EWR	股份制
EWS	貅
EWT	股息
EWU	斞
EWV	朌
EWW	腳
EWX	а
EWY	朎
EXA	奚落
EXB	加強了
EXD	奚
EXE	脂肪
EXG	腞
EXH	䏖
EXI	乿
EXJ	脂
EXK	膙
EXL	加強團結
EXN	雞蛋
EXS	肺結核
EXT	膷
EXU	䐞
EXW	加強合作
EXX	肶
EXY	胟
EYA	輿論監督
EYD	興衰成敗
EYE	興高采烈
EYF	助產士
EYG	毀於一旦
EYJ	月產量
EYK	朜
EYL	輿論界
EYM	膽識過人
EYN	胲
EYO	興衰榮辱
EYP	脫離實際
EYQ	脫離危險
EYS	助記歌
EYT	肪
EYU	膀
EYV	朖
EYW	腋
EYX	臃
EYY	輿論認為
FAA	二期工程
FAB	才華出眾
FAC	雨花台
FAD	堪
FAE	霰
FAF	卋
FAG	墷
FAH	壏
FAI	塔河
FAJ	卉
FAK	霸
FAL	㙹
FAM	賁
FAN	堞
FAO	十萬火急
FAP	靀
FAQ	墆
FAR	南斯拉夫
FAS	枽
FAT	塔身
FAU	霸道
FAW	塔
FAX	地區經濟
FAY	塃
FBA	土耳其
FBB	地陷
FBD	地面
FBE	地膜
FBF	地址
FBG	地球
FBH	邗
FBI	邗江
FBJ	壭
FBK	凷
FBL	地界
FBM	地幔
FBN	地
FBO	電子對抗
FBP	逇
FBQ	地名
FBR	地質
FBS	垜
FBT	霳
FBU	地道
FBW	地位
FBX	壣
FBY	圾
FCA	弆
FCB	叝
FCC	墋
FCD	頍
FCE	劫
FCF	云南
FCH	去處
FCI	支流
FCJ	刦
FCK	唟
FCL	盍
FCM	支農
FCN	翅
FCO	走馬燈
FCP	迲
FCQ	去留
FCR	魂
FCS	支柱
FCT	埃
FCU	去
FCV	刧
FCW	埈
FCX	鼁
FCY	才能充分體現
FDA	堶
FDB	十三陵
FDC	坺
FDD	老太太
FDE	需用
FDF	震
FDG	坧
FDH	坯
FDI	地面水
FDJ	埯
FDK	震中
FDL	壥
FDM	需
FDN	城
FDO	博大精深
FDP	垯
FDQ	城鎮
FDR	塬
FDS	埼
FDT	靂
FDU	地面站
FDV	老百姓
FDW	埉
FDX	垅
FDY	城市
FEA	十月革命
FEB	垺
FED	老朋友
FEE	協
FEF	埒
FEG	坥
FEH	赤膊上陣
FEI	教學法
FEJ	霾
FEK	赤膽忠心
FEL	未加思索
FEM	協同
FEN	增加收入
FEO	電腦應用
FEP	協定
FEQ	霓
FER	霢
FES	埰
FET	㔹
FEU	協辦
FEW	十月份
FEX	電力網
FEY	霡
FFA	壩
FFB	邽
FFC	雲
FFD	壖
FFE	劸
FFF	圭
FFG	奊
FFH	填
FFI	款
FFJ	刲
FFK	郌
FFL	壊
FFM	封山
FFN	恚
FFO	霊
FFP	堵塞
FFQ	坃
FFR	博士后
FFS	土木
FFT	堵
FFU	寺
FFV	封建
FFW	堎
FFX	鼃
FFY	填充
FGA	十七
FGB	坉
FGC	垤
FGD	十三
FGE	博
FGF	圩
FGG	二
FGH	十
FGI	干涉
FGJ	垣
FGK	塥
FGL	堜
FGM	武夷山
FGN	雨情
FGO	干燥
FGP	地下室
FGQ	地下鐵道
FGR	十年
FGS	十杰
FGT	二千
FGU	坪
FGV	霋
FGW	十分
FGX	坘
FGY	十六
FHA	墟
FHB	趣
FHC	坡
FHD	霏
FHE	趄
FHF	直
FHG	越
FHH	赴
FHI	趟
FHJ	趕
FHK	坫
FHL	塷
FHM	赸
FHN	武
FHO	走廊
FHP	趤
FHQ	趨
FHR	赾
FHS	真相
FHT	趲
FHU	走
FHV	超
FHW	真
FHX	超級
FHY	圤
FIA	霟
FIB	增添了
FIC	未能
FID	靋
FIE	霄
FIF	祘
FIG	霈
FIH	霑
FII	未
FIJ	臺灣是中國的一部分
FIK	老河口
FIL	云游四方
FIM	埫
FIN	礼
FIO	釐米
FIP	壋
FIQ	未免
FIR	未按
FIS	霂
FIT	釐
FIU	示
FIV	墚
FIW	塉
FIX	霐
FIY	霔
FJA	埋藏
FJB	堤防
FJC	朝圣
FJD	坦克
FJE	井架
FJF	朝
FJG	坦
FJH	刊
FJI	汬
FJJ	亓
FJK	井
FJL	墁
FJM	堣
FJN	塌
FJO	井底
FJP	乾安
FJQ	埸
FJR	朝气
FJS	堁
FJT	刊物
FJU	朝前
FJV	刱
FJW	刊登
FJX	堒
FJY	丼
FKA	喜歡
FKB	郆
FKC	鼓足勇气
FKD	頡
FKE	袁
FKF	吉
FKG	埕
FKH	圳
FKI	地中海
FKJ	吉日
FKK	靈
FKM	塤
FKN	翓
FKO	＃
FKP	臺
FKQ	欯
FKR	鼓舞
FKS	吉林
FKT	吉利
FKU	鼓
FKV	喜好
FKW	遠
FKX	哉
FKY	遠離
FLA	戴
FLD	堌
FLE	賣力
FLF	雷
FLG	堽
FLI	雷波
FLJ	雷暴
FLK	雷鳴
FLL	夁
FLM	賣
FLN	二輕局
FLO	賣座
FLP	載客
FLQ	畞
FLR	賣掉
FLS	賣票
FLT	雷管
FLU	替罪羊
FLV	塿
FLW	堺
FLX	載
FLY	塄
FMA	霻
FMB	南陵
FMC	南通
FMD	坱
FME	塴
FMF	霌
FMG	垌
FMH	圸
FMI	南海
FMJ	南昌
FMK	坰
FML	南國
FMM	南丹
FMN	堝
FMO	南康
FMP	南宁
FMQ	境內外
FMR	南樂
FMS	南极
FMT	南和
FMU	南
FMV	南召
FMW	埁
FMX	南疆
FMY	垻
FNA	壽
FNB	㐊
FNC	翹尾巴
FND	志愿
FNE	聲譽
FNF	䨒
FNG	堩
FNH	霞
FNI	墀
FNJ	聲明
FNK	霹
FNM	志丹
FNN	圯
FNP	迃
FNQ	聲名
FNR	霫
FNS	直屬機關
FNT	志向
FNU	忈
FNV	亐
FNW	聲
FNX	坭
FNY	聲望
FOA	壙
FOB	郝
FOC	垿
FOD	頳
FOE	赤膊
FOF	赫
FOG	墣
FOH	覝
FOI	塘沽
FOJ	赨
FOM	赤峰
FON	塶
FOO	埮
FOP	赤字
FOQ	赥
FOR	赫哲
FOT	赦
FOU	赤
FOV	塘
FOW	地廣人稀
FOX	烖
FOY	赤誠
FPA	考察工作
FPB	勃
FPD	槖
FPE	十字架
FPF	壺
FPG	壹
FPH	電視劇
FPI	電視小品
FPJ	塓
FPK	辻
FPL	堚
FPM	索賠
FPN	索性
FPO	電視廣告
FPP	赤裸裸
FPQ	埦
FPR	幸福的
FPS	坾
FPT	垞
FPU	索道
FPV	垵
FPW	坈
FPX	索
FPY	南宁市
FQA	坻
FQB	元
FQC	兘
FQD	頑
FQE	埆
FQF	坖
FQG	元素
FQH	頑皮
FQI	垗
FQJ	刓
FQK	堍
FQL	頑固
FQM	均由
FQN	雹
FQO	均應
FQP	元宵
FQQ	垑
FQR	圽
FQS	均可
FQT	均衡
FQU	均
FQV	埩
FQW	坎
FQX	黿
FQY	朮
FRA	朝气蓬勃
FRB	堫
FRC	坂
FRD	直接原因
FRE	地質學
FRF	支持者
FRG	垢
FRH	圻
FRI	喜气洋洋
FRJ	直接影響
FRK	支持單位
FRL	墲
FRM	十年內亂
FRN	塊狀
FRO	直接對話
FRP	零的突破
FRQ	塊
FRR	二把手
FRS	十年樹木
FRT	埤
FRU	支援前線
FRV	十年如一日
FRW	老年人
FRX	直接經濟損失
FRY	坼
FSA	土木工程
FSB	霜降
FSC	都可能
FSD	真相大白
FSF	堙
FSG	酨
FSH	霜
FSI	吉林省
FSJ	墰
FSK	坷
FSL	南极圈
FSM	栽贓
FSQ	需要解決
FSR	考核制度
FSS	霖
FST	二极管
FSU	雬
FSV	土木建筑
FSW	零配件
FSX	栽
FSY	霍林郭勒
FTA	圫
FTB	教
FTC	才能
FTD	垁
FTE	耂
FTF	霆
FTG	壎
FTH	埏
FTI	教堂
FTJ	者
FTK	垎
FTL	才略
FTM	塮
FTN	圪
FTO	墦
FTP	考察
FTQ	耇
FTR	教授
FTS	都要
FTT	耉
FTU	垀
FTV	都好
FTW	老人
FTX	老
FTY	坆
FUA	垪
FUB	干部子女
FUC	報務
FUD	埢
FUE	壠
FUF	雴
FUG	垃
FUH	達卡
FUI	增添
FUJ	境
FUK	培
FUL	增
FUM	增幅
FUN	增收
FUO	報廢
FUP	幸福
FUQ	壛
FUR	干部制度
FUS	墫
FUT	增生
FUU	增益
FUV	霎
FUW	塧
FUX	增強
FUY	赱
FVA	雪花
FVB	雪恥
FVD	雪原
FVE	垠
FVF	雪
FVG	垏
FVH	壗
FVI	埭
FVJ	雪景
FVL	封建思想
FVM	雪山
FVN	城建局
FVO	封建迷信
FVP	埽
FVR	雪白
FVS	雪柜
FVT	堖
FVU	幹群關係
FVV	老奶奶
FVW	超媒体
FVX	封建統治
FVY	雪亮
FWA	零散
FWB	邞
FWC	坄
FWD	垘
FWE	截肢
FWF	替
FWG	垥
FWH	規
FWI	截流
FWJ	圿
FWK	堢
FWL	熱點
FWM	椝
FWN	埠
FWO	零度
FWP	老人家
FWQ	截留
FWR	干休所
FWS	垛
FWT	堸
FWU	熱門
FWV	坋
FWW	赍
FWX	墢
FWY	零
FXC	䨎
FXD	毐
FXE	坳
FXF	熱線電話
FXG	堟
FXH	塡
FXI	增強黨性
FXJ	坲
FXK	教練員
FXL	增強團結
FXN	城鄉居民
FXP	老紅軍
FXR	十幾年來
FXS	教練機
FXT	二級簡碼
FXU	老弱病殘
FXV	城鄉建設
FXW	二級企業
FXX	堦
FXY	坶
FYA	教育工作
FYB	教育子女
FYC	堉
FYD	城市面貌
FYE	裁
FYF	霅
FYG	地方政府
FYH	地方戲
FYI	圡
FYJ	靄
FYK	壤
FYL	壇
FYM	地方財政
FYN	垓
FYO	塆
FYP	裁定
FYQ	地方色彩
FYR	雱
FYS	超文本
FYT	坊
FYU	雯
FYV	埌
FYW	坑
FYX	壪
FYY	南京市
GAA	琖
GAB	邢
GAC	邢台
GAD	琪
GAE	形
GAF	玵
GAG	玒
GAH	琊
GAI	弄清
GAJ	弄
GAK	瑾
GAL	東歐國家
GAM	瑛
GAN	玴
GAO	烎
GAP	形容
GAQ	璥
GAR	一切后果
GAS	弄權
GAT	璓
GAU	正式開始
GAV	整舊如新
GAW	珙
GAX	下世紀初
GAY	青藏高原
GBB	瑘
GBC	㻓
GBD	瓍
GBE	屯墾
GBF	專職幹部
GBG	珥
GBJ	屯昌
GBK	頓號
GBN	頓
GBP	一孔之見
GBQ	屯留
GBR	屯兵
GBW	現階段
GBX	互聯網
GBY	青出於藍
GCA	到期
GCB	致函
GCC	晉
GCD	一通百通
GCE	致力
GCF	至
GCG	至于
GCH	至此
GCI	至少
GCK	珆
GCL	到點
GCM	五台山
GCN	瑈
GCO	瑪
GCP	致富
GCQ	玧
GCR	到手
GCS	到校
GCT	晉升
GCU	丟
GCW	至今
GCX	晉級
GCY	㺨
GDA	⒎
GDB	形成了
GDC	蚕桑
GDD	△
GDE	瑚
GDF	幵
GDG	珬
GDH	玤
GDI	天
GDJ	奣
GDK	吞
GDL	◇
GDM	頊
GDN	忝
GDO	天麻
GDP	迗
GDQ	天然
GDR	「
GDS	琦
GDT	瓑
GDU	㺯
GDV	⒐
GDW	琫
GDX	№
GDY	天文
GEA	青工
GEB	琈
GEC	豝
GED	豲
GEE	靜
GEF	青
GEG	瑗
GEH	甫
GEI	豕
GEJ	蟸
GEK	珈
GEL	青田
GEM	青山
GEN	豭
GEO	逐鹿
GEP	逐
GEQ	豞
GER	豨
GES	表格
GET	玏
GEU	表彰
GEV	豤
GEW	豛
GEX	逐級
GEY	剢
GFA	五十七
GFB	邘
GFC	求真務實
GFD	瓀
GFE	一塊兒
GFF	珪
GFG	亞
GFH	玕
GFI	平均水平
GFJ	琎
GFK	于
GFL	盂
GFM	表示同意
GFN	璹
GFO	一塌糊涂
GFP	迂
GFQ	玩
GFR	副教授
GFS	東南西北
GFT	珯
GFU	現場辦公
GFV	五十九
GFW	玞
GFY	五十六
GGA	一切
GGB	一下子
GGC	琶
GGD	一套
GGE	琢
GGF	玗
GGG	王
GGH	五
GGI	一流
GGJ	瑼
GGK	珸
GGL	一
GGM	一同
GGN	瑟
GGO	瑨
GGP	一定
GGQ	璈
GGR	一年
GGS	琹
GGT	一种
GGU	玶
GGV	一群
GGW	琴
GGX	琵
GGY	一方
GHA	琥
GHB	下降
GHC	玻
GHD	正
GHE	正月
GHF	下去
GHG	焉
GHH	羐
GHI	下
GHJ	琸
GHK	玷
GHL	政界
GHM	下山
GHN	丐
GHO	政府
GHP	璿
GHQ	現
GHR	正气
GHS	下述
GHT	政
GHU	下次
GHV	正如
GHW	颪
GHX	玼
GHY	㺪
GIA	璖
GIB	救出
GID	互派大使
GIE	琑
GIF	琺
GIG	珖
GIH	政治上
GII	青海省
GIJ	求是
GIK	珠江口
GIL	政治思想
GIM	瑣
GIN	政治局
GIO	救火
GIP	瑺
GIQ	政治危机
GIR	青少年
GIS	至少可以
GIT	求得
GIU	政治部
GIV	珰
GIW	正常人
GIX	政治經濟
GIY	救
GJA	丣
GJB	專職
GJC	更能
GJD	更大
GJE	更加
GJF	理
GJG	刯
GJH	惠
GJI	東
GJJ	琩
GJK	丌
GJL	瑥
GJM	理由
GJN	更快
GJO	專業
GJP	惠安
GJQ	更多
GJR	更
GJS	理想
GJT	瑆
GJU	更新
GJV	更好
GJW	理念
GJX	琨
GJY	璟
GKA	事項
GKB	郚
GKC	融通
GKD	事故
GKE	琄
GKF	吾
GKG	丗
GKH	囊
GKI	整
GKJ	亜
GKK	卅
GKL	副
GKM	融
GKN	事情
GKO	速度
GKP	逜
GKQ	事儿
GKR	吏
GKS	整机
GKT	敔
GKU	豆
GKV	事
GKW	整体
GKX	束縛
GKY	速率
GLD	珚
GLF	環境
GLG	環
GLH	玾
GLI	柬
GLK	卌
GLL	瓃
GLM	環山
GLO	一團糟
GLP	璉
GLQ	㻿
GLR	環抱
GLT	環節
GLU	兩國關係
GLV	㻲
GLW	琾
GLX	環繞
GLY	正因為
GMA	遭
GMB	再出
GMC	叀
GMD	瑞
GME	勣
GMF	再
GMG	遭到
GMH	兩
GMI	刺
GMJ	曺
GMK	下崗員工
GML	兩國
GMM	珊
GMN	恵
GMO	再度
GMP	瑞安
GMQ	瑞金
GMR	棘手
GMS	′
GMT	再生
GMU	責
GMV	再婚
GMW	丙
GMX	兩級
GMY	珼
GNA	珉
GNB	㐏
GND	琚
GNE	惡性腫瘤
GNF	殖民地
GNG	珝
GNH	瑕
GNI	㝳
GNJ	到那時
GNK	瑋
GNM	致以崇高的敬意
GNN	瓦
GNP	一臂之力
GNQ	瓦解
GNR	戸
GNS	平裝本
GNT	攷
GNU	忢
GNV	丂
GNW	玦
GNX	戉
GNY	夨
GOA	政府工作
GOB	政府職能
GOD	事業成功
GOF	王府井
GOG	璞
GOH	烈火見真金
GOK	事業單位
GON	事業心
GOO	琰
GOP	政府官員
GOQ	璘
GOR	專業技術
GOS	政府机构
GOT	玩火自焚
GOU	政府部門
GOV	瑭
GOW	政府代表
GOX	政府總理
GOY	更應該
GPB	一定限度
GPC	一定能夠
GPD	辷
GPE	專家學者
GPF	琮
GPG	琔
GPH	琯
GPI	兩袖清風
GPJ	一定是
GPL	琿
GPM	一視同仁
GPN	現實情況
GPO	珠寶店
GPP	一審宣判
GPQ	琬
GPR	瑸
GPS	一定要
GPT	一定程度
GPU	現實意義
GPV	囊空如洗
GPW	琛
GPX	專家組
GPY	事實證明
GQA	殘
GQB	殛
GQC	殆
GQD	殎
GQE	殍
GQF	殖
GQG	琻
GQH	殩
GQI	歹
GQJ	列
GQK	殫
GQL	殬
GQM	殃
GQN	玸
GQO	列席
GQP	殯
GQQ	殉
GQR	殊
GQS	天然林
GQT	熬
GQU	殕
GQV	兀
GQW	殲
GQX	死
GQY	玖
GRA	更年期
GRB	珠子
GRC	天氣預報
GRD	碧
GRE	青年學生
GRF	青年干部
GRG	珀
GRI	珠
GRJ	一無是處
GRK	豆制品
GRL	璑
GRM	珤
GRN	一剎那
GRO	一手遮天
GRP	一气之下
GRQ	瑰
GRR	瓆
GRS	一年來
GRT	琕
GRU	棘手問題
GRV	一拍即合
GRW	青年人
GRX	瓅
GRY	璬
GSA	末期
GSB	末了
GSD	膥
GSE	互相學習
GSF	互相支持
GSG	一查到底
GSH	玎
GSI	末
GSJ	亍
GSK	珂
GSM	平頂山
GSN	末尾
GSR	末年
GSS	琳
GST	═
GSU	互相尊重
GSV	琴棋書畫
GSW	琜
GSY	東西方
GTA	一等功
GTB	琇
GTC	再生能源
GTD	琒
GTE	珘
GTF	瓚
GTG	珩
GTH	一般見識
GTI	政策水平
GTJ	琍
GTK	珞
GTL	璁
GTM	珦
GTN	琁
GTO	璠
GTP	五筆字型
GTQ	瓈
GTR	珴
GTS	更重要的是
GTT	平等待人
GTU	一知半解
GTV	副秘書長
GTW	瑽
GTX	珻
GTY	玫
GUA	事半功倍
GUB	一意孤行
GUC	平台
GUD	刾
GUE	瓏
GUF	平
GUG	珜
GUH	正義鬥爭
GUI	平常
GUJ	璋
GUK	琣
GUL	璔
GUM	平山
GUN	一次性
GUO	平庸
GUP	平安
GUQ	平遙
GUR	下半年
GUS	慭
GUT	平衡
GUU	再立新功
GUV	亊
GUW	一部分
GUX	珶
GUY	平方
GVA	勁
GVB	妻子
GVD	再好不過
GVE	珢
GVF	坙
GVG	珒
GVH	妻
GVI	琭
GVJ	璅
GVK	玿
GVL	到群眾中去
GVO	㻏
GVP	一怒之下
GVR	殘忍的
GVS	頸椎
GVT	瑙
GVV	一如既往
GVW	一九八四年
GVY	副書記
GWA	玳
GWB	玱
GWC	玜
GWD	瑖
GWE	珍
GWF	現代教育
GWG	瑜
GWH	整体上
GWI	整体水平
GWJ	玠
GWK	珍品
GWL	救命恩人
GWM	爾
GWN	瑡
GWO	青飼料
GWP	万分之
GWQ	專人負責
GWR	五体投地
GWS	珍本
GWT	珍稀
GWU	兲
GWV	玢
GWW	一体化
GWX	責任編輯
GWY	玲
GXA	毒草
GXC	互通
GXD	素有
GXE	互助
GXF	瑻
GXG	互
GXH	纛
GXI	素
GXJ	毒蛇
GXK	毒品
GXL	正統思想
GXM	再經過
GXN	毒性
GXP	毒害
GXQ	互勉
GXR	毒气
GXS	互相
GXT	互利
GXU	毒
GXW	夷
GXX	璣
GXY	互訪
GYA	理論基礎
GYB	班子
GYC	琉
GYD	一方面
GYE	珳
GYF	天主教
GYG	斑
GYH	玣
GYI	玉
GYJ	再就是
GYK	瓖
GYL	璮
GYM	玉山
GYN	一言以蔽之
GYO	平方米
GYP	更衣室
GYR	璃
GYS	玉林
GYT	班
GYU	璾
GYV	瑯
GYW	珓
GYX	玹
GYY	玟
HAA	虐
HAB	劇院
HAD	睰
HAE	皻
HAF	虞城
HAG	劇
HAH	頥
HAI	瞄準
HAJ	虛
HAK	虞
HAL	瞄
HAM	瞞
HAN	歫
HAO	覷
HAP	矇
HAQ	
HAR	眍
HAS	虨
HAT	處
HAU	瞄准
HAV	虍
HAW	虎
HAX	獻給
HAY	虔
HBA	齖
HBB	齱
HBC	齝
HBD	齮
HBE	齟
HBF	齻
HBG	眲
HBH	齜
HBJ	齒
HBK	齪
HBL	齫
HBM	䶡
HBN	齷
HBP	齳
HBQ	齣
HBR	齗
HBS	齼
HBT	齲
HBU	齴
HBV	齦
HBW	齡
HBX	齔
HBY	齩
HCA	皮革
HCB	皮子
HCC	眼巴巴
HCD	頗
HCE	頗受
HCF	皯
HCG	皮球
HCH	皮膚
HCI	皮
HCJ	㓟
HCK	眙
HCM	皮肉
HCN	瞲
HCP	皹
HCQ	皰
HCS	皮棉
HCT	眸
HCU	攴
HCV	㿪
HCW	皮貨
HCY	頗為
HDA	矋
HDB	輩出
HDD	卓有成效
HDE	歲月
HDF	睚
HDG	歲
HDH	輩
HDI	非常
HDJ	占有量
HDK	悲嘆
HDL	具有國際先進水平
HDM	頉
HDN	翡翠
HDP	見面禮
HDQ	斐然
HDS	悲歌
HDT	具有重要的
HDU	瞭
HDV	目不忍睹
HDW	睶
HDX	眬
HDY	狊
HEA	頗受歡迎
HEB	卡脖子
HEF	肯
HEG	眀
HEH	瞍
HEJ	瞬時
HEL	䂃
HEN	鬥爭性
HEP	瞬
HEQ	睨
HER	䁘
HES	睬
HET	䀐
HEU	瞬間
HEV	睜
HFB	上臺階
HFC	歧
HFD	處境尷尬
HFF	眭
HFH	盰
HFI	眎
HFJ	鬥志昂揚
HFK	睵
HFL	歧異
HFM	歧山
HFN	歧异
HFO	睦鄰
HFP	歧視
HFQ	盶
HFS	縣直機關
HFT	睹
HFU	歧義
HFW	睦
HFY	悲喜交集
HGA	上工
HGB	盹
HGC	眰
HGD	上
HGE	睛
HGF	盱
HGG	鬧
HGH	卡
HGI	叔
HGJ	上映
HGK	上路
HGL	上回
HGM	歵
HGN	忐
HGO	上火
HGP	上空
HGQ	上旬
HGR	卡拉
HGS	眜
HGT	上升
HGU	上前
HGV	睫
HGW	仧
HGX	眱
HGY	上市
HHA	矑
HHB	步子
HHC	步驟
HHD	頻
HHF	止境
HHG	止
HHH	目
HHI	目光
HHK	目瞪口呆
HHL	丨
HHN	愳
HHO	煛
HHP	瞾
HHQ	睍
HHR	步
HHS	目標
HHT	步入
HHU	歨
HHV	非此即彼
HHW	瞿
HHX	瞠目結舌
HHY	頻率
HIB	非法出版物
HID	非常成功
HIE	睄
HIF	縣城
HIG	懸殊
HII	非常清楚
HIJ	非常明顯
HIK	非常嚴重
HIL	非洲國家
HIM	懸崖
HIN	非常快
HIO	非常精彩
HIP	矘
HIQ	非常危險的
HIR	非法所得
HIS	柴油机
HIT	縣
HIU	非常痛快
HIV	非常好
HIW	非常保守
HIX	縣級
HIY	上海市
HJA	卓著
HJB	桌子
HJD	桌面
HJE	非暴力手段
HJF	卓
HJG	睼
HJH	眒
HJI	䁜
HJP	䁙
HJQ	児
HJS	桌
HJT	睲
HJU	卓資
HJX	卓絕
HJY	卓識
HKB	䁒
HKC	梷
HKD	奌
HKE	睊
HKF	占地
HKG	睈
HKH	覘
HKJ	㓠
HKK	瞣
HKM	䁚
HKN	乩
HKP	迠
HKQ	眖
HKR	占据
HKT	占先
HKW	占住
HLE	䁌
HLF	盀
HLG	睤
HLK	㔽
HLL	見異思遷
HLM	䁲
HLO	鹹
HLR	卥
HLS	睏
HLV	瞜
HLW	㮚
HLX	縣團級
HMA	欳
HMD	眏
HMF	睭
HMG	眮
HMH	具體目標
HMI	非同小可
HMM	具體內容
HMN	卣
HMP	遉
HMQ	具體負責
HMR	具體措施
HMS	具體要求
HMT	貞節
HMU	貞
HMV	非同尋常
HMW	具體化
HMX	懸崖絕壁
HMY	具體方法
HNA	眠
HNB	瞰
HND	鼎
HNE	虛心學習
HNG	肯尼亞
HNH	睱
HNI	矚
HNK	䁹
HNM	凹
HNN	㠯
HNR	悲慘的
HNT	處心積慮
HNU	鼎立
HNV	郻
HNW	矅
HNX	眤
HOA	矌
HOB	歯
HOD	睦鄰友好
HOG	瞨
HOI	柴米油鹽
HON	虛榮心
HOO	睒
HOP	瞇
HOQ	瞵
HOR	虛度年華
HOU	睦鄰關係
HOV	瞊
HPB	瞎子
HPD	瞎
HPE	肻
HPF	睆
HPG	睿
HPH	虎視眈眈
HPJ	瞑
HPL	睴
HPN	矃
HPQ	眈
HPR	瞎搞
HPS	眝
HPT	敹
HPV	㢟
HPY	非官方
HQA	眂
HQB	見
HQC	餐
HQD	瞻
HQF	見報
HQG	見到
HQH	覞
HQI	眺
HQJ	眴
HQK	眗
HQL	餐車
HQM	矎
HQN	非金屬
HQO	餐廳
HQQ	眵
HQR	覐
HQS	見機
HQT	覹
HQU	歺
HQV	見好
HQW	瞻仰
HQX	紫外線
HQY	眺望
HRA	獻殷勤
HRB	䁓
HRC	眅
HRD	睎
HRE	眽
HRF	瞃
HRG	虛擬現實
HRH	盺
HRI	目無法紀
HRL	瞴
HRN	目的性
HRP	矈
HRQ	䁛
HRR	瞎指揮
HRS	虛無飄渺
HRT	睥
HRU	目的意義
HRW	眣
HRX	虛無縹緲
HRY	虛無主義
HSF	瞟
HSG	目標責任製
HSH	盯
HSJ	瞫
HSK	㱒
HSS	桌椅板凳
HST	目標管理
HSU	上述問題
HSV	䁏
HSW	睞
HTA	瞬息萬變
HTD	見物不見人
HTE	歬
HTF	睡
HTG	歱
HTH	矏
HTK	上等品
HTM	矀
HTN	盵
HTO	瞅
HTP	眨
HTR	睋
HTS	睡醒
HTT	步行街
HTU	睡意
HTV	縣委書記
HTW	瞛
HTX	䀲
HTY	非生產性建設
HUC	見義勇為
HUD	眹
HUE	矓
HUF	上半場
HUG	眫
HUH	睜開眼睛
HUJ	瞳
HUK	督導員
HUL	䁬
HUM	皮開肉綻
HUN	矙
HUR	目前的
HUT	眼前利益
HUU	上半部
HUV	瞬間即逝
HUW	此間人士
HUX	睇
HUY	瞻前顧後
HVE	眼
HVF	眼熱
HVG	睷
HVH	眼睛
HVI	睩
HVK	眧
HVL	眼界
HVP	眼帘
HVQ	眼色
HVR	眼看
HVT	眼科
HVU	眼前
HVW	處女作
HVX	眼紅
HVY	見好就收
HWA	具体工作
HWB	龁
HWC	瞈
HWD	具有
HWE	眕
HWF	虛假報告
HWG	瞪
HWH	瞪眼
HWJ	見分曉
HWL	見風轉舵
HWM	具體
HWN	睺
HWO	虛假廣告
HWP	具体安排
HWQ	具名
HWR	具体措施
HWS	具体要求
HWU	具
HWV	盼
HWW	睉
HWX	具結
HWY	瞧
HXA	柴草
HXB	紫陽
HXD	砦
HXE	眑
HXF	些
HXG	此事
HXH	眥
HXI	柴油
HXJ	歶
HXK	呰
HXM	貲
HXN	此
HXO	此類
HXP	此案
HXQ	觜
HXR	矊
HXS	柴
HXT	此种
HXU	此次
HXV	姕
HXW	雌
HXX	紫
HXY	訾
HYA	鬧市區
HYC	瞮
HYF	見諸報端
HYG	步調一致
HYH	獻計獻策
HYK	瞓
HYL	䁴
HYN	盳
HYP	處於被勳狀態
HYR	瞝
HYS	步話機
HYT	眆
HYU	䁤
HYV	䀶
HYW	睟
HYX	眩
HYY	盿
IAA	淺
IAB	江陵
IAC	港台
IAD	湛
IAE	潵
IAF	泔
IAG	江
IAH	濫
IAI	洪水
IAJ	漠
IAK	灌
IAL	渵
IAM	滿
IAN	㲺
IAO	瀳
IAP	濛
IAQ	滯
IAR	泄气
IAS	柒
IAT	流芳千古
IAU	灡
IAV	沏
IAW	洪
IAX	瀕臨絕境
IAY	㳀
IBA	洗耳恭听
IBB	灄
IBC	溋
IBD	瀡
IBE	泐
IBF	池塘
IBG	洱
IBH	滍
IBI	涵
IBJ	消除影響
IBK	凼
IBL	瀆職罪
IBM	泏
IBN	池
IBP	海陸空
IBQ	決出名次
IBR	派出所
IBS	派出机构
IBT	漋
IBU	涵義
IBW	滁
IBX	㶌
IBY	滁州
ICA	汗馬功勞
ICB	常駐聯合國代表
ICC	滲
ICD	津巴布韋
ICE	湧
ICF	涌起
ICG	治理
ICH	浚縣
ICI	治水
ICJ	流通量
ICK	治
ICL	治罪
ICM	治山
ICN	汿
ICO	溤
ICP	治安
ICQ	沇
ICR	流通手段
ICS	治本
ICT	洠
ICU	治病
ICW	治愈
ICY	汊
IDA	濿
IDB	尖子
IDC	汯
IDD	深有感触
IDE	湖
IDF	涯
IDG	沽
IDH	潔
IDI	尜
IDJ	淹
IDK	湖口
IDL	湖畔
IDM	湎
IDN	厳
IDO	洃
IDP	
IDQ	減免
IDR	源
IDS	渏
IDT	瀝
IDU	尖
IDV	尖刀
IDW	湊
IDX	減弱
IDY	汰
IEA	湼
IEB	浮
IEC	淝
IED	小朋友
IEE	滔
IEF	肖
IEG	沮
IEH	溲
IEI	滔滔
IEJ	削
IEK	泇
IEL	灂
IEM	浮雕
IEN	混亂狀態
IEP	逍
IEQ	潟
IER	滛
IES	小學校
IET	淫
IEU	水力資源
IEV	淨
IEW	削价
IEX	鸂
IEY	水乳交融
IFA	灞
IFB	法院
IFC	法
IFD	濡
IFE	深圳股市
IFF	坔
IFG	汢
IFH	汗
IFI	沬
IFJ	潮
IFK	澎
IFL	瀆
IFM	湳
IFN	濤
IFO	浾
IFP	渤
IFQ	沅
IFR	法制
IFS	溨
IFT	渚
IFU	涬
IFW	淕
IFX	法紀
IFY	深圳市
IGA	汧
IGB	沌
IGC	洷
IGD	添
IGE	清
IGF	汙
IGG	汪
IGH	沔
IGI	浗
IGJ	洹
IGK	漱
IGL	湅
IGM	沛
IGN	汅
IGO	溍
IGP	清官
IGQ	耀
IGR	激烈的
IGS	沫
IGT	清算
IGU	泙
IGV	淒
IGW	挙
IGX	溼
IGY	光亮
IHA	濾
IHB	涉及
IHC	波
IHD	渄
IHE	小股
IHF	小雨
IHG	沚
IHH	涉
IHI	渺
IHJ	淖
IHK	惉
IHL	滷
IHM	湞
IHN	濎
IHO	小康
IHP	濬
IHQ	瀣
IHR	小看
IHS	小麥
IHT	小
IHU	波音
IHV	小姐
IHW	濉
IHX	泚
IHY	氺
IIA	濷
IIB	消除
IIC	港澳台
IID	消耗
IIE	消
IIF	深深地
IIG	洸
IIH	污水處理
III	淼
IIJ	涾
IIK	水路
IIL	海洛因
IIM	淌
IIN	水性
IIO	水底
IIP	漟
IIQ	淡泊名利
IIR	消失
IIS	消极
IIT	沙
IIU	水准
IIV	消退
IIW	消化
IIX	消費
IIY	沝
IJA	瀑
IJB	小日子
IJD	瀑布
IJE	混亂
IJF	沓
IJG	汨
IJH	漫步
IJI	滉
IJJ	淐
IJK	混戰
IJL	漫
IJM	湡
IJN	溻
IJO	清晰度
IJP	洩密
IJQ	渴
IJR	光明的
IJS	巣
IJT	湦
IJU	光明前景
IJV	漫畫
IJW	混合
IJX	混
IJY	灝
IKA	泥足巨人
IKB	湒
IKC	浥
IKE	涓
IKF	呇
IKG	塣
IKH	汌
IKI	沖洗
IKK	澡
IKL	沖擊
IKM	涢
IKN	沖刷
IKO	潰爛
IKP	沖突
IKQ	況
IKR	沖撞
IKS	潞西
IKT	削足适履
IKU	潰瘍
IKV	潰退
IKW	演唱會
IKX	㕾
IKY	海口市
ILA	戦
ILB	小圈子
ILC	溫柔
ILD	涸
ILE	渭
ILF	泴
ILG	泗
ILH	㳌
ILI	漯河
ILJ	単
ILK	洄
ILL	灅
ILM	溫嶺
ILN	潿
ILO	溫度
ILP	漣
ILQ	濁
ILR	漸
ILS	涃
ILT	溫和
ILU	溿
ILV	漊
ILW	泅
ILX	漯
ILY	溫州
IMA	澧
IMB	小冊子
IMC	測驗
IMD	湍
IME	滑
IMF	淍
IMG	油
IMH	汕
IMI	油漆
IMJ	測
IMK	尚
IML	油田
IMM	瀴
IMN	渦
IMO	油料
IMP	漴
IMQ	湍急
IMR	油气
IMS	尚可
IMT	溄
IMU	潂
IMW	涔
IMX	測繪
IMY	浿
INA	泯
INB	潺
INC	泥巴
IND	涺
INE	決勝
INF	漏
ING	渥
INH	湄
INI	漽
INK	浺
INL	瀷
INM	涮
INN	汜
INO	澱粉
INP	瀈
INQ	決然
INR	漝
INT	泌
INU	漏斗
INV	泦
INW	決
INX	泥
INY	沁
IOA	渡
IOB	海底隧道
IOD	水火不相容
IOG	澲
IOI	淡水
IOJ	瀍
IOK	渡口
IOL	瀵
IOM	渡過
ION	漉
IOO	淡
IOP	小康社會
IOQ	潾
IOR	輝煌的
IOS	灖
IOT	㲿
IOU	濂
IOV	溏
IOW	淡化
IOY	洣
IPA	瀽
IPB	
IPC	常務
IPD	浤
IPE	瀉
IPF	淙
IPG	濱
IPH	涫
IPI	常常
IPJ	溟
IPK	當
IPL	渾
IPM	峃
IPN	濘
IPO	深度
IPP	深邃
IPQ	沈
IPR	党的
IPS	栄
IPT	瀋
IPU	滓
IPV	洝
IPW	深
IPX	沱
IPY	深刻
IQA	汦
IQB	瀏陽
IQC	沒
IQD	澹
IQE	淊
IQF	溜走
IQG	淦
IQH	淡然處之
IQI	洮
IQJ	洵
IQK	浼
IQL	漠然置之
IQM	渙
IQN	泡
IQO	漁
IQP	濥
IQQ	沉甸甸
IQR	淘
IQS	盜權
IQT	漪
IQU	汮
IQV	浄
IQW	盜
IQX	涉外經濟
IQY	汐
IRA	黨的基本路線
IRB	派出
IRC	汳
IRD	淆
IRE	派
IRF	垽
IRG	泊
IRH	沂
IRI	洙
IRJ	激昂
IRK	派遣
IRL	潕
IRM	峾
IRN	汽
IRO	派對
IRP	少年之家
IRQ	溾
IRR	浙
IRT	渒
IRU	法製意識
IRV	溵
IRW	泆
IRX	濼
IRY	激
ISA	法西斯
ISB	溧陽
ISC	消极怠工
ISD	酒厂
ISE	涁
ISF	漂
ISG	酒
ISH	汀
ISI	江西省
ISJ	潭
ISK	河
ISL	河畔
ISM	河山
ISN	劣根性
ISO	潥
ISP	酒家
ISR	淅
ISS	淋
IST	漂移
ISU	河北
ISV	㴗
ISW	漆
ISX	湘鄉
ISY	沐
ITA	洚
ITB	沲
ITC	活動能力
ITD	活
ITE	少
ITF	浩
ITG	汼
ITH	省
ITI	潲
ITJ	浰
ITK	洛
ITL	洫
ITM	澳
ITN	汔
ITO	潘
ITP	活塞
ITQ	海外
ITR	涐
ITS	流行歌曲
ITT	毟
ITU	泈
ITV	潷
ITW	漎
ITX	海
ITY	汷
IUA	洴
IUB	溯
IUC	㶒
IUD	浂
IUE	湔
IUF	溬
IUG	泣
IUH	洋縣
IUI	河北省
IUJ	澗
IUK	涪
IUL	潧
IUM	潎
IUN	當前狀況
IUO	湴
IUP	法新社
IUQ	澬
IUR	灁
IUS	湭
IUT	浐
IUU	灍
IUV	淁
IUW	溢
IUX	滋
IUY	潣
IVA	潯
IVB	激怒了
IVC	溉
IVD	游刃有余
IVE	泿
IVF	潚
IVG	汝
IVH	濜
IVI	浸泡
IVJ	漅
IVK	沼
IVL	淄
IVM	梁山
IVN	氿
IVO	染料
IVP	浸
IVQ	染色
IVR	沼气
IVS	染
IVT	涒
IVU	染病
IVV	小姑娘
IVW	粱
IVY	澀
IWA	浌
IWB	小伙子
IWC	滃
IWD	洑
IWE	脊
IWF	泭
IWG	塗
IWH	滌
IWI	沿海
IWJ	準時
IWK	沿
IWL	潑墨
IWM	沿岸
IWN	㲹
IWO	濮
IWP	浴室
IWR	滏
IWS	脊柱
IWT	渢
IWU	氼
IWV	汾
IWW	浴
IWX	潑
IWY	淮
IXA	消費基金
IXB	渳
IXC	泓
IXD	漲
IXE	泑
IXF	消費者
IXG	澠
IXH	黨紀處分
IXI	消費水平
IXJ	沸
IXK	漒
IXL	黨紀國法
IXM	漲幅
IXQ	滯納金
IXS	常綠植物
IXT	省紀委
IXU	溺
IXV	黨組書記
IXW	濰
IXX	沘
IXY	消費市場
IYA	浪花
IYB	游子
IYC	流
IYD	流感
IYE	㳖
IYF	流域
IYG	乼
IYH	汴
IYI	浪潮
IYJ	済
IYK	淳
IYL	澶
IYM	注冊
IYN	滬
IYO	洂
IYP	游客
IYQ	注解
IYR	灕
IYS	洗衣机
IYT	洲
IYU	滴
IYV	浪
IYW	液
IYX	灣
IYY	汶
JAA	暱
JAB	昻
JAD	蟒
JAE	昮
JAF	畢
JAG	虹
JAH	蚜
JAI	蜡染
JAJ	㫒
JAK	蜮
JAL	蠛
JAM	蟥
JAN	蝶
JAO	畢業
JAP	蠓
JAQ	曔
JAR	顯著提高
JAS	最基本的
JAT	蠮
JAU	畢竟
JAV	蟏
JAW	暴
JAY	星期六
JBC	最
JBD	最大
JBE	朂
JBF	㫗
JBG	虸
JBH	㫞
JBI	蜬
JBJ	最早
JBK	蟶
JBL	蜢
JBM	昢
JBN	虵
JBP	最初
JBQ	最多
JBR	最近
JBT	最先
JBU	最新
JBV	最好
JBW	最佳
JBX	最終
JBY	昅
JCA	昪
JCC	蝃
JCE	蛹
JCJ	螞蟻
JCK	㬃
JCM	䝨
JCN	蚆
JCO	螞
JCQ	里通外國
JCR	暢通無阻
JCT	蛑
JCW	晙
JDA	蠣
JDB	蚅
JDC	蛂
JDD	是否有可能
JDE	蝴
JDF	晨
JDG	蛄
JDH	蚌
JDI	晨光
JDJ	昦
JDM	暊
JDN	晟
JDR	螈
JDS	是不可能的
JDT	是否符合
JDU	旲
JDW	蛺
JDX	昽
JDY	明确方向
JEA	日用工業品
JEB	蜉
JED	猒
JEE	蛠
JEF	冐
JEG	明
JEH	螋
JEI	暖流
JEJ	明星
JEK	日用品
JEL	盟
JEN	明快
JEO	焽
JEP	曖
JEQ	晲
JER	暚
JET	㫑
JEU	明辨
JEV	明媚
JEW	明令
JEX	螇
JEY	明亮
JFA	暁
JFB	時限
JFC	野
JFD	蠕
JFE	時興
JFF	蛙
JFG	晴雨表
JFH	旰
JFI	昧
JFJ	早
JFK	蟛
JFL	旱田
JFM	蝻
JFN	早已
JFO	黒
JFP	曀
JFQ	蚖
JFR	早年
JFS	時機
JFT	暑
JFU	蟽
JFV	果真如此
JFW	蚨
JFY	䖞
JGA	蚈
JGB	旽
JGC	蛭
JGD	昊
JGE	晴
JGF	旦
JGG	旺
JGH	題
JGI	蛷
JGJ	量
JGK	晤
JGL	暕
JGM	曬
JGO	量度
JGP	晴空
JGQ	敭
JGR	昨天的
JGS	昩
JGT	旺季
JGU	蚲
JGV	蛵
JGW	鴠
JGX	蛦
JGY	晴朗
JHA	曥
JHB	虫子
JHC	蚾
JHD	暃
JHE	冒用
JHF	冒
JHG	朄
JHH	刂
JHI	冒尖
JHJ	暢
JHK	申
JHM	＃
JHN	曰
JHO	冒火
JHP	迧
JHQ	蜆
JHR	冒失
JHS	申述
JHT	毷
JHU	申辦
JHW	明眼人
JHX	蟕
JHY	虲
JIA	蟝
JID	最深厚的
JIE	蛸
JIG	晃
JII	日光浴
JIJ	最清晰
JIM	㫾
JIO	日光燈
JIP	螳
JIR	最小的
JIT	日常生活
JIU	日常辦公
JIW	蝋
JIY	最深刻
JJA	曝
JJB	日子
JJD	昌盛
JJE	日用
JJF	昌
JJG	昍
JJH	蝐
JJI	日常
JJJ	晶
JJK	日中
JJL	蝹
JJM	晶體
JJN	明顯改善
JJO	焸
JJP	暥
JJQ	蠍
JJR	日后
JJS	蜾
JJT	暒
JJU	日前
JJV	明顯好轉
JJW	晶体
JJX	蜫
JJY	䖵
JKB	蟬聯
JKE	蜎
JKG	蜈
JKH	蚛
JKI	暗中活動
JKJ	早中晚
JKK	蟬
JKM	日喀則
JKP	野戰軍
JKQ	㫛
JKR	暗中摸索
JKT	最嚴重的
JKV	暴跳如雷
JLA	蟈
JLC	曼
JLE	蝟
JLF	昷
JLG	蠉
JLH	蛼
JLI	曙光
JLK	蛔
JLL	蠝
JLQ	蠋
JLR	螹
JLS	星羅棋布
JLT	蜠
JLV	螻
JLW	曼谷
JLX	螺
JLY	日思夜想
JMA	蛐
JMB	映出
JMD	映
JME	螖
JMF	蚺
JMG	蚰
JMH	愚
JMJ	旵
JMM	蠳
JMN	蝸
JMP	遇害
JMQ	愚鈍
JMR	蛧
JMT	映射
JMU	蝄
JMW	蚋
JMY	蛽
JND	蜛
JNF	野心勃勃
JNG	蛡
JNH	暇
JNI	曯
JNJ	時快時慢
JNK	暐
JNN	蟤
JNP	遢
JNR	旸
JNT	毾
JNW	曜
JNX	蚭
JNY	蚇
JOA	曠
JOC	昿
JOF	畢業考試
JOG	曗
JOI	最廣泛
JOJ	易燃易爆
JOM	畢業典禮
JON	螰
JOO	蠑
JOQ	暽
JOS	䗫
JOT	畢業生
JOU	炅
JOV	螗
JOW	畢業分配
JOY	炚
JPA	時空觀
JPD	曢
JPF	晥
JPG	暄
JPH	影視劇
JPJ	螟
JPK	最寶貴的
JPL	暈
JPN	曉之以理
JPO	蜂窩煤
JPQ	蜿
JPT	明察秋毫
JPV	晏
JPW	螲
JPX	蛇
JPY	㬕
JQA	曻
JQB	昂
JQD	蟾
JQE	蜭
JQF	易地
JQG	易于
JQH	晚上
JQI	晁
JQJ	㫬
JQK	晚
JQL	蜔
JQM	蝜
JQN	蚫
JQO	易燃
JQP	晚宴
JQQ	蛥
JQR	易
JQS	影印机
JQT	昴
JQU	昀
JQV	晚婚
JQW	歇
JQY	旳
JRB	蝬
JRC	昄
JRD	晞
JRE	最后胜利
JRF	最近十多年來
JRG	蝗
JRH	昕
JRI	蛛
JRL	蟱
JRM	㫼
JRN	暣
JRQ	螝
JRR	晣
JRT	蜱
JRW	昳
JRX	最近幾年
JRY	曒
JSD	顆
JSE	褁
JSF	螵
JSG	日本政府
JSH	虰
JSI	果
JSJ	曋
JSK	蚵
JSL	果園
JSM	果農
JSN	果敢
JSO	顆粒
JSP	照本宣科
JSQ	夥
JSR	晰
JSS	晽
JST	㪙
JSU	杲
JSW	蜙
JSX	果斷
JSY	蚞
JTA	昇
JTB	蜏
JTD	蜂
JTE	最後勝利
JTF	蜓
JTG	星
JTH	昨
JTI	星光
JTJ	蝮
JTK	蛒
JTL	螕
JTM	晌
JTN	虼
JTO	蟠
JTP	蜂蜜
JTQ	顯微鏡
JTR	蛾
JTS	最重要的
JTT	星系
JTU	蝌
JTV	蜲
JTW	暰
JTX	晦
JTY	暀
JUA	蛢
JUD	最新成果
JUE	曨
JUF	昱
JUG	蟻
JUH	日益頻繁
JUI	日益激烈的
JUJ	暗
JUK	暗中
JUL	㬝
JUM	日益豐富
JUN	日益改善
JUO	䗒
JUP	日益突出
JUQ	蠀
JUR	最新的
JUS	蝤
JUT	螏
JUU	時間差
JUV	螊
JUW	螠
JUX	晜
JUY	最新調查表明
JVA	蟳
JVB	旯
JVC	蝍
JVD	照面
JVE	蛝
JVF	妟
JVG	昭平
JVI	曃
JVJ	照明
JVK	照
JVL	蠟
JVO	照料
JVP	照實
JVR	最好的
JVS	照相
JVT	旫
JVU	照章
JVW	照例
JVY	照亮
JWA	蚮
JWB	冒風險
JWC	蚣
JWD	最偉大的
JWE	昣
JWF	暩
JWG	蛤
JWH	螩
JWI	㬰
JWJ	蚧
JWK	蛻
JWL	最低點
JWN	螄
JWO	愚公精神
JWR	蚥
JWT	晶体管
JWU	時代背景
JWV	昐
JWW	最低价
JWX	最低綱領
JWY	晗
JXA	顯著
JXB	㫐
JXC	蛛絲馬蹟
JXD	最強大
JXE	蚴
JXF	顯示
JXG	蠅
JXH	蚓
JXI	最經濟
JXJ	昲
JXK	顯貴
JXM	昆山
JXP	最終實現
JXQ	顯然
JXR	果斷措施
JXS	影響極壞
JXT	曏
JXW	昆侖
JXX	顯
JXY	曵
JYA	景觀
JYB	影院
JYC	蜟
JYD	ア
JYF	蠩
JYG	蛀
JYH	景頗
JYI	あ
JYJ	影星
JYK	影
JYL	蟺
JYM	景山
JYN	蝙
JYP	景宁
JYQ	景象
JYR	昘
JYS	℡
JYT	昉
JYU	旻
JYV	螂
JYW	蛟
JYX	蟀
JYY	蚊
KAA	中醫藥
KAB	中醫院
KAC	哄騙
KAD	嘶
KAE	中醫學
KAF	囈
KAG	叿
KAH	呀
KAI	中共黨員
KAJ	噶
KAK	嘞
KAL	喵
KAM	咂
KAN	喋
KAP	患難之交
KAQ	囌
KAR	哎
KAS	呆若木雞
KAT	哄笑
KAU	囒
KAV	中華書局
KAW	嗬
KAX	跨世紀
KAY	嚆
KBB	囁
KBC	㖩
KBE	唨
KBF	咠
KBG	吇
KBH	叩
KBI	㖤
KBK	吼叫
KBM	咄
KBN	吼
KBO	吸煙
KBQ	口出狂言
KBS	啊
KBT	嗤笑
KBU	中聯部
KBX	戢
KBY	吸
KCB	邑
KCC	嗓
KCE	嗵
KCG	串通一气
KCI	啜泣
KCJ	只能是
KCK	咍
KCN	吧
KCO	嗎
KCQ	吮
KCT	唉
KCU	嗓門
KCW	唆
KDA	咗
KDB	呃
KDC	吰
KDE	哊
KDF	喹
KDG	咕
KDH	嘎
KDI	吃不消
KDJ	喱
KDK	喊叫
KDL	吳邦國
KDM	順
KDN	哤
KDO	咴
KDQ	吃大鍋飯
KDR	嚴厲打擊
KDS	喊醒
KDT	嚦
KDU	嘹
KDW	唪
KDX	吐故納新
KDY	吠
KEA	哺乳期
KEB	哹
KEC	㖬
KED	另有
KEE	嗋
KEF	肙
KEG	咀
KEH	嗖
KEI	口服液
KEJ	剈
KEK	咖
KEL	嚼
KEM	戰爭賠償
KEN	口服心服
KEO	哺乳類
KEP	噯
KEQ	唲
KER	另
KES	啋
KET	叻
KEU	品學兼優
KEV	哸
KEW	鵑
KEX	嗘
KEY	另議
KFA	噴
KFB	哋
KFC	吱
KFD	嚅
KFF	哇
KFG	吐
KFH	嗔
KFI	味
KFJ	嘲
KFK	嘻
KFL	鄙
KFM	喃
KFN	嚋
KFO	嚇
KFP	嗦
KFR	中老年
KFS	吃老本
KFT	嗜
KFU	噠
KFV	嗜好
KFW	呋
KFY	吋
KGA	咞
KGB	噸
KGC	咥
KGD	另一面
KGE	哺
KGF	呈
KGG	㕵
KGH	嘕
KGI	中下游
KGJ	哽
KGK	嗽
KGL	號數
KGM	嘈
KGN	號
KGP	逞
KGQ	咧
KGR	唯一的
KGT	另一种
KGU	呯
KGV	啑
KGW	吨位
KGX	咦
KGY	另一方面
KHA	距
KHB	嚙
KHC	踴
KHD	跨
KHE	踩
KHF	躊
KHG	貴
KHH	趾
KHI	踏
KHJ	踢
KHK	中
KHL	盅
KHM	蹦
KHN	忠
KHO	踱
KHP	躥
KHQ	跑
KHR	跌
KHS	躚
KHT	蹤
KHU	足
KHV	跟
KHW	趴
KHX	嘴
KHY	卟
KID	川流不息
KIE	哨
KIF	中小城市
KIG	咣
KIH	啵
KII	唦
KIK	吵嘴
KIM	嗩
KIP	嚐
KIR	哨所
KIT	吵
KIW	中小企業
KJA	嗶
KJB	嘬
KJE	喝彩
KJF	哩
KJG	呾
KJH	呻
KJI	喝酒
KJJ	唱
KJK	呻吟
KJL	嗢
KJM	喁
KJN	口是心非
KJQ	喝
KJR	吃里爬外
KJS	嗮
KJT	唱片
KJU	喅
KJW	雖
KJX	㖂
KJY	雖說
KKA	噐
KKB	郘
KKC	唈
KKD	器
KKE	哵
KKF	鄂
KKG	吅
KKH	串
KKI	口水
KKJ	丳
KKK	品
KKL	戰
KKM	
KKN	嘂
KKO	戰火
KKP	斝
KKQ	呪
KKR	口气
KKS	槑
KKT	品种
KKU	遻
KKV	咆哮如雷
KKW	咒
KKX	單純
KKY	喌
KLA	嘓
KLB	中國隊
KLC	中國通
KLD	嗯
KLE	喟
KLF	嘿
KLG	呬
KLH	呷
KLI	嚃
KLK	咽喉
KLL	戰略思想
KLM	嘪
KLN	戰略性
KLO	中國煙草總公司
KLP	嗹
KLQ	啰
KLR	中國的
KLS	中國核工業總公司
KLT	中國科學院
KLU	嚺
KLV	嘍
KLW	中國人
KLX	囉
KLY	中國文化
KMA	嗣
KMB	鄖
KMC	中央預算
KMD	喘
KME	勛
KMF	啁
KMG	哃
KMH	鄖縣
KMI	中央党校
KMK	路由器
KML	中央國家機關
KMM	嚶
KMN	喎
KMO	中央精神
KMP	中央社
KMQ	中央銀行
KMR	中央的
KMS	中央機關
KMT	吶
KMU	員
KMV	中央書記處
KMW	嗺
KMX	中央紀委
KMY	唄
KNA	叫苦
KNB	啒
KNC	哪能
KND	吳
KNE	哪兒
KNF	中心城市
KNG	哪
KNH	叫
KNI	囑
KNJ	哪里
KNK	噼
KNL	中心思想
KNM	唰
KNN	呡
KNO	叫座
KNQ	哪儿
KNR	遺憾的是
KNS	吳橋
KNT	㕧
KNU	躍居首位
KNV	叫好
KNW	吷
KNX	呢
KNY	吣
KOA	喥
KOB	順應了
KOF	唱對臺戲
KOG	噗
KOH	㖢
KOI	順應潮流
KOK	嘮叨
KOO	嘮
KOP	中庸之道
KOQ	噒
KOS	嘛
KOV	嘃
KOY	咪
KPA	噻
KPD	嗐
KPE	口蜜腹劍
KPF	唍
KPG	喧
KPH	喧鬧
KPK	喧嚷
KPL	喗
KPN	嘧
KPQ	啘
KPT	喀
KPU	中宣部
KPV	咹
KPW	嚓
KPX	咜
KQA	呧
KQB	兄
KQD	嘫
KQE	啗
KQF	喚起
KQG	唫
KQH	別處
KQI	咷
KQJ	別
KQK	呴
KQL	別國
KQM	喚
KQN	咆
KQO	嚕
KQP	別字
KQQ	哆
KQR	吻
KQS	喚醒
KQT	唙
KQU	呁
KQV	喼
KQW	吹
KQX	躍然紙上
KQY	嚠
KRA	唣
KRB	听取
KRC	呱
KRD	唏
KRE	哌
KRF	唕
KRG	㕷
KRH	啣
KRI	史
KRK	哪年哪月
KRL	嘸
KRM	嚹
KRN	別無選擇
KRO	史料
KRP	史實
KRQ	啲
KRR	啪
KRS	咑
KRT	啤
KRU	啦
KRV	史書
KRW	呹
KRX	喞
KRY	噭
KSA	中西醫結合
KSB	喀麥隆
KSC	只要能
KSD	喖
KSF	嘌
KSG	哂
KSH	叮
KSI	呆滯
KSJ	喳
KSK	呵
KSL	㘄
KSM	呆帳
KSP	中樞神經
KSR	唽
KSS	噤
KST	嚴格管理
KSU	呆
KSV	喓
KSW	嘜
KSX	嚴格紀律
KSY	㕲
KTA	噬
KTB	唀
KTC	另行通知
KTD	咶
KTE	吃力
KTF	唾
KTG	吽
KTH	川
KTI	呼和浩特
KTJ	唎
KTK	咯
KTL	囖
KTM	噢
KTN	吃惊
KTO	啾
KTP	路透社
KTQ	嚟
KTR	哦
KTS	呼机
KTT	吃透
KTU	呼
KTV	唩
KTW	中和作用
KTX	啼笑皆非
KTY	呚
KUB	嗍
KUD	咲
KUE	嚨
KUF	呌
KUG	嗟
KUH	吖
KUI	中美洲
KUJ	噫
KUK	哾
KUL	噌
KUN	
KUP	單親家庭
KUQ	嚪
KUS	噂
KUT	喭
KUU	中美關係
KUV	唼
KUW	嗌
KUX	嗞
KVA	噚
KVC	唧
KVD	嗜好成癖
KVE	哏
KVF	嘯
KVG	㖀
KVH	嚍
KVI	㖨
KVK	嗈
KVN	㕤
KVO	嘨
KVP	唚
KVR	叧
KVS	嚴肅查處
KVT	叨
KVW	䬭
KVY	嚴肅認真
KWA	唯其
KWB	咃
KWC	嗡
KWD	只有
KWE	只用
KWF	啥
KWG	哈
KWH	只占
KWI	只當
KWJ	吤
KWK	哈哈
KWL	嗰
KWM	呼倫貝爾盟
KWN	喉
KWP	哈密
KWQ	唯獨
KWR	嗲
KWS	咻
KWT	喺
KWU	中俄關係
KWV	吩
KWW	唑
KWX	吪
KWY	叭
KXB	吸引了
KXE	呦
KXG	喙
KXH	吲
KXI	中級法院
KXJ	咈
KXK	吆喝
KXM	㖰
KXN	叱
KXQ	喲
KXR	囂張氣燄
KXT	中紀委
KXU	中組部
KXW	哛
KXX	嘰
KXY	吆
KYA	咬牙
KYB	唁函
KYC	唷
KYD	單方面
KYF	唁電
KYG	唁
KYI	貴州省
KYK	嚷
KYN	咳
KYP	忠於祖國
KYQ	唱主角
KYR	囄
KYS	中高檔
KYT	㕫
KYU	啼
KYV	啷
KYW	吭
KYX	呟
KYY	呅
LAA	軾
LAB	國際
LAC	國務
LAD	國有
LAE	國力
LAF	國土
LAG	軭
LAH	轞
LAI	罪孽深重
LAJ	羃
LAK	國
LAL	國界
LAM	國內
LAN	國情
LAO	國慶
LAP	國家
LAQ	國外
LAR	困難戶
LAS	國歌
LAT	國籍
LAU	轥
LAV	國畫
LAW	異
LAX	羈絆
LAY	國產
LBA	國防工業
LBB	國際聯網
LBC	輙
LBD	囝
LBE	國際輿論
LBF	國際地位
LBG	四子王旗
LBH	國際上
LBI	國際水平
LBJ	國際影響
LBK	擊中
LBL	國際國內
LBM	擊敗
LBN	輒
LBO	團隊精神
LBP	國際社會
LBQ	國際貿易
LBR	國際舞臺
LBS	國際標準
LBT	國際先進水平
LBU	國際競爭
LBV	國防建設
LBW	擊
LBX	國際組織
LBY	國際市場
LCA	罷工
LCB	國務院
LCC	輟
LCD	輽
LCE	罷
LCF	圗
LCI	囜
LCK	囼
LCM	圎
LCN	罞
LCO	罵
LCP	罷官
LCQ	國務卿
LCR	罷手
LCT	國務委員
LCU	國務部長
LCW	畯
LCX	車馬費
LCY	罷課
LDA	因其
LDB	軛
LDC	軷
LDD	固
LDE	囿
LDF	罟
LDG	轱
LDH	罘
LDI	因
LDJ	罨
LDM	輀
LDN	恩
LDO	罽
LDP	固定
LDQ	欭
LDR	較大的
LDS	畸
LDT	轣
LDU	轑
LDV	固始
LDW	輳
LDX	國有經濟
LDY	軑
LEA	男式
LEB	罦
LED	男朋友
LEE	㘞
LEF	胃
LEG	䢁
LEK	胃口
LEL	國與國
LEM	男嬰
LEN	男性
LEQ	輗
LER	男
LES	男權
LET	㽖
LEV	嬲
LEW	男人
LEY	男方
LFA	轒
LFB	黑子
LFC	囩
LFD	轜
LFE	黑勢力
LFF	畦
LFG	置于
LFH	軒
LFI	団
LFJ	䍐
LFK	園
LFL	默默
LFM	罱
LFN	疇
LFO	黑
LFP	黑客
LFQ	黑色
LFR	因地制宜
LFS	黑板
LFT	署
LFU	睪
LFV	轌
LFW	畉
LFX	置疑
LFY	黑夜
LGA	輕工
LGB	囤
LGC	輊
LGD	囯
LGE	輔
LGF	還需
LGG	軖
LGH	車
LGI	還清
LGJ	轉
LGK	還
LGL	疅
LGM	輛
LGN	還將
LGO	還應
LGP	回天之力
LGQ	軏
LGR	男青年
LGS	還要
LGT	轉移
LGU	軯
LGV	輕
LGW	輕佻
LGX	團結
LGY	轉變
LHA	轤
LHB	罩子
LHC	軙
LHD	罪
LHE	四月
LHF	四十
LHG	四万
LHH	四處
LHI	四海
LHJ	罩
LHK	㐃
LHM	四周
LHN	甲
LHO	四鄰
LHP	罪案
LHQ	罪犯
LHR	罪魁
LHS	甲板
LHT	四季
LHV	四書
LHW	四化
LHX	甲級
LHY	四方
LIA	還治其人之身
LIC	車水馬龍
LID	因小而失大
LIE	輎
LIF	塁
LIG	輄
LII	囦
LIJ	㘤
LIN	〇
LIP	疂
LIQ	圓滿解決
LIR	因小失大
LIS	固沙林
LIT	輸油管
LIU	眔
LIW	䳴
LIX	圓滿結束
LIY	四海為家
LJA	罼
LJD	黑暗面
LJG	畼
LJL	輼
LJQ	輵
LJR	眾星捧月
LJS	輠
LJU	因果關係
LJX	輥
LKA	回落
LKB	輯
LKC	圓通
LKD	回春
LKE	罥
LKF	軎
LKG	回到
LKH	甽
LKI	四川省
LKJ	回暖
LKK	回路
LKL	回國
LKM	圓
LKN	回收
LKO	回廊
LKP	迴
LKQ	軦
LKR	回扣
LKS	回想
LKT	回答
LKU	回首
LKV	圖書
LKW	軹
LKX	圖紙
LKY	回族
LLB	田聯
LLD	䍛
LLE	疊加
LLF	畕
LLG	圜
LLH	䡛
LLJ	田野
LLK	㘡
LLL	田
LLN	罳
LLO	轟炸
LLP	轋
LLQ	疊印
LLR	默默無聞
LLS	田林
LLT	田徑
LLU	田間
LLV	男男女女
LLW	轀
LLY	圐
LMB	軸承
LMC	買通
LMD	圌
LME	男同學
LMF	畘
LMG	軸
LMH	軕
LMK	國內戰爭
LMM	異曲同工
LMN	軸心
LMO	固體燃料
LMP	團體賽
LMQ	國內外
LMR	團體操
LMS	買票
LMT	國內先進水平
LMU	買
LMW	軜
LMX	α
LMY	國內市場
LNA	輾
LNB	轏
LND	顋
LNE	圍墾
LNF	罻
LNG	翈
LNH	輕裝上陣
LNI	思潮
LNJ	思量
LNK	圍
LNL	輾轉
LNN	軋
LNQ	軋鋼
LNR	軋製
LNS	思想
LNT	國民生產總值
LNU	思
LNV	圍剿
LNW	罹
LNX	國民經濟
LNY	回收率
LOD	軟磨硬泡
LOF	轉業幹部
LOG	轐
LOH	黑燈瞎火
LOJ	國慶日
LOL	點對點協議
LOM	國營農場
LON	轆
LOP	轉業軍人
LOQ	轔
LOT	國慶節
LOU	䍘
LOW	國營企業
LOX	國營經濟
LOY	國營商業
LPA	數字式
LPB	國家隊
LPC	連通
LPD	轄
LPE	畳
LPF	輐
LPG	國家專利
LPH	輨
LPI	國家法
LPJ	連日
LPK	連
LPL	畹町
LPM	國家體委
LPN	國家民委
LPO	置之度外
LPP	國家安全
LPQ	畹
LPR	連接
LPS	國家標準
LPT	國家科委
LPU	固定資產
LPV	國家建設
LPW	固定价格
LPX	連續
LPY	國家計委
LQA	軝
LQC	軟驅
LQD	軒然大波
LQE	輡
LQF	斬釘截鐵
LQJ	蜀
LQK	輓
LQL	䡘
LQM	軟體
LQN	軳
LQO	連鎖店
LQP	因名額有限
LQQ	黑色金屬
LQR	囫
LQS	軟禁
LQT	軟盤
LQU	畇
LQW	軟
LQX	軟弱
LQY	畂
LRA	團的工作
LRB	䍟
LRC	畈
LRD	磛
LRE	暫且
LRF	塹
LRG	軼事
LRH	斬
LRI	輕描淡寫
LRJ	暫
LRK	蹔
LRL	轉折點
LRM	眾所周知
LRN	慙
LRO	數據庫
LRP	罪魁禍首
LRQ	鏨
LRR	暫缺
LRS	槧
LRT	黑白片
LRU	轉折關頭
LRV	㜞
LRW	軼
LRX	轢
LSA	困惑
LSD	思想感情
LSF	困境
LSG	輏
LSH	町
LSI	思想活躍
LSJ	甼
LSK	軻
LSM	思想體系
LSP	思想家
LSQ	思想包袱
LSR	困扰
LSS	罧
LST	困乏
LSU	䍒
LSV	思想建設
LSW	思想体系
LSX	思想統一
LSY	思想方法
LTA	墨竹工卡
LTB	回答了
LTC	輻射能
LTD	轎
LTE	輈
LTF	軞
LTG	畽
LTH	䡻
LTI	囷
LTJ	輹
LTK	略
LTL	罪行累累
LTM	因特网
LTN	圖片展
LTO	轓
LTP	因循守舊
LTR	回答提問
LTT	略微
LTU	轷
LTV	恩重如山
LTW	略作
LTX	畮
LTY	畋
LUA	軿
LUB	圈子
LUD	圈
LUE	䡵
LUF	輔導報告
LUG	畔
LUI	黑龍江
LUJ	疃
LUK	輔導員
LUL	罾
LUR	図
LUS	輶
LUT	回首往事
LUU	輔導站
LUV	男尊女卑
LUX	罤
LUY	車間主任
LVA	數萬
LVB	男女隊
LVD	囡
LVE	數學
LVF	婁
LVG	甊
LVH	數目
LVJ	罺
LVK	軺
LVL	輜
LVN	軌
LVO	婁底
LVP	遱
LVR	數據
LVT	數
LVU	軌道
LVV	數九
LVW	鷜
LVY	軔
LWA	輪式
LWB	界限
LWC	撃
LWD	圙
LWE	軫
LWF	囶
LWG	輸
LWI	囚
LWJ	界
LWK	軟件中心
LWL	輪回
LWN	䡄
LWO	固体燃料
LWP	界定
LWQ	囚犯
LWR	軟件技術
LWS	囚禁
LWT	畟
LWU	界首
LWV	鴨
LWW	眾
LWX	囮
LWY	㽗
LXB	甲級隊
LXC	羅馬
LXD	團結奮鬥
LXE	軪
LXF	團結協作
LXG	團結一致
LXH	羄
LXI	羅漢
LXK	羂
LXL	累累
LXM	羅山
LXN	連續性
LXO	毗鄰
LXP	羅定
LXQ	墨綠色
LXR	軟弱無力
LXT	羅盤
LXW	羅
LXX	毗
LXY	輕紡產品
LYA	較難
LYB	眾議院
LYC	轍
LYD	圁
LYE	畩
LYF	詈
LYG	罜
LYI	較少
LYJ	罰
LYK	輬
LYL	較輕
LYM	回顧過去
LYN	甿
LYP	較之
LYQ	較多
LYR	較近
LYT	較短
LYU	較差
LYV	較好
LYW	較
LYX	圝
LYY	較高
MAA	賤
MAB	曲子
MAD	曲
MAE	農用
MAF	嵌
MAG	屸
MAH	岈
MAI	曲沃
MAJ	刪
MAK	冊
MAL	購買
MAM	購
MAN	岠
MAO	農業
MAP	農家
MAQ	嵽
MAR	曲折
MAS	農村
MAT	峣
MAU	曲靖
MAV	農奴
MAW	典
MAX	曲線
MAY	戝
MBB	㕀
MBG	㞨
MBH	邖
MBI	崡
MBJ	骨子里
MBN	貤
MBQ	內聯外引
MBR	㞧
MBT	屷
MBX	內聯網
MBY	岌
MCA	峅
MCB	岜
MCC	嵾
MCD	㟥
MCF	財務報表
MCH	財務處
MCI	禸
MCK	貽
MCM	峻岭
MCN	財務收支
MCR	財務製度
MCS	剛柔相濟
MCT	財務管理
MCU	財務部
MCW	峻
MCX	財務紀律
MCY	貽誤
MDA	巁
MDB	內在聯繫
MDD	岩石
MDE	賬
MDF	岸
MDG	岵
MDH	艷
MDI	央
MDJ	崦
MDK	豐足
MDL	盎
MDM	耑
MDN	贓
MDO	炭
MDP	豐富
MDQ	盎然
MDR	屵
MDS	崎
MDT	央行
MDU	嶚
MDV	賑災
MDW	峽
MDX	賎
MDY	贆
MEA	髒
MEB	農學院
MEC	體驗
MED	髓
MEE	崩
MEF	骨
MEG	岄
MEH	骳
MEI	崩潰
MEJ	髁
MEK	體味
MEL	髏
MEM	體
MEN	髎
MEO	髍
MEP	髖
MEQ	骶
MER	屴
MES	骵
MET	骼
MEU	骿
MEV	崢
MEW	鶻
MEX	嵠
MEY	骸
MFA	周期
MFC	岐
MFD	冉
MFE	骨干力量
MFF	峙
MFG	周末
MFH	屽
MFI	周游
MFK	週
MFL	贖
MFN	嶹
MFO	財迷
MFP	周密
MFQ	岏
MFR	周年
MFS	財權
MFT	財
MFU	雕塑
MFW	崚
MFX	財經
MFY	雕刻
MGA	岍
MGB	由表及里
MGC	峌
MGD	同感
MGE	豳
MGF	同志
MGG	同一
MGH	同步
MGI	賕
MGJ	崠
MGK	同
MGL	財政困難
MGM	嶆
MGN	甹
MGO	同類
MGP	同窗
MGQ	屼
MGR	典型的
MGS	同机
MGT	同行
MGU	岼
MGV	崨
MGW	同仁
MGX	峓
MGY	農副產品
MHA	巇
MHB	帽子
MHC	岥
MHD	帳
MHE	幍
MHF	幬
MHG	幅
MHH	帖
MHI	帩
MHJ	帽
MHK	巾
MHL	幗
MHM	巾幗
MHN	冂
MHO	幞
MHP	帎
MHQ	峴
MHR	帕
MHS	帄
MHT	幡
MHU	幢
MHV	㠴
MHW	帆
MHX	㠲
MHY	由衷
MIA	財源茂盛
MID	巌
MIE	峭
MIF	埊
MIG	過渡政府
MII	山清水秀
MIJ	崉
MIK	丹江口
MIM	䞆
MIN	峭壁
MIP	贘
MIR	過河拆橋
MIT	由淺入深
MIU	汖
MIV	崇洋媚外
MIW	嵴
MJA	同時期
MJB	過日子
MJD	囬
MJF	㞱
MJG	崵
MJH	則
MJI	雕虫小技
MJJ	䞎
MJL	同盟國
MJM	嵎
MJP	同盟軍
MJQ	賜
MJU	同時並舉
MJW	同時代
MJX	崑
MKB	嶯
MKD	冋
MKG	肉中刺
MKH	㞲
MKI	巖溶
MKK	巖
MKN	巖層
MKP	迥
MKQ	貺
MKR	賊喊捉賊
MKU	㟕
MKW	嶉
MLA	農田基本建設
MLD	崮
MLE	購買力
MLF	嶧
MLG	嵔
MLH	岬
MLI	農田水利
MLJ	周轉量
MLK	峰回路轉
MLL	㠥
MLN	崽
MLR	嶄
MLS	周恩來
MLU	嶄新
MLV	嶁
MLW	幽默風趣
MMA	嶩
MMB	山陽
MMC	崗巴
MMD	岟
MME	山腰
MMF	峀
MMG	岫
MMH	屾
MMI	山水
MMJ	岀
MMK	山路
MMM	山
MMN	骨肉情
MMO	山庄
MMP	山寨
MMQ	鑍
MMR	罌
MMS	山西
MMT	贁
MMU	崗
MMV	嬰
MMW	鸎
MMX	剛剛結束
MMY	賏
MNA	岷
MNB	㐕
MND	崌
MNF	嶎
MNG	囙
MNH	嵋
MNI	過渡
MNJ	過時
MNK	過路
MNM	過
MNN	屺
MNO	過度
MNP	農民運動會
MNQ	過多
MNR	嶍
MNS	過來
MNT	過程
MNU	過關
MNV	囘
MNW	嵺
MNX	過細
MNY	過於
MOA	農業區劃
MOB	農業院校
MOD	農業大學
MOE	農業用地
MOF	賍
MOG	嶪
MOL	農業國
MOM	嶗山
MOO	嶸
MOQ	嶙
MOR	農業技術
MOS	農業機械
MOT	農業科技
MOU	農業部
MOV	嵣
MOW	農業人口
MOX	農業經濟
MOY	同類產品
MPA	崇敬
MPB	敗家子
MPD	迪
MPE	農家肥料
MPF	崇
MPI	䢙
MPJ	崇明
MPK	辿
MPL	賱
MPM	內容豐富
MPO	迪慶
MPP	周密安排
MPQ	同案犯
MPR	崇拜
MPS	貯
MPT	內容簡介
MPU	㞫
MPV	峖
MPW	崆
MPX	岮
MPY	崇高
MQA	岻
MQB	岇
MQD	贍
MQE	崅
MQF	崟
MQG	崯
MQJ	峋
MQK	岣
MQM	巍然屹立
MQN	翙
MQQ	嵚
MQR	岉
MQT	嶽
MQU	贍養
MQW	㰞
MQY	嵧
MRA	㟛
MRB	嵏
MRC	販
MRD	崤
MRF	网址
MRG	岶
MRH	岓
MRI	罓
MRK	肉制品
MRN	网民
MRO	网迷
MRP	周年之際
MRQ	嵬
MRR	羀
MRT	崥
MRU	网站
MRW	嶊
MSA	嶘
MSD	嵿
MSF	農村幹部
MSG	農村政策
MSI	山西省
MSJ	嵖
MSK	岢
MSM	岢嵐
MSN	農村改革
MSO	農機廠
MSQ	農村金融
MSR	同樣的
MSS	崊
MST	農林牧副漁
MSV	崾
MSW	崍
MSX	農村經濟
MSY	嵀
MTA	內功
MTB	農科院
MTC	內務
MTD	峰
MTE	內臟
MTF	巑
MTG	貹
MTH	岝
MTI	嵊泗
MTJ	峲
MTK	賂
MTL	賉
MTM	嶶
MTN	屹
MTO	嶓
MTP	貶
MTQ	巍然
MTR	峨
MTS	內遷
MTT	內科
MTU	嵊
MTV	巍
MTW	嵷
MTX	體系結構
MTY	敗
MUA	朑
MUB	胐
MUC	脧
MUD	過意不去
MUE	巃
MUF	岦
MUG	嵯
MUJ	嶂
MUK	賠
MUL	贈
MUM	剛
MUN	剛性
MUO	朥
MUP	雕塑家
MUQ	胊
MUR	嶄新的
MUS	崷
MUT	嵃
MUU	膧
MUV	賺
MUW	巕
MUX	嵫
MUY	罔
MVE	峎
MVG	峍
MVH	贐
MVI	㟤
MVK	岧
MVL	崰
MVR	屶
MVT	峮
MVU	賑災義演
MVY	屻
MWA	岑鞏
MWC	嵡
MWE	肉用
MWF	賒
MWG	崙
MWH	峜
MWI	岑溪
MWJ	岕
MWK	冏
MWM	囧
MWN	巋
MWO	肉麻
MWP	同命運
MWR	賠償損失
MWT	嵐
MWU	㞤
MWV	岎
MWW	肉
MWX	㟆
MWY	嶺
MXA	幽雅
MXE	岰
MXF	幽靈
MXG	幽靜
MXH	巓
MXI	幽深
MXJ	岪
MXK	嵹
MXL	幽默
MXQ	幽怨
MXS	幽禁
MXT	嶷
MXU	嵶
MXW	幽谷
MXX	幽
MXY	㟂
MYA	雘
MYB	丹陽
MYC	丹巴
MYD	丹
MYE	彤
MYF	訔
MYG	丹青
MYH	嵩縣
MYI	體育活動
MYJ	刐
MYK	嵩
MYL	丹田
MYM	嵩山
MYN	賅
MYO	崇高精神
MYP	體育運動
MYR	崇高的敬意
MYS	丹棱
MYT	崺
MYU	㞵
MYV	崀
MYW	峧
MYX	體育組
MYY	㞶
NAA	恜
NAB	展出
NAC	展台
NAD	愜
NAE	展
NAF	展示
NAG	羾
NAH	慳
NAI	异常
NAJ	羿
NAK	慪
NAL	懵
NAM	愥
NAN	屟
NAO	民營
NAP	懞
NAQ	憯
NAR	民兵
NAS	民歌
NAT	懂
NAU	民意
NAV	民
NAW	殿
NAX	慌張
NAY	慌
NBA	避孕藥
NBB	懾
NBC	憨態
NBD	㞌
NBE	屈服
NBF	聼
NBG	敢于
NBH	邔
NBI	敢當
NBK	㥛
NBM	屈
NBN	忚
NBR	敢打
NBS	屙
NBT	敢
NBW	敢做
NBY	忣
NCC	慘
NCD	司務長
NCE	悀
NCF	怪
NCG	怪事
NCH	慘劇
NCI	㞋
NCJ	司馬昭之心路人皆知
NCK	怡
NCL	怪罪
NCM	慘敗
NCN	忬
NCP	慘案
NCR	性騷擾
NCT	恈
NCU	怪癖
NCV	㞎
NCW	悛
NCY	慅
NDA	惰
NDB	怀孕
NDC	翇
NDD	居
NDE	懮
NDF	屒
NDG	怙
NDH	怌
NDJ	懨
NDK	居中
NDM	怖
NDN	居民
NDO	恢
NDP	居室
NDQ	居然
NDR	慡
NDS	必不可少
NDT	恢复
NDU	憭
NDV	慘不忍睹
NDW	悏
NDX	怀疑
NDY	忕
NEA	懚
NEB	以貌取人
NEE	恊
NEF	必須增強
NEG	怚
NEH	必須具有
NEI	必須注意
NEJ	必須是
NEK	心服口服
NEM	收受賄賂
NEN	民用飛機
NEP	懓
NEQ	獎學金
NER	愮
NES	選舉權
NET	忇
NEU	心臟病
NEW	裝腔作勢
NEX	慀
NEY	心力交瘁
NFA	憤
NFB	屆
NFC	怯
NFD	懦
NFF	恃
NFG	迅速
NFH	慎
NFI	慰
NFJ	蝨
NFK	卂
NFL	慎思
NFM	局域网
NFN	懤
NFO	懗
NFP	迅
NFQ	忨
NFR	迅捷
NFS	情報檢索
NFT	屠
NFU	悻
NFV	迅即
NFW	懎
NFX	懦弱
NFY	忖
NGA	以毒攻毒
NGB	那
NGC	屋
NGD	刁
NGE	情
NGF	䍿
NGG	忹
NGH	怔
NGI	司法
NGJ	慱
NGK	司
NGL	情思
NGM	怲
NGN	怴
NGO	民政廳
NGP	民事案件
NGQ	屍
NGR	以下的
NGS	司机
NGT	那么
NGU	怦
NGV	悽
NGW	司令
NGX	愫
NGY	情商
NHA	憈
NHB	郿
NHC	収
NHD	眉
NHE	胥
NHF	遐
NHG	卍
NHH	懼
NHI	疋
NHJ	蛋
NHK	丩
NHL	收回
NHM	眉山
NHN	收尾
NHO	蛋糕
NHP	收割
NHQ	鹛
NHR	以上的
NHS	疏松
NHT	收
NHU	收益
NHW	鶥
NHX	收費
NHY	疏
NIA	情況匯報
NIE	屑
NIF	違法者
NIG	恍
NIH	眉清目秀
NII	尿
NIJ	遲早
NIL	屬
NIM	惝
NIN	悄悄
NIP	憆
NIQ	悄然
NIR	悩
NIS	司法機關
NIT	犀
NIU	司法部
NIX	遲緩
NIY	屬於
NJA	懪
NJD	心照不宣
NJE	避暑胜地
NJF	悍
NJG	怛
NJH	丱
NJI	愰
NJK	民盟中央
NJL	慢
NJM	避暑山庄
NJN	慢性
NJP	心曠神怡
NJQ	惕
NJR	那時的
NJS	惈
NJT	惺
NJW	那時候
NJX	惃
NJY	憬
NKA	違
NKB	避孕
NKC	悒
NKD	心中有數
NKE	悁
NKF	吢
NKG	悜
NKH	忡
NKI	違法
NKJ	避暑
NKK	憚
NKL	壁壘
NKM	屌
NKN	悞
NKP	避寒
NKQ	怳
NKR	壁挂
NKS	違禁
NKT	♂
NKU	壁
NKV	譬如
NKW	怾
NKX	違紀
NKY	以史為鑒
NLA	翼
NLD	乪
NLE	屢受
NLF	懌
NLG	怬
NLK	恛
NLL	裝甲車
NLN	愢
NLP	慩
NLR	慚
NLS	悃
NLU	快車道
NLV	屢
NLW	慍
NLX	㦬
NLY	愣
NMA	憹
NMD	惴
NME	愲
NMF	惆
NMG	恫
NMH	刷
NMI	屃
NMJ	㞯
NMK	恫嚇
NMM	屭
NMN	惆悵
NMP	必由之路
NMR	情同手足
NMT	改過自新
NMU	惘
NMW	慛
NMY	收購計劃
NNA	選
NNB	局限
NND	局面
NNE	選舉
NNF	愉快地
NNG	己
NNH	忸
NNI	快活
NNJ	選題
NNK	愇
NNL	乙
NNM	心惊肉跳
NNN	忋
NNO	必將對
NNP	選定
NNQ	慷慨解囊
NNR	慴
NNS	恰恰相反
NNT	怭
NNU	忌
NNV	乜
NNW	快
NNX	怩
NNY	羽
NOA	懭
NOD	已類左框心屍羽
NOG	㦠
NOH	惦
NOI	屎
NON	慷慨
NOO	惔
NOQ	憐
NOS	懡
NOT	民營科技企業
NOU	心煩意亂
NOV	慷
NOW	惦念
NOX	民營經濟
NOY	惦記
NPC	慎之又慎
NPD	屪
NPE	迉
NPF	悰
NPG	愃
NPH	悺
NPJ	慏
NPL	惲
NPM	心寬體胖
NPN	懧
NPP	收容審查
NPQ	惋
NPR	收容所
NPS	以禮相待
NPT	愘
NPW	屄
NPY	收視率
NQA	忯
NQB	
NQC	懈怠
NQD	恑
NQE	懈
NQF	必然趨勢
NQG	惍
NQI	恌
NQJ	恂
NQK	怐
NQM	愌
NQN	怉
NQO	心急火燎
NQQ	恀
NQR	惚
NQS	收錄機
NQT	獎金稅
NQU	心猿意馬
NQV	
NQW	忺
NQX	必然結果
NQY	懰
NRA	惶惑
NRB	忷
NRC	㤆
NRD	恡
NRE	習用
NRF	習
NRG	怕
NRH	忻
NRI	習水
NRJ	習題
NRK	蛋制品
NRL	憮
NRM	以失敗而告終
NRN	愾
NRP	選拔賽
NRQ	愧
NRR	懫
NRS	屈指可數
NRU	愧疚
NRW	怢
NRX	㦡
NRY	憿
NSD	屢禁不止
NSF	慓
NSG	恓
NSH	忊
NSI	杘
NSJ	憛
NSK	違禁品
NSN	必要性
NSO	憟
NSP	裝機容量
NSR	必要的
NSS	慄
NST	違禁物品
NSW	必要條件
NSX	裝配線
NSY	怵
NTA	屜
NTB	悸
NTC	性能
NTD	恬
NTE	必
NTF	尾
NTG	性
NTH	屣
NTI	收入水平
NTJ	愎
NTK	恪
NTL	屨
NTM	懊
NTN	忔
NTO	愀
NTP	必定
NTQ	必然
NTR	改掉
NTS	必要
NTT	履
NTU	改善
NTV	改建
NTW	鴓
NTX	悔
NTY	改
NUA	屏
NUB	改善了
NUC	飛馳
NUD	㞐
NUE	憪
NUF	翌
NUG	翋
NUH	眉開眼笑
NUI	民意測驗
NUJ	憶
NUK	飛躍
NUL	憎
NUM	屏山
NUN	憧憬
NUR	局部的
NUS	收音机
NUT	飛
NUU	層次
NUV	慊
NUW	居首位
NUX	悌
NUY	憫
NVA	憳
NVB	恪盡職守
NVC	慨
NVD	敢怒不敢言
NVE	恨
NVF	忰
NVG	妀
NVI	㥆
NVK	怊
NVL	快刀斬亂麻
NVN	惟妙惟肖
NVO	惱火
NVP	舝
NVQ	慨然
NVS	恰好相反
NVT	忉
NVV	尻
NVY	憤怒譴責
NWA	恰巧
NWB	悅耳
NWC	忪
NWD	惟有
NWE	鷚
NWF	憏
NWG	恰
NWH	悅目
NWI	乆
NWJ	刔
NWK	悅
NWL	居全國之首
NWN	翭
NWP	戳穿
NWQ	惟獨
NWR	那几年
NWS	恘
NWT	尉健行
NWU	司令部
NWV	凥
NWW	懺
NWY	惟
NXB	必經階段
NXD	已經成為
NXE	怮
NXF	慣
NXG	憴
NXH	愼
NXI	以經濟建設為中心
NXJ	怫
NXN	慣性
NXP	迡
NXQ	慣犯
NXR	那幾年
NXS	尼木
NXT	懝
NXU	愵
NXV	尼
NXW	慣例
NXX	屁
NXY	惤
NYA	以期
NYB	以及
NYC	民族矛盾
NYD	心愿
NYE	心胸
NYF	尺寸
NYG	以下
NYH	忭
NYI	乄
NYJ	心里
NYK	咫
NYL	懷
NYM	以內
NYN	忙
NYO	尺度
NYP	心安
NYQ	以外
NYR	以后
NYS	以西
NYT	㤃
NYU	㣺
NYV	悢
NYW	翠
NYX	怰
NYY	忟
OAA	烒
OAB	炎黃子孫
OAC	度
OAD	廝
OAE	糤
OAF	煤
OAG	灴
OAH	庌
OAI	㡲
OAJ	灷
OAK	廑
OAL	庿
OAM	廣
OAN	炬
OAO	遮
OAP	廣安
OAQ	廗
OAR	煤气
OAS	廣西
OAT	糒
OAU	爤
OAW	烘
OAX	煙幕彈
OAY	廣州
OBA	底子薄
OBB	㸎
OBD	廳長
OBF	廰
OBG	籽
OBH	邩
OBI	廳堂
OBM	炪
OBN	灺
OBS	㢌
OBW	廕
OBX	鬯
OCA	序幕
OCC	糝
OCE	熥
OCG	序列
OCI	広
OCK	炲
OCL	勞務輸出
OCM	序曲
OCN	粑
OCT	業務科
OCU	業務部
OCW	焌
OCX	勞務費
OCY	糔
ODA	糲
ODB	廣大職工
ODC	炦
ODD	燎原
ODE	糊
ODF	煃
ODG	炻
ODH	廈
ODI	糊涂
ODJ	粨
ODK	糊口
ODM	煩
ODN	庬
ODO	烣
ODP	對大家來說
ODQ	座右銘
ODR	應有的
ODS	㢊
ODT	爏
ODU	燎
ODV	廣大群眾
ODW	類似
ODX	類比
ODY	類
OEA	燬
OEB	烰
OED	粗大
OEE	焩
OEF	㷐
OEG	粗
OEH	廋
OEI	粗活
OEJ	粗暴
OEL	爝
OEN	廫
OEO	粗糙
OEP	燰
OEQ	粗獷
OER	熎
OES	炒股票
OET	粗笨
OEW	庾
OEX	粗細
OEY	粗放
OFA	焼
OFB	迷魂陣
OFC	庋
OFD	糯
OFE	燒毀
OFF	燒
OFG	灶
OFH	籵
OFI	庄浪
OFJ	廟
OFK	廚
OFL	烤鴨
OFM	煵
OFN	燽
OFO	焃
OFP	廟宇
OFQ	對臺貿易
OFT	烤
OFU	燵
OFW	庱
OFX	廣域網
OFY	籿
OGA	精英
OGB	庉
OGC	庢
OGD	精确
OGE	精
OGF	精干
OGG	精致
OGH	炡
OGI	精湛
OGJ	粳
OGK	焐
OGL	煉
OGM	糟
OGN	精心
OGO	精度
OGP	精神
OGQ	廒
OGR	精制
OGS	粖
OGT	對策
OGU	對
OGV	烴
OGW	業餘
OGX	彂
OGY	精良
OHA	爐
OHB	爐子
OHD	䨾
OHE	床上用品
OHF	爐霍
OHH	爠
OHI	店堂
OHJ	焯
OHK	粘
OHL	粘連
OHM	廬山
OHO	燦爛
OHP	店家
OHQ	燦
OHX	庛
OHY	店主
OIA	炒菜
OIB	廠子
OID	廉洁奉公
OIE	焇
OIF	炫耀武力
OII	廣泛深入
OIJ	應當是
OIK	廠史
OIM	廠
OIN	熒光屏
OIO	廣泛應用
OIP	爣
OIR	廣泛的
OIS	摩洛哥
OIT	炒
OIU	廣泛開展
OIW	熦
OIX	廠級
OIY	廠商
OJA	爆
OJB	熶
OJD	爆破
OJE	焨
OJF	廛
OJG	糧
OJH	灲
OJI	熀
OJJ	焻
OJL	熳
OJM	庽
OJO	爆炸
OJQ	焬
OJR	焊接
OJS	粿
OJT	焺
OJU	煜
OJV	燳
OJW	糧食
OJX	焜
OJY	燝
OKB	火中取栗
OKE	焆
OKK	燥
OKM	熉
OKN	廢品收購
OKQ	炾
OKT	對號入座
OKU	廢品站
OKW	㡶
OKY	廢品率
OLA	糞
OLD	煾
OLE	煟
OLF	畨
OLG	畑
OLH	炠
OLI	燭光
OLK	庘
OLL	庫車
OLM	勞纍過度
OLN	㐣
OLO	炒買炒賣
OLP	庫容
OLQ	燭
OLS	焑
OLU	火車站
OLV	廔
OLW	熅
OLY	庫房
OMA	燶
OMD	炴
OME	䊘
OMG	粙
OMJ	廁
OMK	炯
OMM	廮
OMN	煱
OMO	炯炯
OMR	廁所
OMT	㷨
OMU	焵
OMW	烱
OMX	糧農組織
OMY	烿
ONA	慶功
ONB	㐘
OND	粗心大意
ONE	慶賀
ONF	廜
ONG	業已形成的
ONH	糈
ONI	応
ONJ	鹿
ONK	煒
ONL	㢞
ONM	慶典
ONN	焗
ONO	麒麟
ONP	燃眉之急
ONR	熠
ONS	精裝本
ONT	精心策划
ONU	熤
ONW	廖
ONX	精心組織
ONY	粎
OOA	熫
OOB	郯
OOC	勞務
OOD	顃
OOE	火力
OOF	烾
OOG	爜
OOH	敥
OOI	火光
OOJ	剡
OOK	營業員
OOL	火車
OOM	火山
OON	廘
OOO	火
OOP	勞
OOQ	燐
OOR	火把
OOS	勞模
OOT	火箭
OOU	炎
OOV	糖
OOW	鶑
OOX	火紅
OOY	炏
OPA	迷惑
OPD	爎
OPE	精神力量
OPF	烷
OPG	煊
OPH	精神上
OPI	迷
OPJ	熐
OPK	熍
OPL	煇
OPM	熔岩
OPN	迷惘
OPO	廀
OPP	精神實質
OPQ	焥
OPR	迷失
OPS	䊉
OPT	烢
OPU	精神病
OPW	焢
OPX	炨
OPY	精神文明
OQA	底
OQB	灮
OQD	燃
OQE	廨
OQF	燃起
OQG	底下
OQH	焔
OQI	庣
OQJ	鄰里
OQK	營銷中心
OQL	鄰國
OQM	煥
OQN	庖
OQO	廯
OQQ	廞
OQR	粅
OQS	鄰村
OQT	底片
OQU	底部
OQW	炊
OQX	對外經濟
OQY	灼
ORB	糉
ORC	炍
ORD	烯
ORF	庪
ORG	粕
ORH	炘
ORI	粗製濫造
ORJ	應按照
ORK	庍
ORL	廡
ORM	廣播體操
ORN	熂
ORP	對抗賽
ORQ	廆
ORR	廣播操
ORS	應邀來訪
ORT	庳
ORU	煤气站
ORW	摩托化
ORX	爍
ORY	燩
OSA	麻花
OSB	麻陽
OSD	麻木不仁
OSE	魔力
OSF	煙
OSG	粞
OSH	廂
OSI	床
OSJ	燂
OSK	庁
OSL	腐朽思想
OSN	廣西壯族自治區
OSO	麻煩
OSQ	床鋪
OSR	爩
OSS	磨
OST	魔術
OSU	麻痹
OSW	庲
OSX	磨練
OSY	炑
OTA	灹
OTB	炧
OTC	庅
OTD	烽
OTE	烐
OTF	糙
OTG	燻
OTH	炸
OTI	勞動法
OTJ	勞動時間
OTK	烙
OTL	烅
OTM	燠
OTN	籺
OTO	燔
OTP	勞動密集型
OTQ	熪
OTR	勞動技能
OTS	勞動模範
OTT	勞動生產率
OTU	烀
OTV	勞動群眾
OTW	庄稼人
OTX	烸
OTY	敉
OUA	庰
OUB	粒子
OUD	㡴
OUE	龐
OUF	料
OUG	粒
OUI	廉洁
OUJ	熾
OUK	焙
OUL	熷
OUN	燜
OUO	焙燒
OUP	廉宜
OUQ	爓
OUR	摩拳擦掌
OUS	煪
OUT	勞資科
OUU	火辣辣
OUV	廉
OUW	熌
OUX	糍
OUY	燘
OVA	燖
OVB	㶢
OVC	廄
OVE	庸
OVF	熽
OVG	籹
OVH	唐
OVI	康
OVK	廱
OVL	爉
OVM	唐山
OVP	康定
OVR	康樂
OVT	灱
OVW	庚
OVX	精妙絕倫
OVY	籾
OWA	廢舊
OWB	應聘
OWC	庺
OWD	煅
OWE	應力
OWF	腐
OWG	燈
OWH	燈具
OWI	庂
OWJ	庎
OWK	廢品
OWL	座車
OWM	腐敗
OWN	籶
OWO	對人類
OWQ	應急
OWR	類似的
OWS	庥
OWT	煈
OWU	座次
OWV	粉
OWW	座
OWX	廢
OWY	焓
OXD	庼
OXE	㶭
OXH	粌
OXI	纇
OXJ	炥
OXK	糨
OXO	對比度
OXT	㢕
OXU	糑
OXV	庀
OXW	粗線條
OXX	庇
OXY	庇護
OYC	焴
OYD	㢇
OYE	庡
OYF	廊坊
OYG	炷
OYH	炞
OYI	炫耀
OYJ	米易
OYK	廓
OYL	廩
OYN	煽
OYO	㷜
OYQ	精講多練
OYR	摩肩接踵
OYS	米林
OYT	米
OYU	熵
OYV	廊
OYW	粹
OYX	炫
OYY	炆
PAA	寬帶
PAB	寨子
PAC	賽馬
PAD	究其原因
PAE	社區服務
PAF	寒露
PAG	賽事
PAH	宦
PAI	寒流
PAJ	寞
PAK	賽跑
PAL	賽車
PAM	㝤
PAN	寒心
PAO	寬度
PAP	寬容
PAQ	塞外
PAR	寒气
PAS	密切配合
PAT	寒冬
PAU	寒冷
PAV	社區建設
PAW	賽
PAX	宏觀經濟
PAY	寒夜
PBA	字幕
PBB	突出了
PBC	冣
PBD	字面
PBF	字
PBG	字形
PBH	字眼
PBI	實際水平
PBJ	㝋
PBK	字號
PBL	實際困難
PBM	字典
PBN	實際情況
PBQ	字句
PBR	空降兵
PBS	字根
PBT	字符
PBU	字音
PBV	軍隊建設
PBW	字体
PBX	字母
PBY	實際效果
PCB	神圣職責
PCD	寄予厚望
PCG	家務事
PCI	實驗小學
PCK	實驗中學
PCO	家務勞動
PCP	實驗室
PCT	神態自若
PCU	㝊
PDA	宏觀
PDB	完成了
PDC	宏
PDD	寄存
PDE	寡
PDF	宕
PDG	割裂
PDH	割
PDJ	害虫
PDK	突破口
PDL	寕
PDM	寄贈
PDN	宬
PDP	寄宿
PDQ	豁然
PDR	寄托
PDS	寄
PDT	寄生
PDU	寮
PDV	寡婦
PDW	実
PDX	割斷
PDY	宊
PEA	初加工
PEB	空架子
PED	宜春
PEE	宜興
PEF	肎
PEG	宜
PEI	寫法
PEJ	宜昌
PEK	宜川
PEL	軍用車輛
PEM	宜山
PEN	實用性
PEP	寫字
PEQ	寫
PER	實用技術
PES	寀
PET	寪
PEU	宜章
PEW	寫作
PEX	補助費
PEY	神采奕奕
PFA	完工
PFB	完了
PFD	完成
PFE	冡
PFF	宗教
PFG	完整
PFH	寘
PFI	宗
PFJ	宑
PFK	㝨
PFL	宗教界
PFM	守則
PFN	冠以
PFP	宗祠
PFQ	完
PFT	宯
PFU	守
PFV	完好
PFW	完全
PFX	宗旨
PFY	宗族
PGA	定期
PGB	定陶
PGC	室
PGD	宣布
PGE	寈
PGF	宇
PGG	定于
PGH	定
PGI	家小
PGJ	宣
PGK	富
PGL	憲
PGM	寅
PGN	完整性
PGO	家庭
PGP	宇宙
PGQ	寳
PGR	寶
PGS	定西
PGT	宇航
PGU	宣判
PGV	寁
PGW	家公
PGX	家鄉
PGY	宣言
PHA	安眠藥
PHB	官職
PHD	初見成效
PHE	官腔
PHF	官場
PHG	寂
PHK	官員
PHL	視頻點播
PHM	寊
PHN	官
PHP	寂寞
PHQ	官邸
PHR	官兵
PHT	官銜
PHU	㓀
PHV	初步建立
PHW	官僚
PHY	官方
PIA	穿小鞋
PIE	宵
PIF	憲法規定
PIJ	客流量
PIL	實況轉播
PIN	窮光蛋
PIO	容光煥發
PIQ	實況錄像
PIR	空洞的
PIS	宵禁
PIT	禮尚往來
PIU	㲾
PIV	寖
PIW	家常便飯
PIX	額濟納旗
PIY	額滿為止
PJB	窮日子
PJG	寔
PJI	冠冕堂皇
PJJ	䥌
PJK	定時器
PJM	寓
PJO	宴席
PJR	寓所
PJU	寓意
PJV	宴
PJW	定量分析
PJX	窗明幾淨
PJY	冥
PKD	富貴不能淫
PKE	空中加油
PKG	宺
PKJ	實踐是檢驗真理的唯一
PKK	實踐中
PKM	寶貴財富
PKN	宮殿
PKO	宮燈
PKP	寶中之寶
PKQ	寅吃卯糧
PKR	寶貴的
PKS	宲
PKT	宮
PKU	寶貴意見
PKV	守口如瓶
PKX	實踐經驗
PKY	實踐證明
PLA	安置工作
PLB	鄆
PLC	軍務
PLD	顐
PLE	運力
PLF	運載
PLG	寰
PLH	皸
PLI	運河
PLJ	軍
PLK	軍品
PLL	運輸
PLN	軍民
PLO	運營
PLP	運
PLQ	運銷
PLR	祖國的
PLS	牢固樹立
PLT	運行
PLU	運送
PLV	寠
PLW	鶤
PLX	祖國統一
PLY	軍方
PMD	寷
PME	神農架
PMF	宙
PMG	窮山惡水
PMJ	冚
PMK	視同路人
PML	窮則思變
PMV	神丹妙藥
PMX	補貼費
PMY	窮則變
PNA	密切
PNB	寧陽
PNC	㝕
PND	密布
PNE	甯
PNF	密封
PNG	富民政策
PNH	寐
PNI	寧波
PNJ	蜜蜂
PNL	寧
PNM	賔
PNO	密度
PNP	寢室
PNQ	密鑰
PNR	密探
PNS	密植
PNT	蜜
PNU	冠心病
PNV	定心丸
PNW	寥
PNX	軍民結合
PNY	廴
POB	穿鑿附會
POC	叜
POD	家庭成員
POF	家庭教育
POG	家庭環境
POH	宋慶齡基金會
POJ	家庭影院
POL	實業界
POM	家庭財產
POO	軍火庫
POP	實業家
POS	安營紮寨
POT	家庭生活
POU	冞
POV	家庭婦女
POW	家庭住址
POX	家庭網絡
POY	運營商
PPA	安家落戶
PPB	之際
PPD	之三
PPE	之爭
PPF	之二
PPG	之一
PPH	之上
PPI	之流
PPJ	客運量
PPK	之中
PPL	安定團結
PPM	之內
PPN	空軍司令
PPO	密密麻麻
PPP	之
PPQ	之外
PPR	之后
PPS	之极
PPT	之後
PPU	㝎
PPV	空空如也
PPW	之余
PPX	視神經
PPY	牢牢記取
PQB	宛
PQD	䪴
PQG	瓭
PQI	宨
PQK	冤
PQM	寏
PQN	冤屈
PQP	冤家
PQQ	宛然
PQR	安然無恙
PQS	冤枉
PQT	密鑰盤
PQU	安危冷暖
PQV	冘
PQW	鴆
PQX	穿針引線
PQY	㝌
PRA	安排工作
PRB	察看了
PRC	寙
PRD	安排不當
PRE	客戶服務器
PRF	空白支票
PRG	寒气逼人
PRH	實質上
PRI	空气污染
PRK	複製品
PRL	空白點
PRN	之所以
PRP	實打實
PRR	空氣質量
PRS	客戶機
PRT	安排生活
PRU	實質問題
PRW	被迫進行
PRX	冟
PRY	寄希望于
PSA	宁蒗
PSB	宁陵
PSD	宁夏
PSF	宁城
PSH	宁肯
PSI	宁波
PSJ	宁明
PSL	㿾
PSO	軍械庫
PSP	宁安
PSQ	穿梭外交
PSR	安哥拉
PSS	冧
PST	宁德
PSU	宋
PSV	神机妙算
PSW	宁化
PSY	官樣文章
PTA	宅
PTB	社科院
PTC	牢騷
PTD	宎
PTE	寒冬腊月
PTF	宒
PTG	牢
PTH	㝚
PTI	安徽省
PTJ	寄生虫
PTK	額
PTL	牢固
PTM	客體
PTN	實行改革
PTO	審
PTP	客家
PTQ	神秘色彩
PTR	客气
PTS	客机
PTT	客船
PTU	審判
PTW	客人
PTX	審結
PTY	客商
PUA	襪
PUB	衪
PUC	衩
PUD	褥
PUE	衫
PUF	宰
PUG	補
PUH	被
PUI	襠
PUJ	裸
PUK	裎
PUL	襬
PUM	袖
PUN	褶
PUO	褲
PUP	衴
PUQ	袍
PUR	裨
PUS	襟
PUT	襖
PUU	襯
PUV	初
PUW	裕
PUX	袎
PUY	褊
PVA	鞌
PVB	宄
PVD	頞
PVF	安
PVG	安平
PVH	安上
PVI	福建省
PVJ	安歇
PVK	安順
PVL	安置
PVM	案由
PVN	安居
PVO	安康
PVP	安定
PVQ	案犯
PVR	安排
PVS	案
PVT	宭
PVU	案卷
PVV	安好
PVW	鴳
PVX	安鄉
PVY	安放
PWA	穿
PWB	窿
PWC	梥
PWD	突
PWE	竄
PWF	察
PWG	窒
PWH	窅
PWI	窪
PWJ	窠
PWK	窗口
PWL	窶
PWM	窩
PWN	窟
PWO	窲
PWP	窗帘
PWQ	窕
PWR	竅
PWS	穼
PWT	窗
PWU	穴
PWV	究
PWW	容
PWX	穹
PWY	鶴
PXB	宆
PXC	宖
PXD	實在
PXE	實力
PXF	實
PXG	實現
PXH	䙾
PXI	實況
PXJ	實時
PXK	實踐
PXM	實體
PXN	實習
PXO	實業
PXP	迱
PXQ	實錄
PXR	它的
PXS	實權
PXT	寲
PXU	軍費開支
PXW	它們
PXX	實彈
PXY	實施
PYA	祺
PYB	祁
PYC	祃
PYD	祐
PYE	祖
PYF	社
PYG	福
PYH	視
PYI	福清
PYJ	神
PYK	祝
PYL	祵
PYM	禮
PYN	冖
PYO	禟
PYP	禈
PYQ	祗
PYR	祈
PYS	禋
PYT	祚
PYU	祥
PYV	祒
PYW	宍
PYX	祿
PYY	禳
QAA	錢
QAB	鉗子
QAC	多功能
QAD	锘
QAE	鏾
QAF	鉗
QAG	釭
QAH	鑑
QAI	銾
QAJ	昏
QAK	钷
QAL	錨
QAM	帋
QAN	鉅
QAO	昏迷
QAP	象牙之塔
QAQ	鐕
QAR	銰
QAT	鑝
QAU	钄
QAV	氏
QAW	鑊
QAY	邸
QBA	危險期
QBB	鑷
QBC	鋷
QBD	迎春
QBF	迎考
QBG	釨
QBH	卬
QBI	䤴
QBJ	鐊
QBK	迎戰
QBL	錳
QBM	鈯
QBN	怨
QBP	迎
QBR	迎接
QBS	錒
QBT	皺
QBU	迎新
QBV	妴
QBW	鴛
QBX	皺紋
QBY	鈒
QCB	色
QCC	錣
QCD	猶豫不決
QCE	銿
QCF	色達
QCG	色素
QCI	勾
QCK	鈶
QCL	䥁
QCN	鈀
QCO	鎷
QCQ	鈗
QCR	勾搭
QCT	鉾
QCV	勾畫
QCW	鋑
QCX	勾引
QCY	釵
QDA	危難
QDB	危
QDC	鈸
QDD	然而
QDE	銪
QDF	錛
QDG	鈷
QDH	鍥
QDI	銇
QDJ	匎
QDM	鈽
QDN	鋮
QDP	危害
QDQ	鋴
QDR	厃
QDS	錡
QDT	矦
QDU	鐐
QDW	詹
QDX	銭
QDY	然
QEA	角落
QEB	鋢
QED	触礁
QEE	錋
QEF	臽
QEG	鈅
QEH	角
QEI	解渴
QEK	鉫
QEL	解圍
QEM	解體
QEN	解恨
QEO	燄
QEP	鑀
QEQ	欿
QER	鎐
QES	解析
QET	釛
QEU	解剖
QEV	鋖
QEW	鵮
QEY	解放
QFA	鐼
QFB	鑽井隊
QFC	鈘
QFD	勻
QFE	鐵力
QFF	鐃
QFG	釷
QFH	針
QFI	銢
QFK	鐵
QFL	鐳
QFM	鐵嶺
QFN	鑄
QFO	針對
QFP	鋍
QFQ	鈨
QFR	包干制
QFS	鎮賚
QFT	鍺
QFU	鐽
QFW	鈇
QFX	針織
QFY	針劑
QGA	鈃
QGB	鈍
QGC	鳋
QGD	銒
QGE	鋪
QGF	鲼
QGG	鲆
QGH	鈣
QGI	銶
QGJ	錬
QGK	匐
QGL	鍊
QGM	鈵
QGN	鉞
QGO	鳙
QGP	象形字
QGQ	
QGR	鲌
QGS	鲄
QGT	鲊
QGU	匉
QGV	鋞
QGW	鑈
QGX	銕
QGY	鳊
QHA	鑪
QHB	鑡
QHC	鈹
QHD	䀏
QHE	錹
QHF	外地
QHG	鉬
QHH	鑺
QHI	外流
QHJ	亇
QHK	鉆
QHL	鏀
QHM	鍞
QHN	鈻
QHO	外廠
QHP	迯
QHQ	鋧
QHR	外援
QHS	外相
QHT	外科
QHU	外部
QHW	外人
QHX	外經
QHY	外
QIA	逃荒
QIB	解決了
QID	頫
QIE	銷
QIF	鼗
QIG	銧
QIH	覙
QII	兆
QIJ	鐋
QIK	逃跑
QIM	鎖
QIN	逃避
QIP	逃
QIQ	逃犯
QIR	鎃
QIS	鈔票
QIT	鈔
QIU	淾
QIV	解決好
QIW	鴵
QIY	釥
QJA	鑤
QJB	郇
QJD	錫礦
QJE	貿易爭端
QJF	銲
QJG	鈤
QJH	釗
QJI	鎤
QJJ	亀
QJK	﹙
QJL	鏝
QJM	鍝
QJN	鎉
QJP	迿
QJQ	錫
QJR	貿易投資
QJS	錁
QJT	鍟
QJU	貿易關係
QJW	貿易公司
QJX	錕
QJY	鉵
QKA	名著
QKB	邭
QKC	免驗
QKD	句
QKE	象
QKF	名
QKG	釦
QKH	釧
QKI	名酒
QKK	鋁
QKM	铞
QKN	免收
QKO	㗮
QKP	名字
QKQ	免
QKR	斪
QKS	象棋
QKT	敂
QKU	免疫
QKV	名畫
QKW	鴝
QKX	劖
QKY	名言
QLA	包羅萬象
QLC	䥯
QLD	甸
QLF	鐸
QLG	鈿
QLH	鉀
QLI	犯罪活動
QLK	䤧
QLL	鑘
QLN	鍶
QLP	鏈
QLQ	鐲
QLR	鏩
QLT	犯罪行為
QLV	鏤
QLW	鎅
QLX	鑼
QLY	犯罪率
QMA	錪
QMB	銅陵
QMD	鉠
QME	鏰
QMF	觴
QMG	鈾
QMI	鋼梁
QMJ	鍘
QMK	銅川
QML	鋼軌
QMM	銏
QMN	鍋
QMO	鍋爐
QMQ	鋼鐵
QMR	負擔
QMS	鋼材
QMT	鎽
QMU	負
QMV	鋼刀
QMW	鈉
QMX	負約
QMY	鋇
QNA	馓
QNB	饣
QNC	馂
QND	鋸
QNE	狠心腸
QNF	馌
QNG	䦀
QNH	鈕
QNI	钃
QNJ	馃
QNK	鍏
QNL	包圍
QNM	馉
QNN	釓
QNO	炰
QNP	包袱
QNQ	包金
QNR	钖
QNS	馇
QNT	鉍
QNU	勾心斗角
QNV	包
QNW	鈌
QNX	鈮
QNY	鈊
QOA	鍍
QOB	鯫
QOC	鮐
QOD	魷
QOE	鰩
QOF	鱈
QOG	鱷
QOH	鱸
QOI	匊
QOJ	魯
QOK	鰐
QOL	鰓
QOM	鯛
QON	鑣
QOO	鱗
QOP	鯇
QOQ	鮑
QOR	鰉
QOS	鰾
QOT	穌
QOU	炙
QOV	鯽
QOW	鮒
QOX	魮
QOY	鈥
QPA	鑧
QPB	鑽空子
QPD	鋐
QPE	䥱
QPF	鋎
QPG	錠
QPH	錧
QPL	鍕
QPN	鑏
QPO	䤹
QPP	危害社會
QPQ	鈂
QPR	金字招牌
QPS	危害极大
QPT	逃之夭夭
QPV	銨
QPW	鎔
QPX	鉈
QPY	鎺
QQA	銽
QQB	卶
QQC	銫
QQD	多大
QQE	錎
QQF	夡
QQG	鍂
QQH	多占
QQI	匇
QQJ	銁
QQK	銘
QQL	多思
QQM	金山
QQN	鉋
QQO	鑥
QQP	迻
QQQ	金
QQR	锪
QQS	金杯
QQT	鉚
QQU	多
QQV	錚
QQW	欽
QQX	多疑
QQY	釣
QRA	狠抓落實
QRB	匈
QRC	鈑
QRD	忽而
QRE	勿
QRF	鍎
QRG	鉑
QRH	釿
QRI	匁
QRJ	刎
QRK	留后路
QRL	忽略
QRM	錦
QRN	忽
QRP	忽視
QRQ	锨
QRR	鑕
QRS	鎩
QRT	錍
QRU	忽聞
QRW	鉄
QRX	鑠
QRY	匆
QSA	多极世界
QSB	迎來了
QSD	危机感
QSF	鏢
QSG	鉢
QSH	釘
QSI	錫林浩特
QSJ	鐔
QSK	鈳
QSL	危机四伏
QSN	多樣性
QSO	錰
QSP	錦標賽
QSR	鑻
QSS	獨木橋
QSU	迎來送往
QSW	錸
QSY	鈢
QTA	獲
QTB	犯
QTC	狁
QTD	鋒
QTE	狙
QTF	鑽
QTG	狂
QTH	鎳
QTI	猀
QTJ	猖
QTK	鉻
QTL	獨
QTM	猾
QTN	勹
QTO	狄
QTP	獰
QTQ	狗
QTR	狐
QTS	猹
QTT	猁
QTU	猶
QTV	狠
QTW	猴
QTX	狒
QTY	狼
QUA	鉼
QUB	鎙
QUD	錈
QUE	鎆
QUF	鋅
QUG	鉝
QUI	獨立法人
QUJ	鐘
QUK	锫
QUL	鏳
QUM	鐘山
QUN	獨立性
QUO	鐠
QUP	多辦實事
QUQ	多姿多彩
QUS	鐏
QUT	鏟
QUU	鐵道部
QUV	鎌
QUW	鎰
QUX	銻
QUY	獨立於
QVA	鐞
QVB	急聘
QVC	匓
QVD	迎刃而解
QVE	銀
QVF	鏽
QVG	釹
QVH	急劇
QVI	録
QVJ	鏁
QVK	銣
QVL	錙
QVM	鎻
QVN	急
QVP	鋟
QVQ	銀色
QVR	急迫
QVS	銀根
QVT	煞
QVU	急症
QVV	勼
QVW	多媒体
QVY	釰
QWA	錄像帶
QWC	鈆
QWD	鍛
QWE	鉁
QWF	鉜
QWG	鑰
QWH	鎀
QWI	勽
QWJ	銷售量
QWK	銳
QWL	負債纍纍
QWM	欠帳
QWN	釠
QWO	鍛煉
QWP	欠安
QWQ	鋁合金
QWR	欠缺
QWS	銝
QWT	銋
QWU	欠
QWV	鈖
QWW	銼
QWX	鈋
QWY	釟
QXA	煞費苦心
QXB	錄取
QXE	錄用
QXF	鏆
QXG	錄
QXH	鈏
QXI	銯
QXJ	鐨
QXK	鏹
QXM	外引內聯
QXP	錯綜複雜
QXQ	鮮紅色
QXR	錄製
QXS	鋼結構
QXT	錄入
QXU	錄音
QXV	匂
QXW	錄像
QXX	鍇
QXY	鉧
QYA	留英
QYB	解放出來
QYC	銃
QYD	訇
QYE	銥
QYF	䚻
QYG	鉒
QYI	久
QYJ	留影
QYK	鑲
QYL	解放思想
QYM	鈰
QYN	鹱
QYO	灸
QYP	外交官
QYQ	久久
QYR	解放后
QYT	鈁
QYU	鎊
QYV	留
QYW	鉸
QYX	鉉
QYY	鈫
RAA	拭
RAB	皂
RAC	兵荒馬亂
RAD	撕
RAE	撒
RAF	拑
RAG	扛
RAH	攬
RAI	擓
RAJ	措
RAK	攤
RAL	描
RAM	搆
RAN	拒
RAO	摸底
RAP	描寫
RAQ	摕
RAR	手工操作
RAS	描述
RAT	搭乘
RAU	后勤部
RAV	打工妹
RAW	搭
RAX	拒絕
RAY	找
RBA	無限期
RBB	攝
RBC	掫
RBD	撱
RBG	挕
RBH	邤
RBI	拯
RBJ	凶暴
RBK	凶器
RBL	掹
RBM	拙
RBN	扡
RBQ	兇
RBR	提出的
RBS	挅
RBT	扔
RBU	提出意見
RBW	攝像
RBY	扱
RCA	反攻
RCB	瓜子
RCC	掇
RCD	撪
RCE	捅
RCF	反霸
RCG	反正
RCH	反目
RCI	反
RCJ	掻
RCK	抬
RCL	返回
RCM	瓜農
RCN	把
RCO	反應
RCP	返
RCQ	抁
RCR	把握
RCS	返校
RCT	挨
RCU	㿝
RCW	捘
RCX	反比
RCY	瓜
RDA	拓荒
RDB	扼
RDC	拔
RDD	希奇
RDE	擾
RDF	振
RDG	拓
RDH	抔
RDI	揼
RDJ	掩
RDK	制成品
RDL	持有異議
RDM	希
RDN	拋
RDO	拻
RDP	白大褂
RDQ	挎包
RDR	摤
RDS	掎
RDT	挷
RDU	撩
RDV	技壓群芳
RDW	捧
RDX	拋磚引玉
RDY	扙
REA	揑
REB	捊
REC	授予
RED	捧腹大笑
REE	拹
REF	捋
REG	援
REH	覛
REI	披肝瀝膽
REK	拁
REL	皭
REN	授獎
REO	授粉
REP	授
REQ	掜
RER	攪
RES	採
RET	劤
REU	授意
REV	掙
REW	搜集
REX	援引
REY	授課
RFA	技巧
RFB	揭示了
RFC	技
RFD	擩
RFE	扶助
RFF	持
RFG	扗
RFH	盾
RFI	抺
RFJ	皁
RFK	拮
RFL	擂
RFM	乕
RFN	擣
RFO	捇
RFP	挬
RFQ	抏
RFR	扶持
RFS	扶植
RFT	拷
RFU	撻
RFV	持刀
RFW	扶
RFX	持續
RFY	打電話
RGA	挵
RGB	邱
RGC	巵
RGD	丘
RGE	搏
RGF	皇
RGG	抂
RGH	扌
RGI	捄
RGJ	摶
RGK	后
RGL	揀
RGM	抦
RGN	屔
RGO	挜
RGP	遑
RGQ	扤
RGR	捕捉
RGS	抹
RGT	乒
RGU	抨
RGV	捷
RGW	兵
RGX	挗
RGY	乓
RHA	遞
RHB	卸
RHC	披
RHD	排
RHE	掯
RHF	看
RHG	扯
RHH	攫
RHI	看法
RHJ	掉
RHK	拈
RHL	年輕
RHM	揁
RHN	拭目以待
RHO	年底
RHP	年初
RHQ	挸
RHR	年后
RHS	年來
RHT	排版
RHU	年前
RHV	看好
RHW	年代
RHX	皉
RHY	爬
RIA	
RIB	邾
RID	換湯不換藥
RIE	捎
RIF	皐
RIG	挄
RIH	揚湯止沸
RII	挱
RIJ	排水量
RIK	擋路
RIL	搞活國營大中型企業
RIN	抄收
RIP	擋
RIQ	抄錄
RIR	灥
RIS	楽
RIT	抄
RIU	泉
RIV	揮汗如雨
RIW	鴸
RIX	鼄
RIY	泉州
RJA	揭幕
RJB	撮
RJD	提成
RJE	擝
RJF	捏
RJG	抇
RJH	刈
RJI	提法
RJJ	提早
RJK	抗日戰爭
RJL	揾
RJM	揚帆
RJN	搨
RJO	提煉
RJP	提案
RJQ	揭
RJR	提拔
RJS	捰
RJT	提升
RJU	提前
RJW	提供
RJX	拽
RJY	撔
RKA	兵器工業
RKB	揖
RKC	挹
RKD	接踵而至
RKE	捐
RKF	捐款
RKG	挰
RKH	捉
RKI	操演
RKJ	︵
RKK	操
RKL	無足輕重
RKM	損
RKN	操心
RKO	操勞
RKP	操守
RKQ	拀
RKR	扣押
RKS	拐杖
RKT	捷足先登
RKU	捐資
RKV	操刀
RKW	抧
RKX	操縱
RKY	近距离
RLA	摑
RLB	兜圈子
RLC	擺
RLD	摁
RLE	無力
RLF	擇
RLG	舞
RLH	押
RLI	無法
RLJ	年輕時
RLK	舞蹈
RLL	攂
RLN	揌
RLO	無煙
RLP	摙
RLQ	擉
RLR	摲
RLS	無機
RLT	撂
RLU	舞弊
RLV	摟
RLW	搵
RLX	摞
RLY	無論
RMA	罐
RMB	缷
RMD	揣
RME	搰
RMF	抩
RMG	抽
RMH	製
RMI	罉
RMJ	罎
RMK	缶
RML	缺點
RMM	攖
RMN	缺
RMO	缹
RMP	制定
RMQ	缼
RMR	缿
RMS	罈
RMT	制造
RMU	掆
RMW	摧
RMX	罆
RMY	制衣
RNA	抿
RNB	掘
RNC	所能
RND	戶
RNE	挪用
RNF	扟
RNG	握
RNH	扭
RNI	摨
RNJ	氘
RNK	氚
RNL	氤
RNM	氙
RNN	癿
RNO	氣
RNP	氨
RNQ	气象
RNR	所
RNS	氥
RNT	氡
RNU	氧
RNV	氯
RNW	氛
RNX	氟
RNY	抋
ROA	擴
ROB	拒腐防變
ROC	拡
ROD	气度不凡
ROE	撲騰
ROF	反應堆
ROG	撲
ROH	掂
ROI	反對黨
ROJ	掂量
ROM	反腐敗鬥爭
RON	摝
ROO	撈
ROP	搪塞
ROQ	掋
ROR	無精打采
ROS	擵
ROT	反對和抵製
ROU	搪瓷
ROV	搪
ROW	捬
ROX	擴張
ROY	擴充
RPA	攐
RPB	制定了
RPD	迫
RPE	控股
RPF	皖
RPG	擯
RPH	捾
RPI	近海
RPJ	按照
RPK	近
RPL	揮
RPM	操之過急
RPN	擰
RPO	按摩
RPP	迫害
RPQ	抌
RPR	控制
RPS	打字机
RPT	挓
RPU	探病
RPV	按
RPW	控
RPX	拕
RPY	探望
RQA	扺
RQB	抑
RQC	鬼
RQD	擔
RQE	掐
RQF	欣喜
RQG	捦
RQH	抑止
RQI	挑
RQJ	挑剔
RQK	拘
RQL	挽回
RQM	換
RQN	抱
RQO	掬
RQP	鬼神
RQQ	撳
RQR	掏
RQS	打印机
RQT	抵御
RQU	抣
RQV	揮金如土
RQW	扻
RQX	打印紙
RQY	的
RRA	逝世
RRB	拆除
RRC	扳
RRD	皞
RRE	挀
RRF	埑
RRG	拍
RRH	折
RRI	皡
RRJ	蜇
RRK	哲
RRL	撫
RRM	質
RRN	乴
RRO	烲
RRP	逝
RRQ	掀
RRR	白
RRS	摋
RRT	捭
RRU	爻
RRV	娎
RRW	抶
RRX	擽
RRY	拆
RSA	打工
RSB	投机取巧
RSC	打通
RSD	打破
RSE	打架
RSF	摽
RSG	拪
RSH	打
RSI	打法
RSJ	撢
RSK	抲
RSL	打擊
RSM	打敗
RSN	殺戮
RSO	打火
RSP	打字
RSQ	打印
RSR	打扮
RSS	搮
RST	打算
RSU	閷
RSV	打好
RSW	殺
RSX	打響
RSY	剎
RTA	扥
RTB	拖
RTD	括
RTE	搬
RTF	插
RTG	手
RTH	攥
RTI	手法
RTJ	摥
RTK	挌
RTL	摠
RTM	擙
RTN	扢
RTO	播
RTP	抸
RTQ	拖欠
RTR	皒
RTS	手机
RTT	斤
RTU	擶
RTV	捼
RTW	拠
RTX	挴
RTY	乂
RUA	拼
RUB	搠
RUC	接通
RUD	捲
RUE	攏
RUF	抖
RUG	拉
RUH	手疾眼快
RUI	接洽
RUJ	撞
RUK	掊
RUL	指導思想
RUM	撇
RUN	接收
RUO	掽
RUP	提前完成
RUQ	接触
RUR	接近
RUS	擲
RUT	擱
RUU	拉美
RUV	接
RUW	搤
RUX	揹
RUY	按部就班
RVA	撏
RVB	招聘
RVC	揤
RVE	拫
RVF	挦
RVG	揵
RVI	捸
RVJ	摷
RVK	招
RVL	擸
RVM	招貼
RVN	扏
RVP	掃
RVQ	拶
RVR	招手
RVS	招標
RVT	㧅
RVV	掃帚
RVW	招集
RVX	招引
RVY	扨
RWA	推荐
RWB	推出
RWC	投
RWD	ア
RWE	劮
RWF	捨
RWG	拾
RWH	失眠
RWI	失
RWJ	扴
RWK	挩
RWL	白俄羅斯
RWM	推崇
RWN	怣
RWO	失火
RWP	迭
RWQ	失色
RWR	近几年
RWS	挆
RWT	拰
RWU	㒵
RWV	扮
RWW	挫
RWX	撥
RWY	扒
RXA	墍
RXB	皀
RXC	無線通信
RXD	提綱挈領
RXE	拗
RXF	摜
RXG	掾
RXH	批鬥
RXI	指派
RXJ	指
RXK	摾
RXL	指數
RXM	樂曲
RXN	㧈
RXO	樂業
RXP	指定
RXQ	撧
RXR	指控
RXS	指標
RXT	擬
RXU	搦
RXV	無線尋呼
RXW	指令
RXX	批
RXY	拇
RYA	希望工程
RYB	提高了
RYC	撤
RYD	抗原
RYE	挔
RYF	抗震
RYG	拄
RYH	抃
RYI	斥
RYJ	抗日
RYK	搞
RYL	擅
RYM	抗體
RYN	掮
RYO	搞糟
RYP	抗寒
RYQ	撤銷
RYR	摛
RYS	摘要
RYT	邀
RYU	摘
RYV	搞好
RYW	抗
RYX	摔
RYY	抆
SAA	械
SAB	桏
SAC	柜台
SAD	棋
SAE	橵
SAF	柑
SAG	橫
SAH	檻
SAI	欂
SAJ	模
SAK	權
SAL	櫗
SAM	構
SAN	枻
SAO	模糊
SAP	檬
SAQ	柩
SAR	棋手
SAS	模板
SAT	樥
SAU	欗
SAV	櫹
SAW	栱
SAX	本世紀
SAY	杙
SBA	极其
SBB	椰
SBC	楹
SBD	橢
SBE	极力
SBF	李
SBG	杍
SBH	邒
SBI	极小
SBJ	极易
SBK	極
SBL	相聯繫
SBM	柮
SBN	杝
SBO	极度
SBR	可恥的
SBS	桗
SBT	㭁
SBU	极端
SBV	极好
SBW	极低
SBY	極為
SCA	㭓
SCC	棳
SCD	桳
SCE	桶
SCK	枱
SCL	㮭
SCM	要能體現
SCN	杷
SCO	榪
SCQ	㭇
SCT	桙
SCW	梭
SCX	橘紅
SCY	杈
SDA	楕
SDB	枙
SDC	柭
SDD	來歷不明
SDE	棖
SDF	桍
SDG	枯
SDH	楔
SDI	枯水
SDJ	栢
SDK	槗
SDL	頂點
SDM	頂
SDN	遷
SDO	枯燥
SDP	遷安
SDQ	要不然
SDR	榞
SDS	椅
SDT	梆
SDU	䙲
SDV	遷怒
SDW	棒
SDX	桟
SDY	杖
SEA	檓
SEB	桴
SEE	棚
SEF	橫加干涉
SEG	桕
SEH	㮴
SEJ	核力量
SEK	枷
SEP	橓
SEQ	棿
SER	榣
SES	棌
SET	杉
SEU	橳
SEV	桵
SEW	楰
SEX	榽
SFA	枿
SFB	鄄
SFC	枝
SFD	檽
SFE	村學
SFF	桂
SFG	杜
SFH	植
SFI	票
SFJ	枾
SFK	桔
SFL	檑
SFM	楠
SFN	杇
SFO	材料
SFP	桲
SFQ	杬
SFR	票据
SFS	桂林
SFT	材
SFU	橽
SFV	樰
SFW	檣
SFX	杜絕
SFY	村
SGA	醋
SGB	酏
SGC	桎
SGD	本
SGE	酹
SGF	酵
SGG	枉
SGH	丁
SGI	梂
SGJ	醒
SGK	梧
SGL	醞
SGM	槽
SGN	配
SGO	醚
SGP	酡
SGQ	酌
SGR	酗
SGS	酊
SGT	酷
SGU	醅
SGV	棲
SGW	酚
SGX	酯
SGY	醉
SHA	櫨
SHB	想出
SHC	柀
SHD	棑
SHE	相助
SHF	相干
SHG	相
SHH	欋
SHI	想法
SHJ	槕
SHK	枮
SHL	樐
SHM	楨
SHN	想
SHO	相應
SHQ	梘
SHR	相反
SHS	相配
SHT	相符
SHU	相差
SHW	椇
SHX	橴
SHY	相交
SIA	根深蒂固
SIB	想法子
SID	相當長時間
SIE	梢
SIF	相當規模
SIG	桄
SII	桫
SIJ	標準時
SIK	柏油路
SIL	極少數
SIM	飄洋過海
SIN	可溶性
SIP	檔
SIQ	相當多的
SIR	相當的
SIS	相當可觀
SIT	杪
SIU	檔次
SIV	樑
SIW	標準化
SIY	㭂
SJA	柳暗花明
SJB	樶
SJC	查驗
SJD	相映成趣
SJE	機遇與挑戰
SJF	杳
SJG	查
SJH	柛
SJI	榥
SJJ	椙
SJK	查哨
SJL	榅
SJM	查帳
SJN	榻
SJO	查對
SJP	查究
SJQ	楬
SJR	查找
SJS	棵
SJT	查稅
SJU	查閱
SJX	棍
SJY	查房
SKA	可敬
SKB	楫
SKC	可能
SKD	可
SKE	柺
SKF	杏
SKG	枵
SKH	杊
SKI	歌唱演員
SKJ	可是
SKK	榀
SKM	歌曲
SKN	可以
SKO	歌迷
SKP	歌唱家
SKQ	柷
SKR	歌舞
SKS	哥
SKT	可靠
SKU	可親
SKV	枴
SKW	枳
SKX	可比
SKY	可望
SLA	槶
SLD	栶
SLE	㭷
SLF	㭗
SLG	柶
SLH	柙
SLL	櫑
SLN	楒
SLP	梿
SLQ	㯮
SLS	梱
SLT	棞
SLU	樓道
SLV	樓
SLW	楐
SLX	欏
SLY	楞
SMA	柵
SMB	票販子
SMD	柍
SME	榾
SMF	枏
SMG	柚
SMH	杣
SMI	李嵐清
SMM	櫻
SMN	楇
SMO	桐廬
SMP	相同之處
SMQ	枧
SMR	
SMS	桐柏
SMT	机帆船
SMU	賈
SMW	枘
SMX	桐鄉
SMY	梖
SNA	榐
SNB	朰
SND	椐
SNE	核心力量
SNF	可以達到
SNG	栩
SNH	楣
SNI	樨
SNJ	蚻
SNK	椲
SNN	札
SNP	核心家庭
SNQ	可以忽視
SNR	槢
SNS	橄欖
SNT	柲
SNU	榌
SNV	橫眉怒目
SNW	櫂
SNX	紮
SNY	杺
SOA	樜
SOB	杰出
SOD	材料厂
SOE	來料加工
SOF	櫥
SOG	樸
SOJ	㔄
SON	樚
SOO	棪
SOP	樸實
SOQ	橉
SOR	相應措施
SOS	賈慶林
SOT	榳
SOU	粟
SOV	椩
SOW	椨
SOX	材料費
SOY	相對說來
SPB	榨取
SPD	廼
SPE	椬
SPF	棕
SPG	楦
SPH	棺
SPI	榕江
SPJ	榠
SPK	丁字路
SPL	楎
SPN	檸
SPP	檢察官
SPQ	枕
SPR	樸實無華
SPS	棺材
SPT	楁
SPU	榟
SPV	桉
SPW	榷
SPX	柁
SPY	榊
SQA	柢
SQB	枊
SQC	栬
SQD	桅
SQE	桷
SQF	柳城
SQI	桃
SQJ	栒
SQK	橡
SQL	构思
SQM	㭥
SQN	枹
SQO	櫓
SQP	來犯之敵
SQQ	栘
SQR	楤
SQS	构想
SQT	柳
SQU	枃
SQV	棦
SQW	杴
SQY	榴
SRA	棉花
SRB	椶
SRC	柧
SRD	槔
SRE	可接受性
SRF	楯
SRG	柏
SRH	析
SRI	株
SRJ	晳
SRK	株距
SRL	橅
SRM	棉
SRN	惁
SRO	本年度
SRP	棉襖
SRQ	槐
SRR	攀
SRS	椞
SRT	椑
SRU	橷
SRW	柣
SRX	櫟
SRY	檄
SSA	攀枝花
SSB	郴
SSD	櫏
SSE	彬
SSF	禁
SSG	梄
SSH	朾
SSI	林海
SSJ	楂
SSK	柯
SSL	榃
SSM	槚
SSN	楚
SSO	焚
SSP	棾
SSQ	林甸
SSR	机械制造
SSS	森
SST	根本利益
SSU	林立
SSV	婪
SSW	梵
SSX	檢查組
SSY	林
STA	杔
STB	柂
STD	橋
STE	可利用
STF	橇
STG	桁
STH	柞
STI	椼
STJ	梸
STK	格
STL	桖
STM	榭
STN	杚
STO	楸
STP	柉
STQ	橁
STS	可移植性
STT	覆
STU	䅇
STV	櫛
STW	樅
STX	梅
STY	枚
SUA	栟
SUB	西門子
SUD	栚
SUE	櫳
SUF	梓
SUG	柆
SUH	欄目
SUI	栤
SUJ	樟
SUK	櫚
SUL	椫
SUM	樣冊
SUN	可塑性
SUO	椪
SUQ	栨
SUR	相關的
SUS	樽
SUT	楌
SUU	西北部
SUV	椄
SUW	榏
SUX	梯
SUY	西北郊
SVA	樳
SVB	根除
SVC	概
SVD	要不
SVE	根
SVF	要
SVG	楗
SVH	要目
SVI	棣
SVJ	樔
SVK	柖
SVL	椔
SVN	朹
SVO	根底
SVP	梫
SVQ	桚
SVR	根据
SVS	根本
SVT	朷
SVU	相媲美
SVV	榋
SVW	概念
SVX	要旨
SVY	杒
SWA	栰
SWB	來函
SWC	杸
SWD	椴
SWE	檢舉
SWF	柎
SWG	檢
SWH	樇
SWI	厀
SWJ	机遇
SWK	柗
SWL	配合默契
SWM	來由
SWN	槌
SWO	机床
SWP	机密
SWQ	樹倒猢猻散
SWR	机制
SWS	机构
SWT	楓
SWU	榆次
SWV	枌
SWW	麥
SWX	杹
SWY	椎
SXA	機工
SXB	椽子
SXC	機能
SXD	相比而言
SXE	柪
SXF	樌
SXG	椽
SXH	槇
SXI	機油
SXJ	柫
SXK	機器
SXL	機車
SXM	機體
SXN	朼
SXO	機床
SXP	相比之下
SXR	檰
SXS	楷模
SXT	機種
SXU	榒
SXV	機群
SXW	可比价格
SXX	楷
SXY	栂
SYA	西方世界
SYB	柱子
SYC	梳
SYD	校友
SYE	西方輿論
SYF	櫧
SYG	柱
SYI	梳洗
SYK	椋
SYL	檀
SYM	柿
SYN	怸
SYO	〡
SYP	述
SYQ	橠
SYR	樆
SYS	⒒
SYT	枋
SYU	榜
SYV	榔
SYW	校
SYX	槒
SYY	杭州
TAA	箋
TAB	笻
TAC	很難預料
TAD	箕
TAE	升學
TAF	笁
TAG	筐
TAH	籃
TAI	升溫
TAJ	徣
TAK	笸
TAL	筪
TAM	簧
TAN	秬
TAO	篝火
TAP	徔
TAQ	簪
TAR	移花接木
TAS	穆斯林
TAT	犕
TAU	䇝
TAV	乇
TAW	穫
TAX	升級
TAY	牫
TBB	竾
TBC	箃
TBD	頺
TBF	季
TBG	秄
TBH	䄦
TBI	篜
TBJ	透明
TBK	邊防戰士
TBM	笜
TBN	彵
TBO	季度
TBP	透
TBQ	透鏡
TBR	秀
TBS	各院校
TBT	䄧
TBU	秀美
TBV	䈨
TBW	篨
TBY	笈
TCA	笲
TCB	笆
TCC	犙
TCD	
TCE	筩
TCF	先驅者
TCG	私下
TCK	笞
TCN	㸭
TCO	篤
TCP	私宅
TCR	智能控制
TCT	私自
TCU	么
TCV	黎巴嫩
TCW	稄
TCY	私
TDA	甜
TDB	科研院所
TDC	叐
TDD	舌
TDE	箶
TDF	䇢
TDG	牯
TDH	逢
TDI	夭
TDJ	刋
TDK	智
TDL	矲
TDM	岙
TDN	稽
TDO	舕
TDP	适宜
TDQ	舐
TDR	很大的
TDS	犄
TDT	矯
TDU	矢
TDV	䂏
TDW	雉
TDX	矧
TDY	㣕
TEA	穩
TEB	稃
TEC	舥
TED	舦
TEE	稻
TEF	艝
TEG	租
TEH	艣
TEI	舟
TEJ	艃
TEK	笳
TEL	穱
TEM	稱
TEN	艉
TEO	艔
TEP	舵
TEQ	艪
TER	竻
TES	舸
TET	艇
TEU	籐
TEV	箏
TEW	般
TEX	舭
TEY	航
TFA	垂
TFB	毛孔
TFC	秐
TFD	壬
TFE	歃
TFF	竺
TFG	牡
TFH	㸩
TFI	特派
TFJ	午
TFK	造
TFL	德
TFM	牡丹
TFN	毛
TFO	第二炮兵
TFP	廷
TFQ	先
TFR	先后
TFS	造林
TFT	箸
TFU	乖
TFV	告退
TFW	稜
TFX	郵編
TFY	造就
TGA	笄
TGB	得到了
TGC	秷
TGD	生
TGE	箐
TGF	竽
TGG	彺
TGH	征
TGI	生活
TGJ	重
TGK	牛
TGL	勳
TGM	策
TGN	管理局
TGO	行唐
TGP	行家
TGQ	第一名
TGR	第一批
TGS	行
TGT	犇
TGU	秤
TGV	秉
TGW	穪
TGX	生疑
TGY	征文
THA	算
THB	郋
THC	彼
THD	自
THE	自用
THF	怎
THG	片
THH	徙
THI	篎
THJ	昝
THK	咎
THL	鼻
THM	自由
THN	息
THO	自燃
THP	延
THQ	筧
THR	臭氧
THS	臬
THT	竹
THU	辠
THV	自如
THW	犋
THX	自幼
THY	自主
TIA	篊
TIB	笵
TIC	箈
TID	稍有
TIE	稍
TIF	策源地
TIG	簿
TIH	箥
TII	生活水平
TIJ	篞
TIK	靠水吃水
TIL	生活困難
TIM	徜
TIN	生活必需品
TIO	短小精悍
TIP	簹
TIQ	知法犯法
TIR	箔
TIS	航海模型
TIT	秒
TIU	尓
TIV	筜
TIW	稍作
TIX	生活費
TIY	生活方式
TJA	篳
TJB	忁
TJC	衛星通信
TJD	馛
TJE	馟
TJF	香
TJG	得
TJH	利
TJI	香港
TJJ	馤
TJK	香味
TJL	得罪
TJM	香山
TJN	悡
TJO	透明度
TJP	馪
TJQ	鋫
TJR	复制
TJS	梨
TJT	馥
TJU	䖝
TJV	千里迢迢
TJW	馚
TJX	箟
TJY	利率
TKA	各式
TKB	箿
TKC	䇼
TKD	頟
TKE	特別助理
TKF	各
TKG	和
TKH	㸪
TKI	洜
TKJ	和煦
TKK	簞
TKL	各界
TKM	禹
TKN	惒
TKO	程序
TKP	各室
TKQ	兎
TKR	程控
TKS	种植
TKT	敋
TKU	各部
TKV	和好
TKW	雒
TKX	各級
TKY	各方
TLA	衊
TLB	範
TLC	犤
TLD	血
TLE	稩
TLF	盉
TLG	牭
TLH	從輕處罰
TLI	衆
TLJ	笚
TLK	血蹟
TLL	範圍
TLM	簤
TLN	衄
TLP	血案
TLQ	悤
TLR	囪
TLS	稇
TLT	稛
TLU	重點問題
TLV	簍
TLW	稷
TLX	籮
TLY	重點課題
TMA	穠
TMB	身子
TMD	身
TME	身受
TMF	笛
TMG	微
TMH	秈
TMI	微波
TMJ	屲
TMK	逈
TML	秧田
TMM	笧
TMN	簻
TMO	嶴
TMP	身穿
TMQ	向外
TMR	身后
TMS	微机
TMT	奧
TMU	筫
TMV	微妙
TMW	笍
TMX	微弱
TMY	㸽
TNA	特异功能
TNB	乞
TND	愁眉不展
TNE	向心力
TNF	行尸走肉
TNG	笥
TNH	徦
TNI	徲
TNJ	刉
TNK	衛
TNL	衛國
TNN	筷
TNO	得心應手
TNP	迄
TNQ	秘魯
TNR	自己的
TNS	徇情枉法
TNT	簈
TNU	稺
TNV	秘書
TNW	穋
TNX	秜
TNY	笖
TOA	穬
TOB	䎹
TOD	程度不同
TOE	翻騰
TOF	秩序井然
TOG	甃
TOH	延慶縣
TOI	釆
TOJ	稥
TOK	程序員
TOL	釋
TOM	釉
TON	愁
TOO	簩
TOP	翻案
TOQ	鍫
TOR	揫
TOS	醔
TOT	秋季
TOU	夈
TOV	媝
TOW	鶖
TOX	私營經濟
TOY	翻譯
TPA	簺
TPB	牸
TPD	犗
TPE	秾
TPF	徖
TPG	稼
TPH	管
TPI	航空港
TPJ	很容易
TPK	乏味
TPL	管界
TPN	穩定性
TPO	延安精神
TPP	管家
TPQ	箢
TPR	管制
TPS	筞
TPT	秺
TPU	乏
TPV	管好
TPW	箜
TPX	管線
TPY	簶
TQA	牴
TQB	禿
TQD	衡
TQE	觕
TQF	篯
TQG	銜
TQI	筄
TQJ	徇
TQK	笱
TQL	自然界
TQM	衡山
TQN	笣
TQO	穭
TQP	身外之物
TQQ	移
TQR	物
TQS	移植
TQT	黎
TQU	笉
TQV	籙
TQW	物价
TQX	自然經濟
TQY	彴
TRA	箍
TRB	稯
TRC	筢
TRD	稀
TRE	科技力量
TRF	循
TRG	徨
TRH	㸫
TRI	穆
TRJ	千年虫
TRK	筘
TRL	籜
TRM	科技周
TRN	犔
TRO	秩序
TRP	御寒
TRQ	篼
TRR	笅
TRS	我想
TRT	稗
TRU	科技部
TRW	秩
TRX	我
TRY	徼
TSA	篐
TSB	箱子
TSC	很可能
TSD	重要原因
TSE	重要力量
TSF	䇴
TSG	徆
TSH	箱
TSI	重要渠道
TSJ	簟
TSK	牱
TSL	重要因素
TSM	重要內容
TSN	重要性
TSO	種植業
TSP	積極宣傳
TSQ	籕
TSR	重要的
TSS	篥
TST	笨重
TSU	積極開展
TSW	徠
TSX	重要組成部分
TSY	術
TTA	秅
TTB	生物防治
TTC	行得通
TTD	笑
TTE	笑貌
TTF	牦
TTG	牲
TTH	筵
TTI	各种渠道
TTJ	稪
TTK	笿
TTL	篦
TTM	生物體
TTN	秭
TTO	篍
TTP	笑容
TTQ	簃
TTR	篽
TTS	筿
TTT	禾
TTU	犐
TTV	箻
TTW	篵
TTX	龝
TTY	牧
TUA	乘警
TUB	乘除
TUD	犈
TUE	箭
TUF	笠
TUG	犧
TUH	従
TUI	乘法
TUJ	簡
TUK	犃
TUL	乘車
TUM	徶
TUN	乥
TUP	乘客
TUQ	得道多助
TUR	乊
TUS	乘机
TUT	犪
TUU	科普
TUV	稴
TUW	鷑
TUX	乘
TUY	簢
TVA	很苦
TVC	節
TVD	衟
TVE	很
TVF	委
TVG	律
TVH	覣
TVI	箓
TVJ	很早
TVK	笤
TVL	犣
TVM	委曲
TVN	很快
TVO	簘
TVP	逶
TVQ	很多
TVR	魏
TVS	筆杆
TVT	很重
TVU	很冷
TVV	很好
TVW	很低
TVX	很弱
TVY	牣
TWA	筏
TWB	行使職權
TWC	役
TWD	頽
TWE	生命力
TWF	符
TWG	徐
TWH	篠
TWI	黏
TWJ	節假日
TWK	稅
TWL	簽署
TWM	生命財產
TWN	篩
TWO	我們應該
TWP	答案
TWQ	簽名
TWR	稚气
TWS	复合材料
TWT	秹
TWU	秂
TWV	凢
TWW	從
TWX	簽約
TWY	稚
TXA	第七
TXB	每隔
TXC	節約能源
TXD	龜
TXE	胤
TXF	毎
TXG	篆
TXH	第
TXI	各級黨委
TXJ	彿
TXK	後患
TXL	第四
TXM	每周
TXN	牝
TXO	繁榮
TXP	每家
TXQ	箹
TXR	每年
TXS	後來
TXT	繁
TXU	每
TXV	第九
TXW	第八
TXX	秕
TXY	牳
TYA	簱
TYB	稿子
TYC	徹
TYD	各方面
TYE	入股
TYF	䇾
TYG	往
TYH	笇
TYI	入
TYJ	往日
TYK	稿
TYL	生產國
TYM	屳
TYN	篇
TYO	糴
TYP	込
TYQ	往外
TYR	籬
TYS	稿酬
TYT	彷
TYU	徬
TYV	稂
TYW	牨
TYX	稸
TYY	入市
UAA	辛勤工作
UAB	郱
UAC	并能
UAD	疘
UAE	并且
UAF	疳
UAG	瓶
UAH	冴
UAJ	竎
UAK	癱
UAL	新世界
UAM	癀
UAN	疶
UAO	辛勤勞動
UAP	迸
UAQ	艵
UAR	并提
UAS	并要
UAT	并行
UAU	并立
UAV	剏
UAW	瘩
UAX	新世紀
UAY	䇅
UBA	普及工作
UBB	逆耳
UBD	聞
UBE	疓
UBF	逆境
UBG	普及型
UBH	競聘上崗
UBI	逆流
UBJ	兯
UBL	逆轉
UBM	兼聽則明
UBN	塑性
UBO	塑料
UBP	立陶宛
UBQ	聞名
UBS	痾
UBT	塑
UBU	逆差
UBV	部隊建設
UBW	癊
UBY	普及率
UCA	慿
UCC	瘮
UCD	瘆
UCE	痛
UCF	普通老百姓
UCG	闖勁
UCH	痛處
UCI	新能源
UCK	冶
UCL	痛擊
UCM	並通過
UCN	痛心
UCO	馮
UCP	憑空
UCQ	冶金
UCR	痛失
UCS	痛楚
UCT	竢
UCU	疤痕
UCV	疤
UCW	痠
UCX	憑弔
UCY	瘙
UDA	北大荒
UDB	勌
UDC	閎
UDD	閆
UDE	辦
UDF	送走
UDG	㓈
UDH	眷
UDI	
UDJ	閹
UDK	半成品
UDL	送回
UDM	帣
UDN	疣
UDO	准确度
UDP	送
UDQ	觠
UDR	拳
UDS	桊
UDT	牶
UDU	療
UDV	券
UDW	瘞
UDX	辮
UDY	辯
UEA	前期
UEB	瘦子
UEC	前台
UED	閒
UEE	痭
UEF	奨
UEG	疽
UEH	瘦
UEI	前沿
UEJ	前
UEK	瘸
UEL	襲擊
UEM	瘦肉
UEN	癙
UEO	競爭對手
UEP	遂
UEQ	前夕
UER	前提
UES	前來
UET	前往
UEU	豙
UEV	凈
UEW	毅
UEX	瘦弱
UEY	前方
UFA	辛苦
UFB	新臺階
UFC	闔
UFD	㽵
UFE	養雞
UFF	閨
UFG	養殖
UFH	癲
UFI	疛
UFJ	辛
UFK	閈
UFL	凟
UFM	美元貶值
UFN	痣
UFO	辛勞
UFP	凌空
UFQ	羌
UFR	開場白
UFS	辛酸
UFT	閉
UFU	闥
UFV	半封建
UFW	養
UFX	首都經濟
UFY	新老交替
UGA	差
UGB	病院
UGC	羧
UGD	閂
UGE	靖
UGF	
UGG	羥
UGH	疜
UGI	羨
UGJ	羊
UGK	半
UGL	闌
UGM	病
UGN	羞
UGO	羹
UGP	羜
UGQ	冽
UGR	叛
UGS	病根
UGT	義
UGU	善
UGV	痙
UGW	羚
UGX	痍
UGY	癍
UHA	瘧
UHB	半輩子
UHC	疲
UHD	㾇
UHE	門臉
UHF	疲塌
UHG	前些天
UHH	癯
UHI	門源
UHJ	竨
UHK	丫
UHL	疲軟
UHM	站崗
UHN	門
UHO	疲勞
UHP	站定
UHQ	門外
UHR	前些年
UHS	站票
UHT	疲乏
UHU	站立
UHV	并非如此
UHW	疲倦
UHX	疵
UHY	門診
UIA	冰期
UID	並沒有
UIE	痟
UIF	冰雪
UIG	新水平
UIH	龍潭虎穴
UII	閖
UIK	冰川
UIL	美洲國家
UIM	冰山
UIN	冰層
UIO	冰糖
UIP	闛
UIR	前清后欠
UIS	冰柜
UIT	闊
UIU	冰冷
UIV	判決書
UIW	瘠
UIX	闊綽
UIY	冰
UJA	韺
UJB	韷
UJD	間
UJE	竭力
UJF	音
UJG	瘍
UJH	痩
UJI	痋
UJJ	閶
UJK	韻
UJL	瘟
UJM	韶山
UJN	意
UJO	意料
UJP	病虫害
UJQ	竟
UJR	韹
UJS	贛榆
UJT	韸
UJU	瘟疫
UJV	韶
UJW	鶕
UJX	戠
UJY	閺
UKA	部落
UKB	部
UKC	開足馬力
UKD	問
UKE	勏
UKF	咅
UKG	瓿
UKH	竒
UKI	痛哭流涕
UKJ	剖
UKK	癌
UKL	部署
UKN	競選
UKO	部類
UKP	立足之地
UKQ	競
UKR	競技
UKS	剖析
UKT	敨
UKU	癌症
UKV	問好
UKW	疻
UKX	部級
UKY	部族
ULA	兾
ULB	部署了
ULD	痼
ULE	曾用
ULF	凙
ULG	癏
ULI	瘝
ULJ	曾
ULK	閘
ULL	癳
ULN	曾以
ULO	美國康柏電腦公司
ULP	前車之鑒
ULR	前因后果
ULS	閫
ULT	前因後果
ULU	痼疾
ULV	瘻
ULW	曾任
ULX	瘰
ULY	曾為
UMA	痶
UMD	㾄
UME	半山腰
UMF	凋
UMG	凒
UMH	瞥見
UMI	弊
UMK	疝
UML	端點
UMM	癭
UMN	瘑
UMO	端庄
UMP	開山祖師
UMR	新體製
UMT	闝
UMU	弊端
UMW	凗
UMY	端詳
UNA	癜
UNB	闞
UND	新局面
UNF	瘺
UNG	翊
UNH	瘕
UNI	悶
UNJ	開懷暢飲
UNK	癖
UNL	新裝置
UNN	䇃
UNQ	前怕狼后怕虎
UNR	關心的
UNT	閟
UNU	竮
UNV	㽶
UNW	瘳
UNX	痆
UNY	痴心妄想
UOA	塑料薄膜
UOB	普及
UOC	普通
UOD	塑料厂
UOE	並且
UOF	並未
UOG	普
UOH	並非
UOI	焛
UOJ	普照
UOL	並轉
UOM	開業典禮
UON	並以
UOO	痰
UOP	意料之中
UOR	塑料制品
UOS	普查
UOT	並行
UOU	並立
UOW	首席代表
UOX	導火線
UOY	普遍
UPA	新社區
UPB	奠定了
UPD	竤
UPE	竩
UPG	逆定理
UPH	痯
UPI	新安江
UPJ	凕
UPK	半空中
UPL	瘒
UPN	兼容性
UPO	養家糊口
UPQ	㽸
UPR	冷空气
UPS	竚
UPT	音容笑貌
UPU	問寒問暖
UPW	辦案人員
UPX	遵守紀律
UQA	閽
UQB	次子
UQC	姿態
UQD	㾣
UQE	閻
UQF	螀
UQG	凎
UQI	資源
UQJ	次日
UQK	凂
UQL	次數
UQM	瘓
UQN	關鍵性
UQO	癬
UQP	次之
UQQ	痑
UQR	(
UQS	,
UQT	§
UQU	曾多次
UQV	竫
UQW	資
UQX	關貿總協定
UQY	瘤
URA	善后工作
URC	㽹
URD	前后左右
URE	意气用事
URF	前所未有
URG	前提下
URH	㾷
URI	闎
URJ	新的里程碑
URK	䦐
URM	痸
URN	逆反心理
URO	開拓精神
URP	門戶之見
URQ	瘣
URR	義無反顧
URT	痺
URU	開拓前進
URV	兿
URW	音樂會
URY	新的高度
USA	新式
USB	闡述了
USC	站柜台
USD	閪
USE	新股
USF	痲
USG	尊
USH	親
USI	閑
USJ	新星
USK	疔
USL	新田
USM	尊崇
USN	新民
USO	新材料
USP	遵守
USQ	新金
USR	新
USS	痳
UST	尊重
USU	新意
USV	闄
USW	凇
USX	新疆
USY	新房
UTA	凞
UTB	痵
UTC	疾馳
UTD	疾
UTE	閁
UTF	冼
UTG	瘇
UTH	首
UTI	新生活
UTJ	痢
UTK	閣
UTL	首輪
UTM	癥
UTN	疙
UTO	首席
UTP	疺
UTQ	新生儿
UTR	首批
UTS	首先要
UTT	剷
UTU	疼
UTV	癤
UTW	痜
UTX	痗
UTY	病入膏肓
UUA	辛辛苦苦
UUB	闕
UUC	普普通通
UUD	閚
UUE	癇
UUF	癢
UUG	竝
UUH	開門見山
UUI	立法
UUJ	瘴
UUK	痥
UUL	竲
UUM	半導體
UUN	痛痛快快
UUO	新聞廣播
UUP	立案
UUQ	閉關鎖國
UUR	前前后后
UUS	竴
UUT	立秋
UUU	立
UUV	立即
UUW	立体
UUX	開門紅
UUY	立刻
UVA	開始工作
UVB	開始了
UVD	兼有
UVE	痕
UVF	妾
UVG	冿
UVI	䇐
UVK	癰
UVN	歉收
UVO	歉
UVP	兼容
UVR	美好的
UVT	美好生活
UVU	兼并
UVV	開始建立
UVW	兼任
UVX	開始繼續
UVY	兼顧
UWA	閥
UWB	開創了
UWC	疫
UWD	准确
UWE	疹
UWF	瘵
UWG	痊
UWH	冷眼
UWI	閃
UWJ	疥
UWK	閱
UWL	益
UWN	竌
UWO	辦公廳
UWP	并使之
UWQ	瘋狂
UWR	前几年
UWS	冷酷
UWT	瘋
UWU	疫病
UWV	竕
UWW	痤
UWX	癈
UWY	冷
UXA	關切
UXB	邶
UXC	新經驗
UXD	瘬
UXE	鄁
UXF	冀南
UXG	丠
UXH	弟
UXI	北海
UXJ	疿
UXK	冀中
UXL	冀
UXM	北山
UXN	北
UXO	癡迷
UXP	慈祥
UXQ	背包
UXR	背后
UXS	北极
UXT	凝
UXU	北部
UXV	疕
UXW	北伐
UXX	關
UXY	北京
UYA	辛亥革命
UYB	資產階級
UYC	㓍
UYD	訚
UYE	閍
UYF	普遍真理
UYG	冫
UYI	閔
UYJ	北京時間
UYK	凉
UYL	凜
UYM	閙
UYN	閡
UYO	立方米
UYP	北京軍區
UYQ	資產負債率
UYR	善良的
UYS	ā
UYT	丷
UYU	癠
UYV	閬
UYW	瘁
UYX	痃
UYY	北京市
VAA	嫟
VAB	媶
VAD	娀
VAE	尋覓
VAF	媒
VAG	妅
VAH	姬
VAI	媒婆
VAJ	嫫
VAK	尋
VAL	媌
VAM	媾
VAN	姖
VAP	如期實現
VAQ	尋甸
VAR	尋找
VAS	尋根
VAT	嫕
VAU	孏
VAV	嫉賢妒能
VAW	娂
VAY	尋訪
VBB	女孩子
VBC	娵
VBD	嫷
VBE	好用
VBF	㜽
VBG	好
VBH	邚
VBI	奶油
VBK	好吃
VBL	好轉
VBM	好過
VBN	她
VBO	奶粉
VBP	好客
VBQ	好多
VBR	好的
VBS	婀
VBT	奶
VBU	好意
VBV	奶奶
VBW	好像
VBX	好比
VBY	好評
VCA	既
VCB	即
VCC	駑
VCD	砮
VCE	努
VCF	奴才
VCG	始末
VCI	怒江
VCJ	既是
VCK	始
VCL	即墨
VCM	帑
VCN	怒
VCO	媽
VCP	既定
VCQ	既然
VCR	拏
VCS	即可
VCT	娭
VCU	厹
VCV	媽媽
VCW	鴑
VCX	弩
VCY	奴
VDA	媠
VDC	妭
VDD	恕不奉陪
VDE	姷
VDF	娠
VDG	姑
VDH	妚
VDJ	㛪
VDM	媆
VDN	娍
VDO	刀耕火种
VDP	好不容易
VDQ	娔
VDR	嫄
VDS	婍
VDT	姑息
VDU	㚑
VDV	姑娘
VDW	媋
VDY	書面講話
VEA	㜒
VEB	娐
VEC	女服務員
VED	努力克服
VEE	嫍
VEF	退款
VEG	姐
VEH	嫂
VEI	艮
VEK	退路
VEL	退回
VEM	嬹
VEN	退居
VEO	退席
VEP	退
VEQ	婗
VER	媱
VES	婇
VET	婬
VEU	姐弟
VEV	娞
VEW	退休
VEX	退縮
VEY	努力方向
VFA	彟
VFB	妹子
VFC	妓
VFD	嬬
VFE	書架
VFF	娃
VFG	九十五
VFH	娬
VFI	妹
VFJ	卆
VFK	嬉
VFL	畫
VFM	婻
VFN	娡
VFO	書店
VFP	嬄
VFQ	妧
VFR	九十年代
VFS	孀
VFT	姥
VFU	婞
VFV	娃娃
VFW	嬙
VFX	如雷貫耳
VFY	九十六
VGA	妍
VGB	建院
VGC	姪
VGD	姸
VGE	婊
VGF	婭
VGG	建平
VGH	嫣
VGI	嫩江
VGJ	姮
VGK	聿
VGL	婳
VGM	姉
VGO	建廠
VGP	建
VGQ	煭
VGR	建制
VGS	妺
VGT	建筑
VGU	建立
VGV	婕
VGW	嬭
VGX	姨
VGY	建交
VHA	婋
VHB	盡職
VHD	婔
VHE	盡力
VHF	盡孝
VHG	盡
VHH	㜹
VHI	如虎添翼
VHJ	婥
VHK	肀
VHL	好戲連臺
VHM	媜
VHN	盡快
VHQ	娊
VHR	如上所述
VHT	如此等等
VHV	媫
VHX	好處費
VHY	如此說來
VIA	妙藥
VID	既沒有
VIE	娋
VIG	姯
VIH	妙齡
VII	妙法
VIJ	鹔
VIK	女演員
VIL	盝
VIN	䏋
VIO	如法炮制
VIP	逮
VIR	逮捕
VIT	妙
VIV	媣
VIW	逮住
VIY	妙語
VJB	好日子
VJD	旭
VJF	旮
VJG	妲
VJH	妽
VJI	巢湖
VJJ	娼
VJL	嫚
VJM	媀
VJP	巢穴
VJQ	盡早解決
VJS	巢
VJV	娼妓
VJW	劃時代
VJX	婫
VJY	如果說
VKA	如期
VKB	邵
VKC	邕
VKD	如愿
VKE	娟
VKF	召
VKG	如
VKH	妕
VKI	如常
VKJ	刟
VKK	嬋
VKL	召回
VKM	帤
VKN	恕
VKP	邕宁
VKQ	欩
VKR	挐
VKS	桇
VKU	如意
VKV	盡忠盡職
VKW	鴽
VKX	絮
VKY	女中豪杰
VLA	群眾監督
VLB	䣎
VLD	姻
VLE	娚
VLF	甾
VLG	㚼
VLH	嬽
VLI	巡回演出
VLJ	㓯
VLK	群眾路線
VLL	群眾團體
VLM	㜥
VLN	媤
VLP	群眾運動
VLQ	㜛
VLR	邋
VLS	群眾來信
VLT	群眾生活
VLU	群眾意見
VLV	㜢
VLW	媼
VLX	嫘
VLY	群眾文化
VMA	姍
VMD	姎
VME	女同學
VMF	姌
VMG	妯
VMH	奾
VMJ	㞪
VMM	孆
VMN	媧
VMO	刀山火海
VMV	妯娌
VMW	妠
VMY	㛝
VNA	㜊
VNB	㐇
VND	婮
VNF	退居二線
VNG	娜
VNH	婿
VNI	孎
VNK	媁
VNN	妃
VNQ	盡快解決
VNR	刀把
VNS	刀槍
VNT	刀
VNU	㣽
VNV	刀刃
VNW	妜
VNX	妮
VNY	姒
VOA	嫬
VOE	群魔亂舞
VOF	㛇
VOJ	粛
VOK	怒火中燒
VON	災民
VOO	婒
VOP	災害
VOQ	嫾
VOR	妖魔鬼怪
VOS	嬤
VOT	㚧
VOU	災
VOV	嫝
VOW	彛
VOX	彞
VPA	巡警
VPE	辺
VPF	婃
VPG	嫁
VPH	婠
VPI	九寨溝
VPJ	嫇
VPL	媈
VPM	帚
VPN	嬣
VPO	㛮
VPP	巡視
VPQ	婉
VPR	嫁接
VPS	巡查
VPT	嬸
VPV	巡
VPW	嫆
VPX	嫁給
VPY	婉言
VQA	婚
VQB	媰
VQD	姽
VQF	肅然起敬
VQG	婚事
VQH	婚齡
VQI	姚
VQJ	姰
VQK	娩
VQM	媍
VQN	㚿
VQO	婅
VQP	姚安
VQQ	姼
VQR	婚后
VQS	婚配
VQT	婚後
VQU	夛
VQV	婙
VQW	如狼似虎
VQX	婚約
VQY	妁
VRC	㛂
VRD	㛓
VRF	娛樂場所
VRG	姤
VRH	妡
VRI	姝
VRL	嫵
VRM	婂
VRN	娛樂性
VRQ	媿
VRR	㜱
VRS	忍無可忍
VRT	婢
VRW	妷
VRX	㜰
VRY	嬓
VSA	建材工業
VSB	好极了
VSC	盡可能
VSE	好樣兒的
VSF	嫖
VSG	㛉
VSH	奵
VSJ	㜁
VSK	妸
VSP	嫖宿
VSR	奴隸製度
VSS	劃框框
VST	書本知識
VSU	尋根問底
VSV	婹
VSW	婡
VSY	奴隸主
VTA	奼
VTB	君子
VTC	九台
VTD	嬌
VTE	尹
VTF	妊
VTG	姓
VTH	媳
VTI	九江
VTJ	娳
VTK	群
VTL	媲
VTM	姠
VTN	九
VTO	嬏
VTP	姂
VTQ	姓名
VTR	娥
VTS	建筑材料
VTT	建筑物
VTU	媲美
VTV	婑
VTW	群体
VTX	娒
VTY	姀
VUA	姘
VUB	建立了
VUC	盡義務
VUD	婘
VUE	媊
VUF	姘夫
VUG	姅
VUJ	嫜
VUK	娧
VUL	好意思
VUN	嫉恨
VUO	召開座談會
VUP	忍痛割愛
VUQ	嫌犯
VUR	如前所述
VUS	嫻
VUT	嫉
VUU	好新聞
VUV	嫌
VUW	建立健全
VUX	娣
VUY	嫻熟
VVA	女工
VVB	女子
VVD	女友
VVE	女用
VVF	㚣
VVG	奻
VVH	嬧
VVI	娽
VVK	妱
VVN	女性
VVP	婦
VVQ	女儿
VVR	女排
VVS	女權
VVT	女生
VVU	婚姻關係
VVV	女
VVW	女人
VVX	婦幼
VVY	女方
VWA	退休工人
VWC	妐
VWE	盡全力
VWF	退休干部
VWG	姵
VWH	如何處理
VWI	刅
VWJ	妎
VWK	媬
VWN	娰
VWP	退伍軍人
VWQ	退休金
VWR	她們的
VWS	㛊
VWT	姙
VWU	好几次
VWV	鳩
VWW	孅
VWX	盡人皆知
VWY	妗
VXA	始終堅持
VXC	始終能夠
VXD	始終不渝地
VXG	始終一貫
VXH	始終處於
VXJ	始終是
VXN	始終恪守
VXQ	嫌疑犯
VXR	嬵
VXU	嫋
VXV	始終如一
VXW	嫌疑人
VXX	妣
VXY	姆
VYA	建設項目
VYC	好高騖遠
VYD	訄
VYE	忍受
VYF	建設者
VYG	娮
VYH	書記處書記
VYI	刃
VYK	婷
VYL	嬗
VYM	建設周期
VYN	忍
VYO	建設廳
VYP	娘家
VYQ	女主角
VYT	妨
VYU	嫡
VYV	奿
VYW	姣
VYX	妶
VYY	妏
WAA	侙
WAB	傇
WAC	烏蘭巴託
WAD	偌
WAE	儰
WAF	仝
WAG	仜
WAH	伢
WAI	供水
WAJ	借
WAK	僅
WAL	儚
WAM	偀
WAN	伳
WAO	代序
WAP	備案
WAQ	儆
WAR	借据
WAS	伐木
WAT	備
WAU	化工部
WAV	借書
WAW	供
WAX	供給
WAY	伐
WBA	仍舊
WBB	倻
WBC	發出通知
WBD	仍有
WBF	仍未
WBG	仔
WBH	䢳
WBI	作出決定
WBJ	仍是
WBK	進出口
WBL	他國
WBM	㑁
WBN	他
WBO	保險業
WBQ	鸧
WBR	作出的
WBS	保障机制
WBT	仍
WBU	人際關係
WBV	作出努力
WBW	他人
WBX	仔細
WBY	伋
WCA	公共
WCB	公子
WCC	傪
WCD	頌
WCE	俑
WCF	公款
WCG	公正
WCI	公演
WCJ	公里
WCK	佁
WCL	公署
WCN	翁
WCO	傌
WCP	公安
WCQ	兊
WCR	公斤
WCS	枀
WCT	俟
WCU	公
WCV	任務書
WCW	俊
WCX	公頃
WCY	仏
WDA	佐
WDB	伌
WDC	伖
WDD	做成
WDE	優
WDF	侉
WDG	估
WDH	鳳
WDI	做法
WDJ	俺
WDK	傳感器
WDL	優點
WDM	佈
WDN	优异
WDO	集成度
WDP	做客
WDQ	偧
WDR	傆
WDS	倚
WDT	做
WDU	僚
WDV	做好
WDW	段
WDX	全面貫徹
WDY	伏
WEA	使用期
WEB	俘
WEC	俷
WED	集腋成裘
WEE	倗
WEF	䏌
WEG	仴
WEH	傁
WEI	优胜劣汰
WEK	伽
WEM	偁
WEN	全力以赴
WEP	僢
WEQ	倪
WER	㐱
WES	倸
WET	僞
WEU	人力資源
WEV	俀
WEW	使用价值
WEX	傒
WEY	使用方法
WFA	僨
WFB	付出
WFC	伎
WFD	儒
WFE	舒服
WFF	佳
WFG	仁
WFH	什
WFI	祭
WFJ	仐
WFK	舒
WFL	傤
WFM	八達嶺
WFN	儔
WFO	發電廠
WFP	侼
WFQ	発
WFR	八十年代
WFS	分支机构
WFT	佬
WFU	倖
WFV	佞
WFW	伕
WFX	佳績
WFY	付
WGA	侀
WGB	伅
WGC	倒
WGD	癸
WGE	傅
WGF	全
WGG	伍
WGH	佂
WGI	俅
WGJ	便
WGK	使
WGL	僵
WGM	債
WGN	兮
WGO	企事業單位
WGP	使之
WGQ	例
WGR	全年
WGS	途
WGT	使得
WGU	伻
WGV	俓
WGW	儞
WGX	仾
WGY	全市
WHA	俿
WHB	會見了
WHC	佊
WHD	凪
WHE	佔用
WHF	企
WHG	佧
WHH	企盼
WHI	修水
WHJ	倬
WHK	佔
WHL	企圖
WHM	偵
WHN	候
WHO	企業
WHP	偵察
WHQ	俔
WHR	佔據
WHS	候机
WHT	條
WHU	修剪
WHV	偼
WHW	俱
WHX	佌
WHY	企望
WIA	倘若
WIB	依法取締
WID	低消耗
WIE	俏
WIF	發源地
WIG	侊
WIH	俏皮
WII	依法治理
WIJ	含水量
WIK	依法嚴懲
WIL	貪污罪
WIM	倘
WIN	合法性
WIO	合法席位
WIP	償
WIQ	貪污犯
WIR	依法拘留
WIS	合法權益
WIT	仯
WIU	尒
WIV	依法逮捕
WIW	愈演愈烈
WIX	合法經營
WIY	仦
WJA	儤
WJB	伸出
WJC	㑠
WJD	但愿
WJF	俚
WJG	但
WJH	伸
WJI	假日消費
WJJ	介
WJK	㖋
WJL	僈
WJM	偶
WJN	傝
WJP	發明家
WJQ	偈
WJR	伸手
WJS	倮
WJT	介入
WJU	介意
WJW	偶像
WJX	倱
WJY	假日旅游
WKA	保苗
WKB	偮
WKC	俋
WKD	保存
WKE	集中力量
WKF	㕣
WKG	㐰
WKH	促
WKI	保洁
WKJ	保暖
WKK	儼
WKL	堡壘
WKM	傊
WKN	俁
WKO	集中精力
WKP	保密
WKQ	兌
WKR	保持
WKS	保
WKT	侶
WKU	人口普查
WKV	保姆
WKW	伿
WKX	分別比
WKY	命中率
WLA	俄羅斯
WLB	個子
WLC	人困馬乏
WLD	個
WLE	侽
WLF	侵略者
WLG	佃
WLH	伡
WLK	佪
WLL	儡
WLM	個體
WLN	偲
WLO	全國勞動模範
WLP	僆
WLQ	㑩
WLR	貧困戶
WLT	僌
WLV	僂
WLW	個人
WLX	儸
WLY	傳輸方式
WMA	儂
WMB	№
WMD	佒
WME	傦
WMF	倜
WMG	侗
WMH	仙
WMI	仙游
WMJ	仚
WMK	「
WML	〇
WMM	個體農戶
WMN	仙居
WMO	個體勞動者
WMP	他山之石
WMQ	伣
WMR	合同制
WMS	◇
WMT	催生
WMU	催辦
WMV	仙女
WMW	催
WMX	集體經濟
WMY	○
WNA	人民警察
WNB	倔
WNC	似能
WND	倨
WNE	追加
WNF	追赶
WNG	伺
WNH	假
WNI	人民法院
WNJ	假冒
WNK	僻
WNL	追回
WNM	假山
WNN	㐶
WNO	阜康
WNP	追究
WNQ	人民解放
WNR	人民的
WNS	追查
WNT	侯
WNU	偋
WNV	亾
WNW	僇
WNX	伲
WNY	似
WOA	儣
WOB	儍
WOD	健康有序
WOF	創業者
WOG	僕
WOH	俯瞰
WOI	㶡
WOJ	供應量
WOK	企業員工
WOL	企業界
WOM	伙同
WON	儦
WOO	倓
WOP	企業家
WOQ	僯
WOR	健康的
WOS	什麼樣
WOT	侂
WOU	俯首
WOV	傭
WOW	伙伴
WOX	企業經營承包製
WOY	伙
WPA	僿
WPB	信守承諾
WPD	代之而起
WPE	人定胜天
WPF	俒
WPG	傢
WPH	倌
WPI	保守党
WPK	偵察員
WPL	保守思想
WPM	八寶山
WPN	儜
WPO	公安廳
WPP	全家福
WPQ	倇
WPR	保密制度
WPS	佇
WPT	侘
WPU	公安部
WPV	侒
WPW	倥
WPX	佗
WPY	保定市
WQA	低
WQB	仰
WQC	低能
WQD	儋
WQF	釡
WQG	尩
WQH	低頻
WQI	您
WQJ	侚
WQK	像
WQM	偩
WQN	佨
WQO	低廉
WQP	低空
WQQ	侈
WQR	伆
WQS	，
WQT	俇
WQU	伨
WQV	
WQW	低价
WQX	僧多粥少
WQY	㐴
WRA	人所共知
WRB	爺
WRC	爸
WRD	俙
WRE	優質服務
WRF	釜
WRG	伯
WRH	伒
WRI	侏
WRJ	信誓旦旦
WRK	父兄
WRL	儛
WRM	釜山
WRN	飏
WRO	飚
WRQ	爹
WRR	斧
WRS	便攜機
WRT	俾
WRU	父
WRV	父女
WRW	佚
WRX	父母
WRY	儌
WSA	佳木斯
WSB	命根子
WSD	僊
WSE	体力
WSF	僄
WSG	価
WSH	仃
WSI	凩
WSJ	剁
WSK	何
WSL	人机界面
WSM	價
WSN	恷
WSO	僳
WSP	分析家
WSQ	僲
WSR	体制
WSS	僸
WST	体系
WSU	朵
WSV	偠
WSW	鵂
WSX	分配比例
WSY	休
WTA	仛
WTB	作出
WTC	仫
WTD	僑
WTE	侜
WTF	任
WTG	件
WTH	作
WTI	作法
WTJ	俐
WTK	佫
WTL	傻
WTM	作曲
WTN	仡
WTO	偢
WTP	作家
WTQ	任免
WTR	俄
WTS	令行禁止
WTT	￥
WTU	佟
WTV	倭
WTW	傱
WTX	侮
WTY	八
WUA	併
WUB	位子
WUC	倦怠
WUD	倦
WUE	偂
WUF	倍增
WUG	位
WUH	公開處理
WUI	領導小組
WUJ	億
WUK	倍
WUL	僧
WUM	伴同
WUN	位居
WUO	創新精神
WUP	公開賽
WUQ	佽
WUR	健美操
WUS	偤
WUT	偐
WUU	仒
WUV	倿
WUW	僧人
WUX	俤
WUY	分辨率
WVA	弅
WVB	邠
WVC	伮
WVD	頒
WVE	佷
WVF	坌
WVG	健
WVH	儘
WVI	分流
WVJ	蚠
WVK	佋
WVL	盆
WVM	貧
WVN	仇
WVO	炃
WVP	侵
WVQ	分解
WVR	分
WVS	分析
WVT	伊
WVU	分部
WVV	伊始
WVW	鳻
WVX	分母
WVY	仞
WWA	人工
WWB	谷子
WWC	伀
WWD	人大
WWE	俎
WWF	坐
WWG	倫
WWH	睂
WWI	伱
WWJ	份量
WWK	卻
WWL	人數
WWM	佡
WWN	仉
WWO	坐庄
WWP	人家
WWQ	人名
WWR	合作制
WWS	价格
WWT	偑
WWU	仌
WWV	份
WWW	傘
WWX	人人皆知
WWY	仈
WXA	化工
WXB	化隆
WXC	化驗
WXD	傾
WXE	化肥
WXF	佛教
WXG	僶
WXH	伄
WXI	佛法
WXJ	發明
WXK	貨品
WXL	貨車
WXM	貨
WXN	化
WXO	發燒
WXP	父母官
WXQ	化解
WXR	發排
WXS	發票
WXT	儗
WXU	發送
WXV	發怒
WXW	發
WXX	偕
WXY	㑄
WYA	餞
WYB	餌
WYC	令
WYD	顀
WYE	依
WYF	儲
WYG	信
WYH	雋
WYI	凡
WYJ	蝕
WYK	停
WYL	餵
WYM	餇
WYN	今
WYO	焦
WYP	進
WYQ	飲
WYR	飯
WYS	集
WYT	倣
WYU	傍
WYV	食
WYW	雙
WYX	饑
WYY	伩
XAA	綫
XAB	縙
XAD	絨
XAE	繖
XAF	紺
XAG	紅
XAH	纜
XAI	紅光
XAJ	縸
XAK	緙
XAL	緢
XAM	彉
XAN	紲
XAO	紅火
XAP	紅軍
XAQ	繱
XAR	張萬年
XAS	紅梅
XAT	纄
XAU	疑難問題
XAV	紅娘
XAW	總工會
XAX	纜繩
XAY	紅旗
XBB	䌰
XBC	緅
XBF	♂
XBG	弭
XBH	鄳
XBI	繼承法
XBK	級別
XBM	絀
XBN	弛
XBS	繼承權
XBT	繼承和發揚
XBU	級差
XBW	繼承人
XBX	維也納
XBY	級
XCA	強項
XCC	綴
XCD	強大
XCE	強力
XCF	経
XCG	強烈
XCI	強盜
XCJ	強
XCK	紿
XCL	強國
XCM	經驗豐富
XCN	弝
XCO	強度
XCP	經驗之談
XCR	弘揚
XCS	強權
XCT	強行
XCU	強辯
XCV	強奸
XCW	強化
XCX	強弱
XCY	弘
XDA	綁匪
XDB	經歷了
XDC	紱
XDD	絕不辜負
XDE	張
XDF	绔
XDG	緘
XDH	紑
XDI	強硬派
XDJ	弼
XDK	張口
XDL	張羅
XDM	緬
XDN	紌
XDP	經研究決定
XDQ	絕大多數
XDR	縓
XDS	綺
XDT	綁
XDU	繚
XDV	絕不姑息
XDW	綊
XDX	總成績
XDY	紎
XEA	幼苗
XEB	孧
XEC	總服務臺
XED	組成
XEE	縚
XEF	幼兒教育
XEG	組
XEH	緩步
XEI	幼小
XEJ	幼虫
XEK	組員
XEL	幼兒園
XEN	組裝
XEP	綬
XEQ	幼儿
XER	幼年
XES	綵
XET	幼
XEU	幼童
XEV	綏
XEW	鴢
XEX	縘
XEY	強加於人
XFA	結匯
XFB	引起了
XFC	紜
XFD	毌
XFE	引起爭議
XFF	繞
XFG	疆
XFH	縝
XFI	頴
XFJ	結果
XFK	結
XFL	續
XFM	貫
XFN	綕
XFO	繊
XFP	綍
XFR	比去年同期
XFS	結構
XFT	緒
XFU	盭
XFV	結婚
XFW	綾
XFX	總教練
XFY	紂
XGA	練功
XGB	純
XGC	緻
XGD	彑
XGE	縛
XGF	弖
XGG	經理
XGH	絚
XGI	剝
XGJ	縳
XGK	綀
XGL	練
XGM	績
XGN	練習
XGO	彝
XGP	彙
XGQ	經貿
XGR	統一的
XGS	統一標準
XGT	彘
XGU	統一部署
XGV	經
XGW	彌
XGX	縤
XGY	彝族
XHA	纑
XHB	引出
XHC	紴
XHD	緋
XHE	引用
XHF	引起
XHG	䊼
XHH	引
XHI	緲
XHJ	綽
XHK	弔
XHL	盄
XHM	緽
XHN	黽
XHO	引爆
XHQ	絸
XHR	比上年
XHS	引述
XHT	引入
XHU	引導
XHV	引退
XHW	引人
XHX	紪
XHY	引言
XIA	經濟工作
XIB	經濟聯繫
XID	潁
XIE	綃
XIF	經濟增長
XIG	絖
XIH	引水上山
XII	經濟活動
XIJ	經濟日報
XIK	經濟中心
XIL	弾
XIM	绱
XIN	經濟改革
XIO	結黨營私
XIP	經濟實力
XIQ	經濟貿易
XIR	經濟損失
XIS	經濟林
XIT	紗
XIU	糸
XIV	經濟建設
XIW	經濟發展
XIX	經濟結構
XIY	經濟效益
XJA	彃
XJB	繓
XJD	旨在
XJE	費力
XJF	旨
XJG	緹
XJH	紳
XJI	縨
XJJ	刜
XJK	弗
XJL	縵
XJM	費
XJN	費心
XJP	費神
XJQ	艴
XJS	綶
XJT	㪄
XJU	旨意
XJV	費盡
XJW	鴲
XJX	緄
XKA	彈藥
XKB	緝
XKD	彈奏
XKE	絹
XKG	緝毒
XKH	紃
XKJ	犟
XKK	彈
XKM	縜
XKN	彈性
XKQ	緝獲
XKR	緝捕
XKT	彈簧
XKU	統戰部
XKW	緝拿
XKX	總路線
XKY	引吭高歌
XLA	細菌
XLB	編輯出版
XLD	絪
XLE	緭
XLF	繹
XLG	細
XLH	細目
XLI	細小
XLJ	比較顯著
XLK	絗
XLL	纝
XLM	細則
XLN	緦
XLO	細糧
XLP	縺
XLQ	比較多的
XLR	㢴
XLS	綑
XLT	細節
XLU	編輯部
XLV	縷
XLW	縕
XLX	縲
XMA	繷
XMB	紅帽子
XMD	紻
XME	繃
XMF	綢
XMG	紬
XMH	㢫
XMI	總體水平
XMK	絅
XML	網點
XMM	纓
XMN	緺
XMO	納米
XMQ	㢷
XMR	䋄
XMS	綱要
XMT	納入
XMU	綱
XMW	納
XMX	網絡
XMY	總體方案
XNA	紐帶
XNB	母子
XND	䋧
XNE	母愛
XNF	幻境
XNG	弓
XNH	糾
XNI	幻滅
XNJ	幻影
XNK	緯
XNM	母體
XNN	幻
XNO	幻燈
XNP	紀實
XNQ	紀錄
XNR	䌌
XNS	幻想
XNT	弓箭
XNU	母親
XNV	母女
XNW	繆
XNX	紐約
XNY	母畜
XOA	纊
XOB	經營承包
XOC	絋
XOD	熲
XOF	經營者
XOG	絕對平均主義
XOI	經營活動
XOJ	纏
XOK	經營單位
XOL	毋庸置疑
XON	継
XOO	緂
XOP	經營之道
XOQ	繗
XOR	絕對的
XOS	經營機製
XOT	經營管理
XOV	䌅
XOW	絕對優勢
XOX	粥
XOY	䋛
XPA	綜觀
XPB	彌補了
XPD	綋
XPF	綜
XPG	綻
XPH	綰
XPI	縮小
XPJ	縮影
XPK	張家口
XPL	緷
XPN	繩之以法
XPP	縮寫
XPQ	紞
XPS	紵
XPT	縮短
XPU	縡
XPW	縮
XPX	紽
XPY	縮放
XQA	紙
XQB	縐
XQC	絶
XQD	繎
XQE	繲
XQF	幼儿教育
XQG	䋮
XQH	約見
XQI	絩
XQJ	絢
XQK	纔
XQN	紙漿
XQO	絢爛
XQP	弦外之音
XQQ	紙錢
XQR	綯
XQS	綠色植物
XQT	引狼入室
XQU	經貿關係
XQV	繺
XQW	弞
XQX	紙張
XQY	約
XRA	綿薄
XRB	緵
XRC	弧
XRD	絺
XRF	線索
XRG	絈
XRH	紤
XRI	線
XRK	線路
XRL	經年纍月
XRM	綿
XRN	線性
XRO	弧度
XRP	緩兵之計
XRQ	繳獲
XRR	總指揮
XRS	幾年來
XRT	綼
XRU	總投資
XRV	強手如林
XRW	紩
XRX	纅
XRY	繳
XSA	紅樓夢
XSC	縱橫馳騁
XSD	㯋
XSF	縹
XSG	絤
XSH	糽
XSK	彁
XSM	幻想曲
XSN	結構性
XSO	統配煤礦總公司
XSQ	紙醉金迷
XSR	繳械投降
XSS	綝
XSU	維權意識
XSV	䌁
XSW	張榜公布
XSX	縹緲
XSY	䊾
XTA	絳
XTB	絁
XTC	總參
XTD	疑
XTE	弱智兒童
XTF	纘
XTG	絎
XTH	綹
XTI	幾乎沒有
XTJ	緮
XTK	絡
XTL	總
XTM	總體
XTN	匕
XTO	繙
XTP	疑案
XTQ	弱智儿童
XTR	鄕
XTS	幼稚可笑
XTT	終身
XTU	終
XTV	緌
XTW	縱
XTX	總統
XTY	鄉
XUA	絣
XUB	縌
XUD	綣
XUE	彅
XUF	紏
XUG	絆
XUI	弱小
XUJ	織
XUK	綐
XUL	繒
XUM	㢼
XUP	弱視
XUQ	絘
XUS	緧
XUT	弱智
XUU	彈道導彈
XUV	縑
XUW	縊
XUX	弱
XUY	終端設備
XVA	繡花
XVC	絕
XVD	絕不
XVE	縁
XVF	繡
XVG	䋖
XVH	絕非
XVI	緑
XVJ	繅
XVK	紹
XVL	緇
XVN	䊵
XVO	繍
XVP	綅
XVR	絕招
XVS	絕頂
XVT	糿
XVU	絕症
XVV	絕妙
XVW	絕食
XVX	絕緣
XVY	紉
XWB	給出
XWC	総
XWD	緞
XWE	紾
XWF	弣
XWG	給
XWH	縧
XWI	引人注目
XWJ	紒
XWK	緥
XWL	繪圖
XWM	綜合體
XWN	緱
XWO	纀
XWP	給定
XWQ	引進外資
XWR	維持
XWS	維西
XWT	絍
XWU	綜合開發
XWV	紛
XWW	纖
XWX	紛紛
XWY	維
XXA	畿
XXB	繼承
XXC	繈
XXD	幾
XXE	網絡服務器
XXF	坒
XXG	斷
XXH	紖
XXI	絲
XXJ	紼
XXK	繦
XXL	比較
XXM	緣由
XXN	比
XXO	粊
XXP	比賽
XXQ	綠色
XXR	皆
XXS	枈
XXT	毞
XXU	幾次
XXV	比如
XXW	比例
XXX	繼
XXY	比率
XYA	維護世界和平
XYB	編隊
XYC	統
XYD	＜
XYE	袰
XYF	編者
XYG	紸
XYH	編劇
XYI	統治
XYJ	緕
XYK	縞
XYL	繵
XYM	統購
XYN	編
XYP	編寫
XYQ	編印
XYR	縭
XYS	統配
XYT	紡
XYU	締
XYW	絞
XYX	縴
XYY	紋
YAA	試
YAB	講了
YAC	試驗
YAD	諾
YAE	誘惑力
YAF	謀
YAG	訌
YAH	訝
YAI	講演
YAJ	謨
YAK	謹
YAL	試點
YAM	講
YAN	諜
YAO	講座
YAP	講究
YAQ	譖
YAR	試製
YAS	講述
YAT	試行
YAU	護送
YAV	謀劃
YAW	護
YAY	謊
YBB	讘
YBC	諏
YBD	望子成龍
YBE	讔
YBF	斈
YBG	誀
YBH	邡
YBI	誰也沒有想到
YBK	㓙
YBM	詘
YBN	訑
YBO	旁聽席
YBR	交際舞
YBT	䚮
YBW	為了什麼
YBY	訯
YCA	育苗
YCB	充盈
YCC	諁
YCD	交通大隊
YCE	育
YCF	育才
YCG	棄
YCH	育齡
YCI	旀
YCK	詒
YCL	夣
YCM	交通崗
YCN	譎
YCO	褭
YCP	交通安全
YCQ	充
YCR	充斥
YCS	交通要道
YCT	誒
YCU	交通部
YCW	誜
YCX	交通線
YCY	訍
YDA	衣不蔽体
YDB	ā
YDC	詙
YDD	享有盛名
YDE	顏
YDF	誇
YDG	詁
YDH	譿
YDI	誄
YDJ	產量
YDK	放大器
YDM	言不由衷
YDN	誠
YDO	詼
YDP	誠實
YDQ	毫不留情
YDR	謜
YDS	旑
YDT	產
YDU	放在首位
YDV	產婦
YDW	亦不例外
YDX	誇張
YDY	就在於
YEA	譭
YEB	商學院
YED	交朋友
YEE	彣
YEF	高興地
YEG	詛
YEH	謏
YEI	衣裳
YEJ	施用量
YEK	詛咒
YEL	文學界
YEM	裔
YEN	講學習講政治講正氣
YEP	衣冠
YEQ	誽
YER	謡
YET	䚲
YEU	衣
YEW	諛
YEX	謑
YEY	適用於
YFA	六十七
YFB	就地取材
YFC	詓
YFD	譳
YFE	認真學習
YFF	詩
YFG	六十五
YFH	計
YFI	市場準入
YFJ	謿
YFK	詰
YFL	讀
YFM	諵
YFN	誌
YFO	市場營銷
YFP	誖
YFQ	諸多
YFR	六十年代
YFS	市場機製
YFT	諸
YFU	市場競爭
YFV	六十九
YFW	褻
YFX	市場經濟
YFY	対
YGA	訮
YGB	訰
YGC	誈
YGD	主
YGE	請
YGF	訏
YGG	高于一切
YGH	証
YGI	主流
YGJ	㪯
YGK	語
YGL	諫
YGM	謮
YGN	瓬
YGO	主席
YGP	迬
YGQ	謸
YGR	主持
YGS	主要
YGT	主管
YGU	評
YGV	誙
YGW	殶
YGX	主張
YGY	肇事方
YHA	謔
YHC	詖
YHD	誹
YHF	高瞻遠矚
YHG	訨
YHI	變戲法
YHK	詀
YHL	京劇團
YHM	盲目崇拜
YHN	盲目性
YHP	高頻字
YHQ	斍
YHR	這些年
YHT	顧慮重重
YHU	卞
YHV	盲目建設
YHW	望眼欲穿
YHX	訿
YHY	訃
YIA	主治醫生
YID	就沒有
YIE	誚
YIF	旅游者
YIG	高水平
YII	氷
YIJ	誻
YIK	交流中心
YIL	交流思想
YIN	旅游局
YIP	讜
YIR	高尚的
YIS	講清楚
YIT	訬
YIU	請注意
YIW	交流信息
YIX	交流經驗
YIY	䚱
YJA	計時工資
YJB	說明了
YJC	識時務者為俊傑
YJD	文明古國
YJE	斔
YJF	斉
YJG	詚
YJH	䚯
YJI	亰
YJJ	亣
YJK	交易中心
YJL	謾
YJM	為時過早
YJN	恴
YJP	交易額
YJQ	謁
YJR	交易所
YJS	課
YJT	謃
YJU	蚉
YJV	說明書
YJW	交易會
YJX	文明經商
YJY	交易市場
YKA	高工
YKB	郭
YKC	裛
YKD	享有
YKE	哀
YKF	吝
YKG	誤
YKH	訓
YKI	京
YKJ	亯
YKK	襄
YKL	畗
YKM	高
YKN	市中心
YKO	高度
YKP	亮
YKQ	詋
YKR	高手
YKS	就要
YKT	熟悉
YKU	衰竭
YKV	衰退
YKW	商品化
YKX	衰弱
YKY	高效
YLA	譯著
YLB	遊擊隊
YLC	畆
YLD	譯碼
YLE	謂
YLF	譯
YLG	訵
YLH	䛅
YLI	褱
YLJ	稟明
YLK	顫
YLL	讄
YLN	諰
YLO	譯叢
YLP	謰
YLQ	畝
YLR	顫抖
YLS	譯本
YLT	顫動
YLU	譯音
YLV	謱
YLW	謖
YLY	畝產
YMA	譨
YMB	高帽子
YMC	變則通
YMD	詇
YME	調用
YMF	調
YMG	䛆
YMH	訕
YMI	文體活動
YMK	詗
YML	調回
YMM	市內
YMN	諣
YMO	市府
YMP	市容
YMQ	調解
YMR	市制
YMS	調查
YMT	市委
YMU	誷
YMW	訥
YMX	調給
YMY	市郊
YNA	啔
YNB	㐎
YNC	高性能
YND	戾
YNE	望
YNF	訊
YNG	詡
YNH	盲
YNI	永
YNJ	朚
YNK	啟
YNL	妄圖
YNM	遍
YNN	記
YNO	扊
YNP	永安
YNQ	扅
YNR	謵
YNS	杗
YNT	刻
YNU	忞
YNV	亡
YNW	顧
YNX	詞組
YNY	房
YOA	弈
YOB	商業職工
YOC	主席台
YOD	奕
YOE	談妥
YOF	談起
YOG	譵
YOH	這麼些
YOI	高精尖
YOK	談吐
YOL	產業界
YOM	帟
YON	高度民主
YOO	談
YOP	謎
YOQ	高度負責
YOS	亦可
YOT	変
YOU	亦
YOV	亦即
YOW	鵉
YOX	產業結構
YOY	詸
YPA	主客觀
YPB	离家出走
YPD	這
YPE	誼
YPF	誴
YPG	諚
YPH	這些
YPJ	谉
YPL	諢
YPO	放空炮
YPP	旅客之家
YPQ	訦
YPR	熟視無睹
YPS	詝
YPT	詫
YPU	這次
YPV	議定書
YPW	這個
YPX	詑
YPY	適宜於
YQA	詆
YQB	謅
YQD	詭
YQE	諂
YQF	肩負起
YQG	裦
YQI	誂
YQJ	詢
YQK	讒
YQL	顧名思義
YQM	讂
YQN	袌
YQO	諊
YQP	言外之意
YQQ	袲
YQR	謠
YQS	記錄本
YQT	誑
YQU	詢問
YQV	諍
YQW	許多人
YQX	郭兆強
YQY	訋
YRA	离散
YRB	離
YRC	䛀
YRD	誵
YRF	离境
YRG	詬
YRH	訢
YRI	誅
YRJ	高質量
YRK	離別
YRL	譕
YRM	旆
YRN	旊
YRO	主持座談會
YRP	离家
YRQ	褢
YRR	訤
YRS	高手林立
YRT	諀
YRU	離開
YRV	离婚
YRW	袠
YRX	离弦
YRY	訴
YSA	主要功能
YSB	論述了
YSC	主要矛盾
YSD	主要原因
YSE	主要力量
YSF	諲
YSG	主要表現
YSH	訂
YSI	高標準
YSJ	譚
YSK	訶
YSL	主要因素
YSM	主要內容
YSN	主要性能
YSO	主要精力
YSP	訂定
YSQ	主要負責人
YSR	主要指的是
YSS	諃
YST	主要特征
YSU	訂閱
YSV	主要媒体
YSW	誺
YSX	調查結果
YSY	訹
YTA	託
YTB	施
YTC	詐騙
YTD	話
YTE	旅
YTF	許
YTG	諥
YTH	誕
YTI	旓
YTJ	誗
YTK	詻
YTL	謥
YTM	謝
YTN	旋
YTO	旙
YTP	旅客
YTQ	旐
YTR	旂
YTS	旚
YTT	族
YTU	旞
YTV	諉
YTW	斻
YTX	誨
YTY	放
YUA	誁
YUB	旁及
YUC	商務
YUD	議長
YUE	譾
YUF	商城
YUG	詳
YUH	劑
YUI	商洛
YUJ	識
YUK	説
YUL	譄
YUM	商
YUN	商情
YUO	譜
YUP	帝
YUQ	諮
YUR	商丘
YUS	譐
YUT	諺
YUU	敵意
YUV	謙
YUW	謚
YUX	詳細
YUY	肩并肩
YVA	良苦
YVB	認出
YVC	朗
YVD	良友
YVE	良
YVF	認真
YVG	旔
YVH	諸如此類
YVI	郎溪
YVJ	䜈
YVK	詔
YVL	良田
YVM	認同
YVN	訅
YVP	誛
YVQ	良久
YVR	良好的
YVS	良机
YVT	良种
YVV	良好
YVW	离退休
YVX	計劃經濟
YVY	認
YWA	交警
YWB	亢
YWC	設
YWD	頏
YWE	診
YWF	詂
YWG	論
YWH	充分肯定
YWI	交流
YWJ	亱
YWK	說
YWL	交界
YWM	說過
YWN	詤
YWO	交火
YWP	迒
YWQ	郊外
YWR	交
YWS	夜校
YWT	夜
YWU	六
YWV	訜
YWW	卒
YWX	訛
YWY	㫃
YXA	變革
YXB	高級職稱
YXC	變通
YXD	變成
YXE	詏
YXF	謴
YXG	譝
YXH	訠
YXI	率
YXJ	詣
YXK	彎路
YXL	畜
YXM	彎曲
YXN	䚰
YXO	高強度
YXP	牽
YXQ	變色
YXR	率兵
YXS	變遷
YXT	雍
YXU	玄
YXV	變好
YXW	變化
YXX	變
YXY	玆
YYA	方式
YYB	方子
YYC	旈
YYD	方面
YYE	文采
YYF	堃
YYG	文
YYH	文具
YYI	方法
YYJ	文明
YYK	讓
YYL	丶
YYM	文山
YYN	讠
YYO	旅遊業
YYP	方案
YYQ	方針
YYR	謧
YYS	文本
YYT	訪
YYU	謗
YYV	斏
YYW	誶
YYX	詃
YYY	言
