GGL	一
SGH	丁
GNV	丂
AGN	七
DGT	丆
DGG	三
HGD	上
GHI	下
GJK	丌
DHI	不
GHN	丐
EGD	且
ANV	世
GKG	丗
RGD	丘
GMW	丙
BIG	丞
GCU	丟
UXG	丠
GJA	丣
HHL	丨
NHK	丩
UHK	丫
KHK	中
NJH	丱
KKH	串
KKJ	丳
YYL	丶
UYT	丷
MYD	丹
YGD	主
FJY	丼
RTY	乂
NYI	乄
QYI	久
NWI	乆
TAV	乇
TCU	么
TUR	乊
PPP	之
TPU	乏
RGT	乒
RGY	乓
RFM	乕
TFU	乖
TUX	乘
NNL	乙
NNV	乜
VTN	九
TNB	乞
TUN	乥
HKN	乩
NLD	乪
EKN	乫
DNB	乭
EBN	乳
RRN	乴
BXI	乸
IYG	乼
EXI	乿
QJJ	亀
ECM	亂
QHJ	亇
GUV	亊
GKV	事
FGG	二
GSJ	亍
GFK	于
FNV	亐
GXG	互
FJJ	亓
GGH	五
FJK	井
HXF	些
GKJ	亜
GFG	亞
BKC	亟
YNV	亡
YWB	亢
YJJ	亣
YWR	交
YOU	亦
YKI	京
YKP	亮
YKJ	亯
YJI	亰
YWJ	亱
WNV	亾
WFH	什
WFG	仁
WSH	仃
WVN	仇
WWY	仈
WWN	仉
WYN	今
WJJ	介
WWU	仌
WBT	仍
WCY	仏
WFJ	仐
WUU	仒
WBG	仔
WBN	他
WFY	付
WMH	仙
WMJ	仚
WTA	仛
WAG	仜
WAF	仝
WVY	仞
WTN	仡
WYC	令
WIY	仦
HGW	仧
WTC	仫
WIT	仯
WQB	仰
WEG	仴
WTG	件
WTF	任
WWV	份
WGX	仾
WWC	伀
WHF	企
WXH	伄
WGB	伅
WQR	伆
WVT	伊
WBY	伋
WDB	伌
WGG	伍
WFC	伎
WDY	伏
WAY	伐
WSY	休
WRH	伒
WFW	伕
WDC	伖
WOY	伙
WLH	伡
WAH	伢
WMQ	伣
WQU	伨
WYY	伩
WVC	伮
WRG	伯
WDG	估
WWI	伱
WNX	伲
WAN	伳
WJH	伸
WNG	伺
WGU	伻
WNY	似
WEK	伽
WKW	伿
WCK	佁
WGH	佂
WLG	佃
WJG	但
WPS	佇
WDM	佈
WHC	佊
WVK	佋
WHX	佌
WUG	位
WQA	低
WDA	佐
WMD	佒
WHK	佔
WSK	何
WPX	佗
WRW	佚
WTH	作
WFV	佞
WTU	佟
WWM	佡
WHG	佧
WQN	佨
WLK	佪
WTK	佫
WFT	佬
WFF	佳
WUA	併
WVE	佷
WUQ	佽
WGK	使
WGA	侀
WOT	侂
WQQ	侈
WDF	侉
WIG	侊
WGQ	例
WRI	侏
WPV	侒
WMG	侗
WPT	侘
WAA	侙
WQJ	侚
WAW	供
WTE	侜
WYE	依
WSG	価
WTX	侮
WNT	侯
WVP	侵
WKT	侶
WFP	侼
WLE	侽
WGJ	便
WEV	俀
WKN	俁
WKH	促
WTR	俄
WGI	俅
WQT	俇
WCW	俊
WKC	俋
WWE	俎
WIE	俏
WTJ	俐
WCE	俑
WPF	俒
WGV	俓
WHQ	俔
WEB	俘
WRD	俙
WJF	俚
WKS	保
WCT	俟
WYG	信
WUX	俤
WHW	俱
WEC	俷
WDJ	俺
WRT	俾
WHA	俿
WPQ	倇
WLD	個
WPH	倌
WUK	倍
WGC	倒
WOO	倓
WNB	倔
WFU	倖
WEE	倗
WIM	倘
WHN	候
WDS	倚
WMF	倜
WAJ	借
WYT	倣
WPW	倥
WUD	倦
WND	倨
WEQ	倪
WWG	倫
WHJ	倬
WTV	倭
WJS	倮
WJX	倱
WES	倸
WBB	倻
WUV	倿
WAM	偀
WEM	偁
WUE	偂
WNH	假
WJQ	偈
WNU	偋
WAD	偌
WUT	偐
WWT	偑
WXX	偕
WDT	做
WYK	停
WSV	偠
WTO	偢
WUS	偤
WVG	健
WDQ	偧
WQM	偩
WKB	偮
WLN	偲
WHM	偵
WJM	偶
WHV	偼
WEH	傁
WGE	傅
WDR	傆
WAB	傇
WKM	傊
WCO	傌
WYU	傍
WEX	傒
WWW	傘
WAT	備
WJN	傝
WPG	傢
WFL	傤
WME	傦
WCC	傪
WMW	催
WOV	傭
WTW	傱
WGM	債
WTL	傻
WXD	傾
WLV	僂
WSF	僄
WAK	僅
WLP	僆
WNW	僇
WJL	僈
WSD	僊
WLT	僌
WQK	像
WTD	僑
WOG	僕
WDU	僚
WET	僞
WEP	僢
WUL	僧
WFA	僨
WOQ	僯
WSQ	僲
WSO	僳
WGL	僵
WXG	僶
WSS	僸
WSM	價
WNK	僻
WPA	僿
WMA	儂
WUJ	億
WAQ	儆
WQD	儋
WRY	儌
WOB	儍
WFD	儒
WFN	儔
WXT	儗
WVH	儘
WAL	儚
WRL	儛
WPN	儜
WGW	儞
WIP	償
WLL	儡
WOA	儣
WJA	儤
WON	儦
WDE	優
WAE	儰
WYF	儲
WLX	儸
WKK	儼
GQV	兀
CQB	允
FQB	元
KQB	兄
YCQ	充
QII	兆
RBQ	兇
TFQ	先
WCQ	兊
WKQ	兌
QKQ	免
TKQ	兎
HJQ	児
EQB	兒
FQC	兘
DQF	兙
DQT	兛
DQD	兢
TYI	入
WGF	全
GMH	兩
WTY	八
WCU	公
YWU	六
WGN	兮
UBJ	兯
AWU	共
GWU	兲
RGW	兵
HWU	具
MAW	典
ULA	兾
URV	兿
UXL	冀
MHN	冂
DMB	冇
MFD	冉
MAK	冊
MKD	冋
GMF	再
MWK	冏
JEF	冐
JHF	冒
PYN	冖
PQV	冘
PMJ	冚
POU	冞
PRX	冟
PFE	冡
PBC	冣
PQK	冤
PJY	冥
PSS	冧
UYG	冫
DUU	冭
UIY	冰
UAH	冴
UCK	冶
UWY	冷
UTF	冼
UGQ	冽
UVG	冿
UQK	凂
USW	凇
UEV	凈
UMF	凋
UQG	凎
UMG	凒
UPJ	凕
UMW	凗
ULF	凙
UYL	凜
UXT	凝
UTA	凞
UFL	凟
WYI	凡
TWV	凢
NWV	凥
WSI	凩
WHD	凪
FBK	凷
HNM	凹
IBK	凼
BIB	函
VNT	刀
NGD	刁
JHH	刂
VYI	刃
VWI	刅
WVR	分
AVT	切
RJH	刈
TNJ	刉
FJH	刊
TDJ	刋
QRJ	刎
MYJ	刐
FQJ	刓
NWJ	刔
EJH	刖
GQJ	列
XJJ	刜
PUV	初
EGJ	刞
VKJ	刟
CKJ	刣
KQJ	別
FCJ	刦
FCV	刧
TJH	利
MAJ	刪
GJG	刯
FJV	刱
FFJ	刲
DFN	刳
BSJ	刴
BJH	刵
NMH	刷
UDV	券
GMI	刺
YNT	刻
GUD	刾
WSJ	剁
MJH	則
KEJ	剈
IEJ	削
DQJ	剋
UEJ	前
RSY	剎
UAV	剏
UKJ	剖
AAJ	剗
MUM	剛
XGI	剝
OOJ	剡
GEY	剢
GKL	副
PDH	割
UTT	剷
HAG	劇
YUH	劑
QKX	劖
ENT	力
ENN	劜
AET	功
EKG	加
RET	劤
EGE	助
VCE	努
FCE	劫
RWE	劮
DET	劯
FFE	劸
DQE	勀
GVA	勁
FPB	勃
UDB	勌
UKE	勏
BLE	勐
CNH	務
KME	勛
OOP	勞
GME	勣
AKG	勤
TGL	勳
DAJ	勵
QTN	勹
QFD	勻
QVV	勼
QWI	勽
QCI	勾
QRE	勿
QRI	匁
QXV	匂
QNV	包
QRY	匆
QQI	匇
QRB	匈
QGU	匉
QOI	匊
QDJ	匎
QGK	匐
QVC	匓
XTN	匕
WXN	化
UXN	北
ABV	匜
AMH	匝
ARK	匠
ALK	匣
AGY	匤
ACA	匥
AIW	匯
AKH	匱
AAW	匶
AQV	匹
AAD	匿
FGH	十
NFK	卂
GKK	卅
VFJ	卆
TFJ	午
FAJ	卉
UGK	半
FAF	卋
GLK	卌
NHG	卍
YWW	卒
HJF	卓
FEE	協
FMU	南
ILJ	単
FGE	博
YHU	卞
KHY	卟
HGH	卡
HMN	卣
HLR	卥
BNH	卩
QBH	卬
QDB	危
VCB	即
QQB	卶
RHB	卸
WWK	卻
SWI	厀
QDR	厃
DTA	厇
DFK	厈
DDX	厐
DKX	厑
DRM	厒
DGC	厔
DDN	厖
DLK	厙
DJB	厚
DKR	厛
DTF	厜
DRI	原
DUB	厥
DGQ	厫
DJT	厬
DIM	厰
IDN	厳
CNY	厶
CCY	厸
VCU	厹
FCU	去
CIU	厼
GMC	叀
CCC	參
BYI	及
DCU	友
RCI	反
NHC	収
TDC	叐
HGI	叔
BCY	取
EPC	受
UGR	叛
POC	叜
FCB	叝
EHC	叟
DGH	古
QKD	句
KER	另
KVR	叧
KVT	叨
KBH	叩
KNH	叫
VKF	召
KWY	叭
KSH	叮
SKD	可
KXN	叱
KRI	史
DKF	右
AKD	叵
NGK	司
KET	叻
BKF	叾
KAG	叿
TKF	各
KKG	吅
KXY	吆
KBG	吇
FKF	吉
KFY	吋
MGK	同
QKF	名
RGK	后
GKR	吏
KFG	吐
KUH	吖
YKF	吝
GDK	吞
KDY	吠
NKF	吢
KNY	吣
KWJ	吤
DHK	否
KCN	吧
KWV	吩
KWX	吪
KYW	吭
KCQ	吮
KDC	吰
KFC	吱
KXH	吲
KND	吳
KIT	吵
KMT	吶
KNW	吷
KBY	吸
KQW	吹
KQR	吻
KBN	吼
KTG	吽
GKF	吾
KAH	呀
KQU	呁
KDB	呃
BDF	呄
KYY	呅
KSU	呆
IKF	呇
KGF	呈
KFW	呋
KUF	呌
KTY	呚
KYX	呟
KNN	呡
KNX	呢
KXE	呦
KQA	呧
KKQ	呪
KLG	呬
KGU	呯
HXK	呰
KRC	呱
KFI	味
KQK	呴
KSK	呵
KLH	呷
KRW	呹
KJH	呻
KTU	呼
KJG	呾
KEG	咀
KAM	咂
KWB	咃
KBM	咄
UKF	咅
KQN	咆
KXJ	咈
TKG	和
KCK	咍
THK	咎
KRS	咑
KKW	咒
KDG	咕
KEK	咖
KDA	咗
KPX	咜
KGA	咞
KBF	咠
KIG	咣
KGC	咥
KGX	咦
KGQ	咧
KOY	咪
NYK	咫
KTK	咯
KUD	咲
KYN	咳
KDO	咴
KTD	咶
KQI	咷
KPV	咹
KWS	咻
YKE	哀
KKK	品
KSG	哂
KMG	哃
KQQ	哆
KFF	哇
KWG	哈
FKX	哉
KDE	哊
KFB	哋
KRE	哌
KAR	哎
KVE	哏
KXW	哛
KMU	員
KDN	哤
SKS	哥
KTR	哦
KIE	哨
KJF	哩
KNG	哪
RRK	哲
KKE	哵
KEV	哸
KEB	哹
KGE	哺
KGJ	哽
KUK	哾
KTB	唀
KYG	唁
KMY	唄
KCW	唆
KKC	唈
KCT	唉
KPF	唍
KTJ	唎
KRD	唏
OVH	唐
KWW	唑
KRF	唕
DCK	唘
KQT	唙
KVP	唚
FCK	唟
KRA	唣
KII	唦
KVC	唧
KBE	唨
KTV	唩
KDW	唪
KQG	唫
KNM	唰
KJJ	唱
KEQ	唲
KYC	唷
KUV	唼
KSR	唽
KTF	唾
KMF	啁
YUM	商
KBS	啊
KES	啋
UKD	問
KGV	啑
KNB	啒
YNA	啔
KQE	啗
KPQ	啘
YNK	啟
KRH	啣
KRT	啤
KWF	啥
KRU	啦
KRR	啪
KLQ	啰
KRQ	啲
KIH	啵
KYV	啷
KYU	啼
KTO	啾
KPT	喀
KJM	喁
KFM	喃
UGU	善
KJU	喅
KWN	喉
KAN	喋
KKY	喌
KMN	喎
KSV	喓
KSD	喖
KPL	喗
KMD	喘
KXG	喙
KQM	喚
KJQ	喝
KRX	喞
KLE	喟
KOA	喥
KPG	喧
KUT	喭
KDJ	喱
KXQ	喲
KSJ	喳
KAL	喵
KDF	喹
KWT	喺
KQV	喼
KVK	嗈
KEE	嗋
KUW	嗌
KUB	嗍
KCO	嗎
KPD	嗐
KCC	嗓
KFH	嗔
KEH	嗖
KEX	嗘
KFT	嗜
KUX	嗞
KUG	嗟
EBT	嗠
KWC	嗡
KJL	嗢
KMA	嗣
KFP	嗦
EKW	嗧
KIM	嗩
KAW	嗬
KJS	嗮
KLD	嗯
KWL	嗰
KWR	嗲
KCE	嗵
KJA	嗶
KLP	嗹
KMW	嗺
KGK	嗽
KKN	嘂
KOV	嘃
KGM	嘈
KSF	嘌
KLV	嘍
KDH	嘎
DNH	嘏
KLA	嘓
KGH	嘕
KOS	嘛
KSW	嘜
KAK	嘞
KPN	嘧
KVO	嘨
KLM	嘪
KQD	嘫
KJB	嘬
KOO	嘮
KVF	嘯
KXX	嘰
KFJ	嘲
KHX	嘴
KAD	嘶
KRL	嘸
KDU	嘹
KFK	嘻
KLF	嘿
KUS	噂
KUL	噌
KKA	噐
KOQ	噒
ETN	噕
KOG	噗
KVA	噚
KFU	噠
KTM	噢
KSS	噤
KKD	器
KUJ	噫
KTA	噬
KRY	噭
KEP	噯
KFA	噴
KAJ	噶
KGB	噸
KPA	噻
KNK	噼
KLI	嚃
KFD	嚅
KAY	嚆
KFO	嚇
KFN	嚋
KVH	嚍
KIP	嚐
KPW	嚓
KQO	嚕
KHB	嚙
KTQ	嚟
KQY	嚠
KDT	嚦
KUE	嚨
KUQ	嚪
KMM	嚶
KYK	嚷
KRM	嚹
KLU	嚺
KEL	嚼
KBB	囁
KYR	囄
KAF	囈
KLX	囉
GKH	囊
KAQ	囌
KNI	囑
KAU	囒
KTL	囖
MNV	囘
MNG	囙
LWI	囚
LCI	囜
LBD	囝
LDI	因
LVD	囡
LFI	団
LGB	囤
LII	囦
MWM	囧
LFC	囩
TLR	囪
LQR	囫
MJD	囬
LWX	囮
LGD	囯
LUR	図
LWF	囶
LTI	囷
LDD	固
LCK	囼
LDE	囿
LYD	圁
CLU	圅
LUD	圈
LAK	國
LMD	圌
LNK	圍
LCM	圎
LLY	圐
LFK	園
LKM	圓
LCF	圗
LWD	圙
LLG	圜
LYX	圝
FYI	圡
FHY	圤
DFD	圧
DHF	在
FGF	圩
FTN	圪
FTA	圫
FFF	圭
FNN	圯
FBN	地
FKH	圳
FMH	圸
FRH	圻
FQR	圽
FBY	圾
FWJ	圿
FRC	坂
FFQ	坃
FWC	坄
FTY	坆
FQU	均
FPW	坈
FGB	坉
FYT	坊
FWV	坋
WVF	坌
FQW	坎
WWF	坐
FYW	坑
XXF	坒
IFF	坔
FQF	坖
FGX	坘
GVF	坙
FHC	坡
FEG	坥
FJG	坦
FDG	坧
FGU	坪
FHK	坫
FNX	坭
FDH	坯
FMK	坰
FMD	坱
FXJ	坲
FXE	坳
FXY	坶
FSK	坷
FDC	坺
FQA	坻
FRY	坼
FPS	坾
FTU	垀
FTD	垁
TFA	垂
FUG	垃
FDX	垅
FMG	垌
FTK	垎
FVG	垏
FQQ	垑
FYN	垓
FQI	垗
FWD	垘
FWS	垛
FBS	垜
FPT	垞
FVE	垠
FRG	垢
FGJ	垣
FGC	垤
FWG	垥
FUA	垪
FDP	垯
FPV	垵
FEB	垺
FMY	垻
IRF	垽
FOC	垿
FMW	埁
FCT	埃
BYF	埅
FQE	埆
FCW	埈
FDW	埉
MIF	埊
FYV	埌
FDN	城
FTH	埏
RRF	埑
FEF	埒
FKG	埕
FWN	埠
FUD	埢
FRT	埤
FPQ	埦
FQV	埩
FIM	埫
FVI	埭
FOO	埮
FDJ	埯
FES	埰
FJQ	埸
FUK	培
ADW	基
FDS	埼
FVP	埽
BCF	埾
FJS	堁
YYF	堃
FYC	堉
FLD	堌
FQK	堍
FFW	堎
FJX	堒
FVT	堖
FSF	堙
FPL	堚
FGL	堜
FMN	堝
FAN	堞
FXG	堟
FWK	堢
FJM	堣
FXX	堦
FNG	堩
FAD	堪
FRB	堫
FFT	堵
FDA	堶
FWT	堸
FLW	堺
FLG	堽
LIF	塁
FAY	塃
FLY	塄
FYO	塆
FIW	塉
FRQ	塊
FJN	塌
UBT	塑
FPJ	塓
FAW	塔
IWG	塗
FOV	塘
FXH	塡
IKG	塣
FKM	塤
FGK	塥
FUW	塧
FFH	填
FDR	塬
FTM	塮
FME	塴
FON	塶
FHL	塷
LRF	塹
FLV	塿
FNI	墀
FJL	墁
FUJ	境
FAQ	墆
FCC	墋
RXA	墍
FIV	墚
FUL	增
FHA	墟
FWX	墢
FOG	墣
FTO	墦
FUS	墫
BXG	墬
FSJ	墰
FRL	墲
FAG	墷
NKU	壁
FYL	壇
FFL	壊
FIP	壋
FTG	壎
FAH	壏
DJE	壓
FFD	壖
FVH	壗
FOA	壙
FUQ	壛
FUE	壠
FBX	壣
FYK	壤
FDL	壥
FFA	壩
FYX	壪
TFD	壬
FBJ	壭
FPG	壹
FPF	壺
FNA	壽
FLL	夁
TOU	夈
YOT	変
DHT	夏
DHH	夒
QHY	外
QQU	多
VQU	夛
YWT	夜
QQF	夡
ALP	夢
YCL	夣
JSQ	夥
GNY	夨
GDI	天
DYI	太
TDI	夭
MDI	央
DER	夯
DJJ	夰
RWI	失
DFJ	夲
DDY	夶
GXW	夷
DKJ	夼
DCB	夿
DJN	奄
DSK	奇
DFI	奈
FFG	奊
HKD	奌
DFF	奎
DWG	奏
DHV	契
DQQ	奓
DFA	奔
YOD	奕
DDC	套
CDJ	奙
EXD	奚
DFT	奢
GDJ	奣
TMT	奧
UEF	奨
DAK	奩
DWY	奪
DDJ	奭
VVV	女
VCY	奴
VSH	奵
VBT	奶
VBN	她
VVG	奻
VTA	奼
VBG	好
VMH	奾
VYV	奿
NVG	妀
VQY	妁
VKG	如
VNN	妃
VAG	妅
VTF	妊
VGA	妍
VWJ	妎
VYY	妏
VWC	妐
VFC	妓
VKH	妕
VWY	妗
VIT	妙
VDH	妚
VNW	妜
JVF	妟
VMW	妠
VRH	妡
VXX	妣
EVF	妥
VFQ	妧
VYT	妨
VDC	妭
VNX	妮
VMG	妯
VVK	妱
VJG	妲
QBV	妴
VYX	妶
VRW	妷
VSK	妸
VFI	妹
VGS	妺
GVH	妻
VJH	妽
UVF	妾
EKV	妿
VTY	姀
VTP	姂
VUG	姅
VXY	姆
VGM	姉
VCK	始
VMF	姌
VMA	姍
VMD	姎
VEG	姐
VDG	姑
VNY	姒
VTG	姓
TVF	委
HXV	姕
VAN	姖
VUA	姘
VWT	姙
VQI	姚
VRI	姝
VTM	姠
VYW	姣
VRG	姤
VFT	姥
VGX	姨
VGC	姪
VAH	姬
VGJ	姮
VIG	姯
VQJ	姰
VWG	姵
VDE	姷
VGD	姸
VLD	姻
VQQ	姼
VQD	姽
VAD	娀
DGV	威
VAW	娂
VFF	娃
VHQ	娊
VIE	娋
VDN	娍
RRV	娎
VEB	娐
VTX	娒
VDQ	娔
VLE	娚
VNG	娜
VEV	娞
VKE	娟
VDF	娠
VFN	娡
VUX	娣
VTR	娥
VUK	娧
VQK	娩
VFH	娬
VCT	娭
VYG	娮
VWN	娰
VTJ	娳
VBC	娵
BCV	娶
VJJ	娼
VVI	娽
VBS	婀
LVF	婁
VRM	婂
VPF	婃
VQO	婅
VES	婇
VPQ	婉
VGE	婊
VHA	婋
VDS	婍
VTV	婑
VOO	婒
VHD	婔
VGV	婕
VEQ	婗
VUD	婘
VQV	婙
VQA	婚
VFU	婞
VPH	婠
VSW	婡
VRT	婢
VHJ	婥
VVP	婦
SSV	婪
VJX	婫
VET	婬
VGF	婭
VND	婮
VGL	婳
VYK	婷
VSV	婹
VFM	婻
VNH	婿
VJM	媀
VNK	媁
VDM	媆
VPL	媈
VUE	媊
VDW	媋
VAL	媌
VQM	媍
VAF	媒
VHM	媜
TOV	媝
VDA	媠
VIV	媣
VLN	媤
VMN	媧
VHV	媫
VWK	媬
VQB	媰
VER	媱
VTL	媲
VTH	媳
VAB	媶
VLW	媼
VCO	媽
VAM	媾
VRQ	媿
VPG	嫁
VEH	嫂
VDR	嫄
VPW	嫆
VPJ	嫇
VUT	嫉
VXU	嫋
VUV	嫌
VEE	嫍
DHS	嫑
VAT	嫕
VSF	嫖
VLX	嫘
VJL	嫚
VUJ	嫜
VOV	嫝
VAA	嫟
VYU	嫡
VGH	嫣
VAJ	嫫
VOA	嫬
VRL	嫵
VBD	嫷
VUS	嫻
VOQ	嫾
VFP	嬄
VFK	嬉
VKK	嬋
VTD	嬌
VTO	嬏
VRY	嬓
VYL	嬗
VFW	嬙
VPN	嬣
VOS	嬤
VVH	嬧
VFD	嬬
VGW	嬭
MMV	嬰
LEV	嬲
VXR	嬵
VPT	嬸
VEM	嬹
VLH	嬽
VFS	孀
VWW	孅
VMM	孆
VNI	孎
VAU	孏
BBB	子
BGD	孒
BNN	孔
BBF	孕
BBG	孖
PBF	字
DHB	存
EBF	孚
BTY	孜
BNU	孞
BLF	孟
BCK	孡
BQN	孢
TBF	季
BRC	孤
XEB	孧
BYN	孩
BTX	孫
BMY	孭
ERR	學
BFD	孺
BVH	孻
BTW	孼
BMM	孾
PVB	宄
PTA	宅
PXB	宆
PGF	宇
PFU	守
PVF	安
PDY	宊
PSU	宋
PFQ	完
PYW	宍
PTD	宎
PDC	宏
PFJ	宑
PTF	宒
PDF	宕
PXC	宖
PFI	宗
PHN	官
PMF	宙
PGH	定
PQB	宛
PEG	宜
PDW	実
PGJ	宣
PGC	室
PAH	宦
PQI	宨
PDN	宬
PVT	宭
PKT	宮
PFT	宯
PUF	宰
PKS	宲
PJV	宴
PIE	宵
PWW	容
PKG	宺
PES	寀
PGV	寁
PHG	寂
PDS	寄
PGM	寅
PGE	寈
PHM	寊
PGK	富
PQM	寏
PNH	寐
PJM	寓
PJG	寔
PDL	寕
PIV	寖
PFH	寘
PRC	寙
PAJ	寞
PWF	察
PLV	寠
PDE	寡
PNW	寥
PXF	實
PNL	寧
PTO	審
PET	寪
PEQ	寫
PDU	寮
PLG	寰
PXT	寲
PGQ	寳
PGR	寶
PMD	寷
FFU	寺
EFU	寽
YFY	対
USG	尊
VAK	尋
OGU	對
IHT	小
ITE	少
WIU	尒
TIU	尓
BIU	尕
IDU	尖
IMK	尚
IDI	尜
DNV	尢
DNY	尤
DNQ	尥
DNE	尨
WQG	尩
DNW	尬
DNT	尰
DNM	尳
DNK	尵
VTE	尹
NVV	尻
NXV	尼
NTF	尾
NII	尿
NXX	屁
NMI	屃
NPW	屄
NDD	居
NFB	屆
NBM	屈
NGC	屋
NKM	屌
NGQ	屍
NOI	屎
NUA	屏
NIE	屑
NDF	屒
RGN	屔
NAE	展
NBS	屙
NTA	屜
NAN	屟
NFT	屠
NLV	屢
NTH	屣
NTT	履
NTL	屨
NPD	屪
NIL	屬
NMM	屭
BHK	屮
MMM	山
TMJ	屲
TYM	屳
MER	屴
MDR	屵
MVR	屶
MBT	屷
MAG	屸
MTN	屹
MNN	屺
MVY	屻
MGQ	屼
MFH	屽
MMH	屾
MMJ	岀
MEG	岄
MQB	岇
MAH	岈
MQR	岉
CMJ	岊
MBY	岌
MGA	岍
MWV	岎
MFQ	岏
MFC	岐
MRH	岓
MWJ	岕
TDM	岙
MCB	岜
MTH	岝
MMD	岟
MAN	岠
MSK	岢
MQK	岣
MHC	岥
MUF	岦
MVK	岧
MXJ	岪
MMG	岫
MLH	岬
MPX	岮
MXE	岰
MDG	岵
MRG	岶
MNA	岷
MDF	岸
MQA	岻
MGU	岼
MMF	峀
IPM	峃
MCA	峅
MQJ	峋
MGC	峌
MVG	峍
MVE	峎
MGX	峓
MPV	峖
MFF	峙
MWH	峜
MAT	峣
MYW	峧
MTR	峨
MIE	峭
MVT	峮
MTD	峰
MTJ	峲
MHQ	峴
MCW	峻
MDW	峽
IRM	峾
MYV	崀
MQE	崅
MPW	崆
MPF	崇
MIJ	崉
MSS	崊
MND	崌
MSW	崍
MDS	崎
MJX	崑
MMU	崗
MWG	崙
MFW	崚
MQF	崟
MGJ	崠
MBI	崡
MEV	崢
MRD	崤
MRT	崥
MDJ	崦
MGV	崨
MEE	崩
MLD	崮
MQG	崯
MVL	崰
MJG	崵
MUS	崷
MYT	崺
MLN	崽
MSV	崾
MSY	嵀
MUT	嵃
MTU	嵊
MNH	嵋
MAF	嵌
MJM	嵎
MRB	嵏
MWT	嵐
MLG	嵔
MSJ	嵖
MQQ	嵚
MEX	嵠
MWC	嵡
MOV	嵣
MQY	嵧
MYK	嵩
MUX	嵫
MRQ	嵬
MUG	嵯
MIW	嵴
MXU	嵶
MTW	嵷
MXK	嵹
MNW	嵺
MAQ	嵽
MCC	嵾
MSD	嵿
MLV	嶁
MUJ	嶂
MLR	嶄
MGM	嶆
MKW	嶉
MRW	嶊
MNR	嶍
MNF	嶎
MTO	嶓
MSA	嶘
MOQ	嶙
MDU	嶚
MLF	嶧
MMA	嶩
MOG	嶪
MKB	嶯
TMO	嶴
MTM	嶶
MXT	嶷
MOO	嶸
MFN	嶹
MWY	嶺
MQT	嶽
MDA	巁
MUE	巃
MHA	巇
MWN	巋
MID	巌
MTV	巍
MTF	巑
MXH	巓
MUW	巕
MKK	巖
KTH	川
VPV	巡
VJS	巢
IJS	巣
AAA	工
DAF	左
AND	巨
AWW	巫
AEF	巭
UGA	差
NNG	己
RGC	巵
CKX	巼
MHK	巾
MHS	帄
MHW	帆
QAM	帋
RDM	希
MHP	帎
VCM	帑
MHR	帕
MHH	帖
VPM	帚
YUP	帝
YOM	帟
EMH	帠
UDM	帣
VKM	帤
MHI	帩
MHD	帳
AQP	帶
MHJ	帽
MHG	幅
MHE	幍
MHL	幗
MHO	幞
MHT	幡
MHU	幢
MHF	幬
GUF	平
GDF	幵
XNN	幻
XET	幼
MXX	幽
XXD	幾
OXV	庀
OSK	庁
OWI	庂
OCI	広
OTC	庅
OXX	庇
OGB	庉
OSI	床
OFC	庋
OAH	庌
ORK	庍
OWJ	庎
OQA	底
OQN	庖
OLK	庘
OVW	庚
OHX	庛
OYE	庡
OGC	庢
OQI	庣
OWS	庥
OAC	度
OWW	座
ORF	庪
ODN	庬
OUA	庰
OFW	庱
OSW	庲
ORT	庳
OVI	康
OVE	庸
OWC	庺
OXD	庼
OJM	庽
OEW	庾
OAL	庿
OPO	廀
OMJ	廁
OSH	廂
OVC	廄
ORQ	廆
ODH	廈
OUV	廉
OYV	廊
OEH	廋
OAK	廑
OGQ	廒
OYK	廓
OLV	廔
OBW	廕
ONW	廖
OAQ	廗
OON	廘
OFK	廚
OJF	廛
ONF	廜
OAD	廝
OQQ	廞
OFJ	廟
OIM	廠
ORL	廡
OWX	廢
OAM	廣
OQE	廨
OYL	廩
OEN	廫
OMM	廮
OQO	廯
OBF	廰
OVK	廱
PNY	廴
THP	延
TFP	廷
VGP	建
SPD	廼
AGT	廾
AGH	廿
CAJ	弁
GAJ	弄
WVA	弅
FCA	弆
YOA	弈
UMI	弊
AYI	弋
AFY	弍
AAY	式
XNG	弓
XHK	弔
XHH	引
XGF	弖
XJK	弗
XCY	弘
XBN	弛
XCN	弝
XQW	弞
UXH	弟
XWF	弣
XRC	弧
VCX	弩
XBG	弭
XUX	弱
XDE	張
XCJ	強
XDJ	弼
XIL	弾
XSK	彁
OGX	彂
XJA	彃
XUE	彅
XKK	彈
XAM	彉
XGW	彌
XGD	彑
XGT	彘
XGP	彙
VOW	彛
XGO	彝
VOX	彞
VFA	彟
ETT	彡
GAE	形
YEE	彣
MYE	彤
SSE	彬
JYK	影
TQY	彴
TBN	彵
TYT	彷
TWC	役
TGG	彺
THC	彼
TXJ	彿
TYG	往
TGH	征
TSG	徆
TQJ	徇
TVE	很
TVG	律
TWG	徐
TUH	従
TAP	徔
TPF	徖
TJG	得
THH	徙
TIM	徜
TWW	從
TSW	徠
TAJ	徣
TNH	徦
TRG	徨
TRF	循
TYU	徬
TMG	微
TNI	徲
TUM	徶
TFL	德
TYC	徹
TRY	徼
TJB	忁
NTE	必
NET	忇
FNU	忈
NVT	忉
NSH	忊
NNN	忋
NNU	忌
VYN	忍
HGN	忐
ANY	忒
NTN	忔
NDY	忕
NFY	忖
NYN	忙
NBN	忚
ONI	応
GDN	忝
YNU	忞
NYY	忟
KHN	忠
NKH	忡
GNU	忢
NBY	忣
NFQ	忨
NWC	忪
NNW	快
NCN	忬
NYH	忭
NQA	忯
NVF	忰
NRB	忷
NNH	忸
NGG	忹
NQW	忺
NRH	忻
QRN	忽
NQN	怉
NVK	怊
NDH	怌
THF	怎
NQK	怐
VCN	怒
NGH	怔
NRG	怕
NDM	怖
DNU	怘
NDG	怙
NEG	怚
NJG	怛
LNU	思
CKN	怠
NCK	怡
NRW	怢
RWN	怣
QVN	急
NGU	怦
NTG	性
QBN	怨
NNX	怩
NCF	怪
NXJ	怫
NLG	怬
NNT	怭
NXE	怮
NFC	怯
NYX	怰
NGM	怲
NKQ	怳
NGN	怴
NSY	怵
SYN	怸
NKW	怾
NQQ	恀
NQJ	恂
NFF	恃
NCT	恈
NEE	恊
NQI	恌
NIG	恍
AWY	恐
NQD	恑
NSG	恓
VKN	恕
NWS	恘
FFN	恚
NLK	恛
NAA	恜
NRD	恡
NDO	恢
BNY	恥
NVE	恨
LDN	恩
NTK	恪
NMG	恫
NTD	恬
AWN	恭
THN	息
NWG	恰
YJN	恴
GMN	恵
WSN	恷
NCE	悀
NKE	悁
NLS	悃
NWK	悅
NUX	悌
NJF	悍
NDW	悏
NKC	悒
NTX	悔
NCW	悛
NKG	悜
NKN	悞
TJN	悡
NYV	悢
TLQ	悤
WQI	您
NIR	悩
NPF	悰
UNI	悶
NTB	悸
NPH	悺
NFU	悻
NGV	悽
SRN	惁
NJX	惃
NGE	情
NMF	惆
NJS	惈
IHK	惉
NPQ	惋
NQG	惍
TKN	惒
NOO	惔
NJQ	惕
NMU	惘
NQR	惚
NIM	惝
NWY	惟
GJH	惠
NXY	惤
NOH	惦
NDA	惰
NPL	惲
SHN	想
NMD	惴
NJT	惺
NTO	愀
TON	愁
NPG	愃
NNK	愇
NQM	愌
NTJ	愎
UJN	意
NPT	愘
JMH	愚
EPN	愛
NAD	愜
DGK	感
NLN	愢
NLY	愣
NAM	愥
NRQ	愧
NGX	愫
NER	愮
NJI	愰
NME	愲
HHN	愳
NXU	愵
NXH	愼
NRN	愾
NEX	慀
NSS	慄
NCY	慅
NUV	慊
CEX	態
NAY	慌
NLW	慍
NFH	慎
NPJ	慏
NSF	慓
NCC	慘
LRN	慙
NLR	慚
NMW	慛
NDR	慡
NJL	慢
NXF	慣
DHD	慧
NVC	慨
NLP	慩
NAK	慪
GUS	慭
NFI	慰
NGJ	慱
NAH	慳
NNR	慴
NOV	慷
UCA	慿
DEP	憂
NIP	憆
NHA	憈
NUL	憎
NWF	憏
NOQ	憐
NKK	憚
NSJ	憛
NSO	憟
NFA	憤
NUE	憪
NUY	憫
NJY	憬
NDU	憭
NRL	憮
NAQ	憯
PGL	憲
NVA	憳
NXG	憴
NUJ	憶
NMA	憹
NRY	憿
NAT	懂
NQE	懈
NTM	懊
NLF	懌
NFW	懎
NEP	懓
NFO	懗
NEA	懚
NXT	懝
NAP	懞
NOS	懡
NFN	懤
NFD	懦
NPN	懧
NDJ	懨
NJA	懪
NRR	懫
NOA	懭
NDE	懮
NQY	懰
NAL	懵
NYL	懷
NWW	懺
NHH	懼
NBB	懾
GNX	戉
DGX	戌
DYX	戍
ADE	戎
TRX	我
AAK	戒
AAU	戔
DHA	戛
MAY	戝
UJX	戠
KBX	戢
ILA	戦
DEA	戫
KKL	戰
FLA	戴
RND	戶
GNR	戸
YND	戾
YNY	房
RNR	所
YNQ	扅
YNO	扊
RTG	手
RGH	扌
RVN	扏
RWY	扒
RSH	打
RBT	扔
RFG	扗
RDY	扙
RAG	扛
RNF	扟
RBN	扡
RTN	扢
RGQ	扤
RTA	扥
RVY	扨
RNH	扭
RWV	扮
RHG	扯
RBY	扱
RRC	扳
RWJ	扴
RFW	扶
RXX	批
RQA	扺
RQW	扻
RDB	扼
RAY	找
BDI	承
RFC	技
RCQ	抁
RGG	抂
RYH	抃
RIT	抄
RYY	抆
RJG	抇
RCN	把
RNY	抋
RPQ	抌
RFQ	抏
RQB	抑
RDH	抔
RWC	投
RUF	抖
RYW	抗
RRH	折
RQU	抣
RGM	抦
RKW	抧
RGU	抨
RMF	抩
RHC	披
RCK	抬
RQN	抱
RSK	抲
RRW	抶
RTP	抸
RGS	抹
RFI	抺
RLH	押
RMG	抽
RNA	抿
RKQ	拀
REK	拁
RYG	拄
RRY	拆
RXY	拇
RHK	拈
RUG	拉
RDN	拋
RRG	拍
VCR	拏
RAF	拑
RAN	拒
RDG	拓
RDC	拔
RPX	拕
RTB	拖
RXE	拗
RQK	拘
RBM	拙
RVK	招
RTW	拠
ROC	拡
RSG	拪
RVE	拫
RTD	括
RAA	拭
RFK	拮
RBI	拯
RWT	拰
AWR	拲
UDR	拳
RVQ	拶
RFT	拷
REE	拹
RDO	拻
RUA	拼
RJX	拽
RWG	拾
RRE	挀
RFF	持
RIG	挄
RBS	挅
RWS	挆
RXJ	指
RPV	按
RTK	挌
VKR	挐
RQI	挑
RPT	挓
RYE	挔
RBG	挕
RGX	挗
IGW	挙
RGO	挜
RVF	挦
RCT	挨
RWK	挩
RWW	挫
RFP	挬
RDF	振
RKG	挰
RII	挱
RTX	挴
RGA	挵
RDT	挷
RHQ	挸
RKC	挹
RGI	捄
RCE	捅
RFO	捇
RKH	捉
REB	捊
REF	捋
RIE	捎
RJF	捏
RKE	捐
RCW	捘
RQG	捦
RDW	捧
RWF	捨
ROW	捬
RRT	捭
RJS	捰
RUD	捲
RGV	捷
RVI	捸
RTV	捼
RPH	捾
RRQ	掀
ROH	掂
RVP	掃
RMU	掆
RCC	掇
REP	授
RHJ	掉
RUK	掊
ROQ	掋
RDS	掎
RQR	掏
RQE	掐
RHD	排
RNB	掘
REV	掙
REQ	掜
RES	採
RUV	接
RPW	控
RDJ	掩
RAJ	措
RBC	掫
RQO	掬
RYN	掮
RHE	掯
RBL	掹
RCJ	掻
RUO	掽
RXG	掾
RGL	揀
RHM	揁
RLN	揌
RAL	描
REA	揑
RTF	插
RKB	揖
RQM	換
RNG	握
RMD	揣
RVC	揤
TOR	揫
RJQ	揭
RPL	揮
REG	援
RVG	揵
RUX	揹
RDI	揼
RJL	揾
RAM	搆
RKM	損
RGE	搏
RYK	搞
RUB	搠
RUW	搤
RXU	搦
RJN	搨
ROV	搪
RTE	搬
RAW	搭
RSS	搮
RME	搰
RLW	搵
RLD	摁
RRS	摋
RLA	摑
RYX	摔
RAQ	摕
RYU	摘
RLP	摙
RYR	摛
RXF	摜
RON	摝
RLX	摞
RLV	摟
RTL	摠
RDR	摤
RTJ	摥
RMW	摧
RNI	摨
RLR	摲
RGJ	摶
RVJ	摷
RSF	摽
RXK	摾
RLT	撂
LWC	撃
RUM	撇
ROO	撈
RVA	撏
RAE	撒
RJY	撔
RAD	撕
RUJ	撞
RSJ	撢
RYC	撤
RWX	撥
RXQ	撧
RDU	撩
RCD	撪
RRL	撫
RTO	播
RJB	撮
RBD	撱
ROG	撲
RQQ	撳
RFU	撻
RFL	擂
RYL	擅
RLF	擇
RLQ	擉
LBW	擊
RIP	擋
RKK	操
RAI	擓
RQD	擔
RTM	擙
RJE	擝
RFN	擣
RFD	擩
RXT	擬
RPG	擯
RPN	擰
RUT	擱
RUS	擲
ROA	擴
ROS	擵
RTU	擶
RVL	擸
RLC	擺
RRX	擽
RDE	擾
SRR	攀
RLL	攂
RUE	攏
RPA	攐
RMM	攖
RBB	攝
RAK	攤
RTH	攥
RER	攪
RHH	攫
RAH	攬
HCU	攴
NHT	收
GNT	攷
NTY	改
ATY	攻
YTY	放
GHT	政
QKT	敂
DTY	故
OTY	敉
TKT	敋
GIY	救
GKT	敔
MTY	敗
FTB	教
NBT	敢
OOH	敥
UKT	敨
AQK	敬
JGQ	敭
GKI	整
LVT	數
HPT	敹
YYG	文
YBF	斈
YJF	斉
YHQ	斍
YYV	斏
GYG	斑
YJE	斔
OUF	料
CCP	斚
KKP	斝
EWU	斞
RTT	斤
RYI	斥
WRR	斧
QKR	斪
DRH	斫
LRH	斬
AJR	斮
USR	新
XXG	斷
YTW	斻
YTB	施
YCI	旀
YTR	旂
YTE	旅
YRM	旆
YYC	旈
YRN	旊
YTN	旋
YTT	族
YTQ	旐
YDS	旑
YTI	旓
YVG	旔
YTO	旙
YTS	旚
YTU	旞
VCA	既
JGF	旦
XJF	旨
JFJ	早
JVT	旫
VJD	旭
VJF	旮
JVB	旯
JFH	旰
JDU	旲
JQY	旳
JMJ	旵
JNR	旸
JGG	旺
JYU	旻
JGB	旽
JQU	昀
JQB	昂
JRC	昄
JBY	昅
JTA	昇
JYT	昉
JGD	昊
JJF	昌
JJG	昍
JEG	明
QAJ	昏
JWV	昐
JQR	易
AJF	昔
JRH	昕
JYR	昘
THJ	昝
JTG	星
JMD	映
JBM	昢
JWE	昣
DWJ	春
JDJ	昦
JFI	昧
JTH	昨
JGS	昩
JCA	昪
JAE	昮
JUF	昱
JXJ	昲
JRW	昳
JQT	昴
JLF	昷
JAB	昻
JDX	昽
JOC	昿
JQI	晁
JIG	晃
GCC	晉
JTM	晌
JPV	晏
JWY	晗
JCW	晙
JQK	晚
JUX	晜
JRD	晞
JDN	晟
JRR	晣
JGK	晤
JPF	晥
JTX	晦
JDF	晨
UOG	普
JSR	晰
JEQ	晲
SRJ	晳
JGE	晴
JJJ	晶
TDK	智
JSS	晽
JTY	暀
JFA	暁
JHD	暃
JPG	暄
JNH	暇
JPL	暈
JDM	暊
JNK	暐
JFT	暑
JJT	暒
JGL	暕
JUJ	暗
JER	暚
JHJ	暢
JRN	暣
JJP	暥
JWF	暩
LRJ	暫
JTW	暰
JAA	暱
JAW	暴
JOQ	暽
JFP	曀
JVI	曃
JSJ	曋
JXT	曏
JRY	曒
JAQ	曔
JEP	曖
JOG	曗
JNW	曜
JJA	曝
JOA	曠
JPD	曢
JHA	曥
JUE	曨
JGM	曬
JNI	曯
JHN	曰
MAD	曲
GJR	更
JXY	曵
GMJ	曺
JQA	曻
JLC	曼
ULJ	曾
FWF	替
JBC	最
JBE	朂
JHG	朄
EEE	月
DEF	有
EFQ	朊
EEG	朋
EWV	朌
EBC	服
EWY	朎
EBM	朏
EQK	朐
MUA	朑
EQI	朓
EYV	朖
YVC	朗
ECW	朘
YNJ	朚
YNE	望
EYK	朜
FJF	朝
EAM	朠
ERB	朡
MUO	朥
EAP	朦
EUE	朧
FII	未
GSI	末
SGD	本
SNN	札
FQY	朮
SNB	朰
WSU	朵
BSU	朶
SVT	朷
SVN	朹
SXN	朼
SSH	朾
SFN	杇
SCY	杈
SET	杉
SKH	杊
SBG	杍
SBF	李
SKF	杏
SFT	材
SFY	村
SVY	杒
STA	杔
SDY	杖
YNS	杗
NSI	杘
SAY	杙
STN	杚
SFG	杜
SBN	杝
SMH	杣
SIT	杪
SFQ	杬
GJI	東
JSU	杲
SJF	杳
SQW	杴
SCN	杷
SWC	杸
SWX	杹
SNY	杺
WCS	枀
SQU	枃
XXS	枈
SGG	枉
SQB	枊
SYT	枋
SWV	枌
SMF	枏
SRH	析
SPQ	枕
SSY	林
SMW	枘
SDB	枙
STY	枚
JSI	果
SFC	枝
SMQ	枧
SHK	枮
SDG	枯
SCK	枱
CKS	枲
SKW	枳
SKV	枴
SKG	枵
EKS	架
SEK	枷
SQN	枹
SAN	枻
ANS	枼
FAS	枽
SFJ	枾
SFA	枿
SHC	柀
SPX	柁
STB	柂
SUG	柆
STP	柉
SMD	柍
SWF	柎
SRG	柏
AFS	某
SAF	柑
IAS	柒
IVS	染
SVK	柖
SWK	柗
SLH	柙
SMG	柚
SJH	柛
STH	柞
SQA	柢
SRW	柣
SJG	查
SRC	柧
SAQ	柩
SXE	柪
SXJ	柫
GLI	柬
SDC	柭
SBM	柮
SSK	柯
SYG	柱
SNT	柲
SQT	柳
HXS	柴
SMA	柵
SLG	柶
SKQ	柷
SKE	柺
SYM	柿
SXY	栂
IPS	栄
SQJ	栒
SQQ	栘
SUD	栚
SUA	栟
SYW	校
SDJ	栢
SUI	栤
SUQ	栨
SNG	栩
SRI	株
SQC	栬
SWA	栰
SAW	栱
SLD	栶
SVE	根
STK	格
FSX	栽
STG	桁
SFF	桂
SQI	桃
SIG	桄
SQD	桅
VKS	桇
PVS	案
SPV	桉
UDS	桊
HJS	桌
SDF	桍
SGC	桎
SAB	桏
SFK	桔
SEG	桕
STL	桖
SBS	桗
SCT	桙
SVQ	桚
SDX	桟
SII	桫
SFP	桲
SCD	桳
SEB	桴
SEV	桵
SCE	桶
SQE	桷
SGI	梂
SSG	梄
STX	梅
SDT	梆
SUF	梓
SMY	梖
SHQ	梘
WHT	條
SIE	梢
PWC	梥
SGK	梧
TJS	梨
SVP	梫
SCW	梭
SUX	梯
SAA	械
SLS	梱
SYC	梳
SSW	梵
HKC	梷
STJ	梸
SLP	梿
YCG	棄
SRM	棉
SAD	棋
SES	棌
SJX	棍
SHD	棑
SDW	棒
SPF	棕
SDE	棖
SEE	棚
SLT	棞
SVI	棣
SQV	棦
SOO	棪
SSS	森
SGV	棲
SCC	棳
SJS	棵
BCS	棸
SPH	棺
SSP	棾
SEQ	棿
SUV	椄
SDS	椅
SHW	椇
SYK	椋
SFH	植
SWY	椎
SND	椐
SRT	椑
SVL	椔
SJJ	椙
FWM	椝
SRS	椞
SOW	椨
SOV	椩
SUO	椪
SUL	椫
SPE	椬
SBB	椰
SNK	椲
SWD	椴
SRB	椶
STI	椼
SXG	椽
SPT	楁
SSJ	楂
SMN	楇
SUT	楌
SPL	楎
SLW	楐
SLN	楒
SWT	楓
SDH	楔
SDA	楕
SVG	楗
SSN	楚
SLY	楞
SFM	楠
SNH	楣
SQR	楤
SPG	楦
SHM	楨
SKB	楫
SJQ	楬
SRF	楯
SEW	楰
SBK	極
SXX	楷
STO	楸
SBC	楹
RIS	楽
SKK	榀
SVC	概
SSL	榃
SJL	榅
SPY	榊
SVV	榋
SNU	榌
SUW	榏
SNA	榐
SXU	榒
SYV	榔
SYU	榜
SDR	榞
SPU	榟
SPJ	榠
SER	榣
SJI	榥
SCO	榪
STM	榭
SOT	榳
SQY	榴
SPW	榷
SJN	榻
SEX	榽
SME	榾
SXH	槇
SAM	構
SWN	槌
SRQ	槐
KKS	槑
SYX	槒
SRD	槔
SHJ	槕
FPD	槖
SDK	槗
SSM	槚
SNR	槢
LRS	槧
SLA	槶
SGM	槽
STW	樅
SYR	樆
SWH	樇
SXF	樌
SHL	樐
SIV	樑
SLV	樓
SVJ	樔
SON	樚
SOA	樜
SUJ	樟
SAJ	模
SAT	樥
SNI	樨
SFV	樰
SVA	樳
SJB	樶
SOG	樸
SUS	樽
STQ	橁
SRL	橅
STF	橇
SOQ	橉
STD	橋
SEP	橓
SYQ	橠
SQK	橡
SBD	橢
SAG	橫
SEU	橳
SHX	橴
SAE	橵
SRU	橷
SFU	橽
SYL	檀
SRY	檄
SFL	檑
SEA	檓
SIP	檔
SWG	檢
SFW	檣
SAP	檬
SXR	檰
SPN	檸
SAH	檻
SFD	檽
SNW	櫂
SSD	櫏
SLL	櫑
SQO	櫓
SAL	櫗
SUK	櫚
STV	櫛
SRX	櫟
SOF	櫥
SYF	櫧
SHA	櫨
SUE	櫳
SAV	櫹
SMM	櫻
SAI	欂
SAK	權
SHH	欋
SLX	欏
SAU	欗
QWU	欠
VKQ	欩
BMQ	欪
LDQ	欭
FKQ	欯
HMA	欳
QQW	欽
FFI	款
QEQ	欿
TFE	歃
JQW	歇
UVO	歉
HHG	止
GHD	正
HXN	此
HHR	步
FHN	武
HFC	歧
HHU	歨
DHG	歪
HAN	歫
HTE	歬
HOB	歯
HTG	歱
HDG	歲
HGM	歵
HXJ	歶
DTT	歷
GQI	歹
HQU	歺
GQX	死
GQM	殃
GQC	殆
GQQ	殉
GQR	殊
GQE	殍
GQD	殎
GQU	殕
GQF	殖
GQA	殘
GQB	殛
GQH	殩
GQK	殫
GQL	殬
GQP	殯
GQW	殲
WDW	段
YGW	殶
RSW	殺
NAW	殿
EFW	毀
UEW	毅
XFD	毌
TXF	毎
TXU	每
FXD	毐
GXU	毒
XXN	比
LXX	毗
TFN	毛
XXT	毞
ITT	毟
EKT	毠
JHT	毷
DAE	毻
JNT	毾
QAV	氏
NAV	民
RNJ	氘
RNM	氙
RNK	氚
RNW	氛
RNX	氟
RNT	氡
RNO	氣
RNL	氤
RNS	氥
RNU	氧
RNP	氨
RNV	氯
BII	氶
YII	氷
YNI	永
IHY	氺
IWU	氼
IVN	氿
ISH	汀
IGN	汅
ICY	汊
IKH	汌
IQY	汐
ITN	汔
IMH	汕
MIU	汖
IFH	汗
IGF	汙
INN	汜
IVG	汝
AIU	汞
IAG	江
IBN	池
IFG	汢
IQA	汦
IGA	汧
IJG	汨
IGG	汪
FJI	汬
IQU	汮
IDC	汯
IDY	汰
IRC	汳
IYH	汴
IYY	汶
ITY	汷
INW	決
ITG	汼
IRN	汽
IWV	汾
ICN	汿
INY	沁
IRH	沂
IFQ	沅
ICQ	沇
IPQ	沈
IGB	沌
IAV	沏
ISY	沐
IQC	沒
IJF	沓
IGH	沔
IXX	沘
IIT	沙
IHG	沚
IGM	沛
IIY	沝
IGS	沫
IFI	沬
IEG	沮
IPX	沱
ITB	沲
ISK	河
IXJ	沸
IMG	油
ICK	治
IVK	沼
IDG	沽
IWK	沿
IKQ	況
ILW	泅
IRW	泆
IEK	泇
ITU	泈
RIU	泉
IRG	泊
INT	泌
IBM	泏
IBE	泐
IXE	泑
IXC	泓
IAF	泔
IFC	法
ILG	泗
IGU	泙
IHX	泚
IQN	泡
IHC	波
IUG	泣
INX	泥
INV	泦
IWF	泭
INA	泯
ILF	泴
DIU	泵
IVE	泿
IYO	洂
IDO	洃
ILK	洄
IWD	洑
IRI	洙
ITA	洚
ITK	洛
TKI	洜
IPV	洝
ICT	洠
IOY	洣
IAW	洪
ITL	洫
IQI	洮
IBG	洱
IYT	洲
IUA	洴
IQJ	洵
IGC	洷
IIG	洸
IGJ	洹
ITD	活
IRE	派
IYC	流
IUD	浂
IQV	浄
IWA	浌
IUT	浐
IGI	浗
IRR	浙
IPD	浤
IKC	浥
ITF	浩
IYV	浪
IEB	浮
ITJ	浰
IWW	浴
ITX	海
IVP	浸
INK	浺
IQK	浼
IFO	浾
IMY	浿
ISE	涁
ILS	涃
IIE	消
IHH	涉
ITR	涐
IVT	涒
IKE	涓
IMW	涔
IKM	涢
IUK	涪
IPH	涫
IFU	涬
INM	涮
IDF	涯
IYW	液
IBI	涵
ILD	涸
IND	涺
IIJ	涾
IUV	淁
IVL	淄
ISR	淅
IRD	淆
IQE	淊
ISS	淋
IIM	淌
IMF	淍
IJJ	淐
IGV	淒
IFW	淕
IHJ	淖
IQR	淘
IPF	淙
IEC	淝
IOO	淡
IQG	淦
IEV	淨
IET	淫
IWY	淮
IPW	深
IYK	淳
IJX	混
IDJ	淹
IAA	淺
IGD	添
III	淼
QIU	淾
IHD	渄
IGE	清
IYJ	済
IDS	渏
IRT	渒
IQM	渙
IFT	渚
IOA	渡
IWT	渢
IFP	渤
ING	渥
IMN	渦
IMJ	測
ILE	渭
IXB	渳
IJQ	渴
IAL	渵
IHI	渺
IPL	渾
INH	湄
IGL	湅
IDW	湊
IMD	湍
IDM	湎
IKB	湒
IUE	湔
IDE	湖
IAD	湛
IHM	湞
IJM	湡
IJT	湦
ICE	湧
IUS	湭
IFM	湳
IUO	湴
IEA	湼
IMT	溄
IVC	溉
IBC	溋
IGO	溍
IOV	溏
IDR	源
IPJ	溟
IUW	溢
ICO	溤
IFS	溨
IUF	溬
IUB	溯
IEH	溲
IRV	溵
IXU	溺
IJN	溻
IGX	溼
IRQ	溾
ILU	溿
IBW	滁
IWC	滃
IJI	滉
IUX	滋
IWH	滌
IBH	滍
IWR	滏
IME	滑
IPU	滓
IEE	滔
IER	滛
IYN	滬
IAQ	滯
ICC	滲
IYU	滴
IHL	滷
IAM	滿
IQO	漁
ISF	漂
IVJ	漅
ISW	漆
ION	漉
ILV	漊
IBT	漋
ITW	漎
INF	漏
IXK	漒
INR	漝
IIP	漟
IAJ	漠
ILP	漣
IQT	漪
IJL	漫
ILX	漯
IGK	漱
IXD	漲
IMP	漴
ILR	漸
INI	漽
XID	潁
IMU	潂
IUM	潎
IWX	潑
IDH	潔
IRL	潕
ITO	潘
IVF	潚
IEQ	潟
IUY	潣
ISO	潥
IUL	潧
ISJ	潭
IFJ	潮
IVA	潯
ITI	潲
IAE	潵
ITV	潷
INB	潺
IOQ	潾
ILN	潿
IVY	澀
IFK	澎
IUJ	澗
IXG	澠
IKK	澡
IMA	澧
IUQ	澬
IOG	澲
ITM	澳
IYL	澶
IQD	澹
IRY	激
ILQ	濁
IOU	濂
IHW	濉
IHN	濎
IPN	濘
IAP	濛
IVH	濜
IFD	濡
IFN	濤
IQP	濥
IAH	濫
IHP	濬
IWO	濮
IXW	濰
IPG	濱
IIA	濷
IRX	濼
IHA	濾
IDA	濿
IFL	瀆
INP	瀈
IPE	瀉
IPT	瀋
IOJ	瀍
IJA	瀑
IDT	瀝
IBD	瀡
IHQ	瀣
IAO	瀳
IMM	瀴
IOL	瀵
INL	瀷
IPA	瀽
IUR	灁
IEL	灂
IBB	灄
ILL	灅
IAK	灌
IUU	灍
IYR	灕
IOS	灖
IJY	灝
IFA	灞
IAU	灡
IYX	灣
RIR	灥
OOO	火
OQB	灮
DOU	灰
OVT	灱
OJH	灲
OAG	灴
OFG	灶
OAJ	灷
QYO	灸
OTA	灹
OBN	灺
OQY	灼
VOU	災
WVO	炃
JOU	炅
OYY	炆
OQW	炊
ORC	炍
OOU	炎
OOY	炏
OSY	炑
OIT	炒
AOU	炗
ORH	炘
QOU	炙
JOY	炚
OYH	炞
OLH	炠
OGH	炡
OXJ	炥
ODC	炦
OTB	炧
OPX	炨
OBM	炪
OYX	炫
OAN	炬
MDO	炭
OMK	炯
QNO	炰
CKO	炱
OCK	炲
OMD	炴
OYG	炷
OTH	炸
ODG	炻
OKQ	炾
OTU	烀
OTL	烅
GAO	烎
OTE	烐
OAA	烒
DGO	烕
FOX	烖
OAW	烘
OTK	烙
OPT	烢
ODO	烣
OFT	烤
ORD	烯
OEB	烰
OMW	烱
RRO	烲
OGV	烴
OPF	烷
OTX	烸
OTD	烽
OOF	烾
OMY	烿
OFO	焃
OKE	焆
OIE	焇
GHG	焉
OCW	焌
OGK	焐
OLS	焑
OWY	焓
OQH	焔
ONN	焗
OUK	焙
SSO	焚
UOI	焛
OJX	焜
OPW	焢
BCO	焣
OPQ	焥
WYO	焦
OJE	焨
OEE	焩
OJQ	焬
OHJ	焯
OYC	焴
OMU	焵
QDY	然
JJO	焸
OJT	焺
OJJ	焻
OFA	焼
JEO	焽
ODF	煃
OWD	煅
OPL	煇
OWT	煈
OGL	煉
OPG	煊
ONK	煒
OSF	煙
HHO	煛
OJU	煜
QVT	煞
OLE	煟
OAF	煤
OQM	煥
JVK	照
ODM	煩
OUS	煪
VGQ	煭
OMN	煱
OFM	煵
OYN	煽
OLD	煾
OJI	熀
ORN	熂
OLW	熅
OKM	熉
OUW	熌
OPK	熍
OER	熎
OPJ	熐
AHK	熙
ONR	熠
ONU	熤
OCE	熥
OIW	熦
OTQ	熪
OOA	熫
GQT	熬
XOD	熲
OJL	熳
OYU	熵
OJB	熶
OUL	熷
OVF	熽
OUJ	熾
OSJ	燂
OQD	燃
QEO	燄
OWG	燈
ODU	燎
OOQ	燐
OFF	燒
OTO	燔
AKU	燕
OVA	燖
OUY	燘
OUN	燜
OJY	燝
OTM	燠
OKK	燥
OHQ	燦
ORY	燩
OEA	燬
OLQ	燭
OEP	燰
OJV	燳
OFU	燵
OMA	燶
OTG	燻
OFN	燽
OJA	爆
OVL	爉
ORX	爍
OPD	爎
ODT	爏
OHA	爐
OUQ	爓
OOG	爜
OEL	爝
OHH	爠
OIP	爣
OAU	爤
OSR	爩
RHY	爬
EVH	爭
EMF	爯
ELV	爵
WRU	父
WRC	爸
WRQ	爹
WRB	爺
RRU	爻
DRR	爽
GWM	爾
THG	片
AHT	牙
TGK	牛
TXN	牝
CTG	牟
TFG	牡
PTG	牢
TVY	牣
TTF	牦
TTY	牧
TYW	牨
TQR	物
TAY	牫
TLG	牭
TDG	牯
TSK	牱
TTG	牲
TXY	牳
TQA	牴
UDT	牶
TPB	牸
YXP	牽
NIT	犀
TUK	犃
TDS	犄
TGT	犇
TUD	犈
THW	犋
TTU	犐
TRN	犔
TAT	犕
TPD	犗
TCC	犙
XKJ	犟
TVL	犣
TLC	犤
TUG	犧
TUT	犪
DCY	犮
QTB	犯
QTC	狁
QTG	狂
QTO	狄
HDY	狊
QTR	狐
QTX	狒
QTQ	狗
QTE	狙
QTV	狠
QTY	狼
QTI	猀
QTT	猁
JED	猒
QTJ	猖
QTW	猴
QTU	猶
QTS	猹
QTM	猾
QTL	獨
QTP	獰
QTA	獲
YXU	玄
YXY	玆
YXI	率
GYI	玉
GGG	王
GSH	玎
GET	玏
GAG	玒
GFH	玕
GQY	玖
GGF	玗
GWC	玜
GFW	玞
GYY	玟
GWJ	玠
GWV	玢
GYH	玣
GDH	玤
GNW	玦
GCQ	玧
GFQ	玩
GTY	玫
GWB	玱
GWY	玲
GWA	玳
GAN	玴
GAF	玵
GGU	玶
GHK	玷
GQN	玸
GYX	玹
GHC	玻
GHX	玼
GLH	玾
GVK	玿
GRG	珀
GSK	珂
GCK	珆
GEK	珈
GNA	珉
GMM	珊
GWE	珍
GVG	珒
GYW	珓
GIG	珖
GTE	珘
GAW	珙
GLD	珚
GUG	珜
GNG	珝
GTK	珞
GRI	珠
GVE	珢
GRM	珤
GBG	珥
GTM	珦
GTG	珩
GFF	珪
GDG	珬
GYT	班
GFT	珯
GIV	珰
GYE	珳
GTR	珴
GUX	珶
GGK	珸
GTX	珻
GMY	珼
GHQ	現
GTN	琁
GKE	琄
GJF	理
GTB	琇
GEB	琈
GYC	琉
GAH	琊
GTJ	琍
GFJ	琎
GIE	琑
GTD	琒
GPG	琔
GRT	琕
GAA	琖
GND	琚
GPW	琛
GSW	琜
GGE	琢
GUK	琣
GHA	琥
GDS	琦
GJX	琨
GJJ	琩
GAD	琪
GDW	琫
GPQ	琬
GVI	琭
GPF	琮
GPH	琯
GOO	琰
GSS	琳
GGW	琴
GGX	琵
GGC	琶
GHJ	琸
GGS	琹
GIF	琺
GQG	琻
GLW	琾
GPL	琿
GJT	瑆
GCN	瑈
GNK	瑋
GNH	瑕
GWD	瑖
GEG	瑗
GBB	瑘
GVT	瑙
GDE	瑚
GAM	瑛
GWG	瑜
GMD	瑞
GGN	瑟
GWN	瑡
GIM	瑣
GJL	瑥
GGO	瑨
GCO	瑪
GOV	瑭
GYV	瑯
GRQ	瑰
GPR	瑸
GIP	瑺
GXF	瑻
GGJ	瑼
GTW	瑽
GAK	瑾
GTL	璁
GYR	璃
GVJ	璅
GGQ	璈
GLP	璉
GUJ	璋
GRL	璑
GAT	璓
GUL	璔
GIA	璖
GOQ	璘
GOG	璞
GJY	璟
GTO	璠
GXX	璣
GAQ	璥
GRY	璬
GYL	璮
GLG	環
GFN	璹
GYU	璾
GHP	璿
GFD	瓀
GLL	瓃
GRX	瓅
GRR	瓆
GTQ	瓈
GBD	瓍
GUE	瓏
GDT	瓑
GYK	瓖
GTF	瓚
RCY	瓜
GNN	瓦
YGN	瓬
PQG	瓭
DGN	瓳
CKG	瓵
UAG	瓶
DCG	瓺
UKG	瓿
TOG	甃
LVG	甊
AFD	甘
TDA	甜
TGD	生
YDT	產
EHK	用
ENV	甩
GEH	甫
DHE	甭
PNE	甯
LLL	田
LHN	甲
JHK	申
LER	男
QLD	甸
MGN	甹
LSH	町
LSJ	甼
LKH	甽
VLF	甾
LYN	甿
LQY	畂
YLC	畆
LQU	畇
LRC	畈
LFW	畉
LTY	畋
LWJ	界
OLG	畑
LUG	畔
LLF	畕
YKL	畗
LMF	畘
QYV	留
CDL	畚
YXL	畜
YLQ	畝
FLQ	畞
LWT	畟
JAF	畢
LTK	略
LFF	畦
OLF	畨
LYE	畩
VFL	畫
LTX	畮
LCW	畯
LAW	異
LPE	畳
IPK	當
LDS	畸
LPQ	畹
LJG	畼
LTG	畽
XXA	畿
LIP	疂
LUJ	疃
LGL	疅
XFG	疆
LFN	疇
NHI	疋
NHY	疏
XTD	疑
UBE	疓
USK	疔
UXV	疕
UAD	疘
UTN	疙
UFI	疛
UGH	疜
UMK	疝
UDN	疣
UCV	疤
UWJ	疥
UWC	疫
UHC	疲
UAF	疳
UHX	疵
UAN	疶
UWE	疹
UTP	疺
UKW	疻
UTU	疼
UEG	疽
UTD	疾
UXJ	疿
UYX	痃
UGM	病
UNX	痆
UWG	痊
UJI	痋
UGX	痍
UQQ	痑
UVE	痕
UTX	痗
UGV	痙
UCE	痛
UTW	痜
UIE	痟
UCW	痠
UTJ	痢
UFN	痣
UWW	痤
UUK	痥
UJH	痩
UEE	痭
UPH	痯
UOO	痰
USF	痲
USS	痳
UTB	痵
UMA	痶
URM	痸
URT	痺
ULD	痼
UBS	痾
UYW	瘁
UCD	瘆
UTG	瘇
UWT	瘋
UJG	瘍
UMN	瘑
UPL	瘒
UQM	瘓
UNH	瘕
UCY	瘙
ULI	瘝
UDW	瘞
UJL	瘟
UIW	瘠
URQ	瘣
UQY	瘤
UEH	瘦
UHA	瘧
UAW	瘩
UXD	瘬
UCC	瘮
ULX	瘰
UNW	瘳
UUJ	瘴
UWF	瘵
UEK	瘸
UNF	瘺
ULV	瘻
UAM	癀
UDU	療
UUE	癇
UWX	癈
UBW	癊
UKK	癌
UGY	癍
ULG	癏
UNK	癖
UEN	癙
UNA	癜
UYU	癠
UUF	癢
UTV	癤
UTM	癥
UQO	癬
UMM	癭
UHH	癯
UVK	癰
UAK	癱
UFH	癲
ULL	癳
WGD	癸
WFQ	発
WXW	發
RRR	白
DJF	百
RNN	癿
RXB	皀
RFJ	皁
RAB	皂
RQY	的
XXR	皆
RGF	皇
RHX	皉
RIF	皐
RTR	皒
DJD	皕
RPF	皖
RRD	皞
RRI	皡
REL	皭
HCI	皮
HCF	皯
HCQ	皰
PLH	皸
HCP	皹
QBT	皺
HAE	皻
HLF	盀
GFL	盂
DHL	盃
XHL	盄
KHL	盅
WVL	盆
DYL	盇
BCL	盈
TLF	盉
UWL	益
FCL	盍
MDL	盎
DOL	盔
DNX	盛
IQW	盜
VIL	盝
AAL	盞
JEL	盟
VHG	盡
EIL	盥
XFU	盭
HHH	目
HSH	盯
HFH	盰
HGF	盱
YNH	盲
HYN	盳
FHF	直
HTN	盵
HFQ	盶
SHG	相
HGB	盹
HRH	盺
HWV	盼
RFH	盾
HYY	盿
HEG	眀
ITH	省
HQA	眂
HRC	眅
HYT	眆
HPQ	眈
NHD	眉
RHF	看
HAR	眍
HFI	眎
HMD	眏
HXE	眑
HJH	眒
LIU	眔
HWE	眕
HKQ	眖
HQK	眗
DUH	眘
HCK	眙
HGS	眜
HPS	眝
FHW	真
HNA	眠
HRW	眣
HNX	眤
HXH	眥
HVK	眧
HTP	眨
HYX	眩
HUG	眫
HDX	眬
HFF	眭
HMG	眮
HGC	眰
HGX	眱
HBG	眲
HQJ	眴
HQQ	眵
UDH	眷
HCT	眸
HUD	眹
HQI	眺
HVE	眼
HRE	眽
LWW	眾
WWH	睂
HIE	睄
HPF	睆
HUX	睇
HKG	睈
HWW	睉
HKE	睊
HTR	睋
HHQ	睍
HRD	睎
HLS	睏
HOO	睒
HDF	睚
HGE	睛
HEV	睜
HSW	睞
HYW	睟
HTF	睡
HLG	睤
HRT	睥
HFW	睦
HEQ	睨
HVI	睩
LFU	睪
HGV	睫
HES	睬
HMF	睭
HAD	睰
HNH	睱
HJT	睲
HPL	睴
HFK	睵
HDW	睶
HVG	睷
HFT	睹
HWN	睺
HJG	睼
HPG	睿
HRF	瞃
HAL	瞄
HTO	瞅
HOP	瞇
HWC	瞈
HOV	瞊
HEH	瞍
HPD	瞎
HPJ	瞑
HYK	瞓
HTW	瞛
HLV	瞜
HYR	瞝
HAM	瞞
HSF	瞟
HKK	瞣
HWY	瞧
HOG	瞨
HWG	瞪
HSJ	瞫
HEP	瞬
HDU	瞭
HYC	瞮
HNB	瞰
HCN	瞲
HUJ	瞳
HRL	瞴
HOQ	瞵
HQD	瞻
HHP	瞾
HHW	瞿
HTM	矀
HPN	矃
HNW	矅
HAP	矇
HRP	矈
HXR	矊
HDA	矋
HOA	矌
HQM	矎
HTH	矏
HHA	矑
HUE	矓
HIP	矘
HUN	矙
HNI	矚
TDU	矢
CTD	矣
QDT	矦
TDX	矧
TDT	矯
TDL	矲
DSH	矴
DBG	矷
DFH	矸
DTN	矻
DAG	矼
DQY	矽
DIT	砂
DMY	砃
DFW	砆
DYY	砇
DDB	砈
DAV	砌
DQW	砍
DBY	砐
DAH	砑
DXX	砒
DWC	砓
DGA	研
DVF	砕
DGB	砘
DWR	砜
DGS	砞
DTH	砟
DEG	砠
DGY	砡
DPX	砣
DQA	砥
HXD	砦
DXJ	砩
DXY	砪
DYG	砫
DUG	砬
DTP	砭
VCD	砮
DGU	砰
DQN	砲
DDG	砳
DHC	破
DRG	砶
DJH	砷
DAM	砸
DAR	砹
DWA	砼
DEH	砽
DOC	砿
DCA	硁
DIG	硄
DTL	硇
DVG	硉
DTK	硌
DVE	硍
DGD	硏
DMG	硐
DUA	硑
DSG	硒
DMN	硙
DTD	硚
DYO	硛
DIE	硝
DYV	硠
DPD	硡
DDW	硤
DLH	硨
DTR	硪
DYC	硫
DGJ	硬
DHQ	硯
DLS	硱
DFO	硳
DMW	硶
DSW	硹
DGE	硺
DEE	硼
DQV	碀
DPF	碂
DLT	碅
DMF	碉
DAA	碊
DMS	碋
DVI	碌
DYW	碎
DRT	碑
DQG	碒
DDS	碕
DPQ	碗
DMA	碘
DUK	碚
DAN	碟
DJQ	碣
DYN	碥
DPT	碦
GRD	碧
DLG	碨
DDM	碩
DAD	碪
DWD	碫
DJG	碭
DVT	碯
DMD	碳
DSJ	碴
DHM	碵
DDH	碶
DRF	碷
DPG	碹
DPW	確
DCO	碼
DNA	碾
DNI	碿
DUX	磁
DOV	磄
DYU	磅
DME	磆
DRQ	磈
DDD	磊
DEX	磎
DUV	磏
DKM	磒
DWN	磓
DFC	磕
DNR	磖
LRD	磛
DWF	磜
DDR	磢
DCC	磣
DRV	磤
DLX	磥
DSF	磦
DGM	磧
OSS	磨
DTW	磫
DDF	磭
DOO	磱
DUL	磳
DEQ	磶
DUS	磸
DTO	磻
DKK	磾
DUE	礀
DIP	礃
DYK	礅
DTM	礇
DRY	礉
DLF	礋
DFL	礌
DSS	礎
DOG	礏
DGL	礓
DJX	礘
DXT	礙
DAP	礞
DAL	礣
DAW	礤
DOA	礦
DLL	礧
DDA	礪
DRX	礫
DDT	礰
DOS	礳
DFS	礵
FIU	示
PYF	社
PYB	祁
PYC	祃
PYR	祈
PYD	祐
PYV	祒
PYE	祖
PYQ	祗
FIF	祘
PYT	祚
PYK	祝
PYJ	神
BMF	祟
PYU	祥
SFI	票
WFI	祭
PYL	祵
PYA	祺
PYX	祿
SSF	禁
PYP	禈
PYS	禋
PYG	福
PYO	禟
PYM	禮
PYY	禳
MCI	禸
TKM	禹
TTT	禾
TQB	禿
TBR	秀
TCY	私
TWU	秂
TBG	秄
TTA	秅
TMH	秈
TGV	秉
TFC	秐
TIT	秒
TXX	秕
TNX	秜
TEG	租
TGU	秤
DWT	秦
TRW	秩
TAN	秬
TTN	秭
TGC	秷
TWT	秹
TPT	秺
TQQ	移
TPE	秾
TRD	稀
TYV	稂
TEB	稃
TCW	稄
TWK	稅
TLS	稇
TIE	稍
TRT	稗
TWY	稚
TLT	稛
TFW	稜
TOJ	稥
TLE	稩
TTJ	稪
TRB	稯
TEM	稱
TUV	稴
TLW	稷
TYX	稸
TNU	稺
TEE	稻
TPG	稼
TDN	稽
TYK	稿
TRI	穆
TNW	穋
QOT	穌
TMA	穠
TEA	穩
TGW	穪
TAW	穫
TOA	穬
TQO	穭
TEL	穱
PWU	穴
PWV	究
PWX	穹
PWS	穼
PWA	穿
PWD	突
PWH	窅
PWG	窒
PWQ	窕
PWT	窗
PWN	窟
PWJ	窠
PWM	窩
PWI	窪
PWO	窲
PWL	窶
PWB	窿
PWE	竄
PWR	竅
UUU	立
UWN	竌
UAJ	竎
UKH	竒
UWV	竕
UPS	竚
UUG	竝
UJQ	竟
UCT	竢
UPD	竤
UHJ	竨
UPE	竩
UQV	竫
UNU	竮
UUL	竲
UUS	竴
UKQ	競
THT	竹
TFF	竺
TER	竻
TGF	竽
TBB	竾
TAF	笁
TGA	笄
TRR	笅
TCB	笆
TYH	笇
TBY	笈
TQU	笉
TMW	笍
TTD	笑
TNY	笖
TLJ	笚
TMF	笛
TBM	笜
TCK	笞
TUF	笠
TQN	笣
TVK	笤
TNG	笥
TWF	符
TMM	笧
TXH	第
TQK	笱
TCA	笲
TEK	笳
TIB	笵
TAK	笸
TAB	笻
TTK	笿
TQI	筄
TWA	筏
TAG	筐
TGM	策
TRK	筘
TIV	筜
TPS	筞
TRC	筢
THQ	筧
TCE	筩
TAL	筪
TMU	筫
TTH	筵
TNN	筷
TTS	筿
TBC	箃
TIC	箈
TAA	箋
TRA	箍
TEV	箏
TGE	箐
TVI	箓
TIR	箔
TAD	箕
THA	算
TPW	箜
TJX	箟
TPH	管
TPQ	箢
TIH	箥
TUE	箭
TSH	箱
TDE	箶
TFT	箸
TXQ	箹
TTV	箻
TKB	箿
TVC	節
TLB	範
TXG	篆
TYN	篇
TIA	篊
TTO	篍
THI	篎
TSA	篐
TBI	篜
TIJ	篞
TWH	篠
TCO	篤
TSS	篥
TTL	篦
TBW	篨
TWN	篩
TQF	篯
TJA	篳
TTW	篵
TRQ	篼
TTR	篽
TTQ	簃
TNT	簈
TLV	簍
TVO	簘
TKK	簞
TSJ	簟
TUJ	簡
TUY	簢
TLM	簤
TAM	簧
TOO	簩
TAQ	簪
TYA	簱
TPY	簶
TIP	簹
TPA	簺
TMN	簻
TIG	簿
TAH	籃
TEU	籐
TSQ	籕
TQV	籙
TRL	籜
TYR	籬
TLX	籮
OYT	米
OFH	籵
OWN	籶
OVG	籹
OTN	籺
OBG	籽
OVY	籾
OFY	籿
OQR	粅
OWV	粉
XXO	粊
OXH	粌
ONY	粎
OCN	粑
OUG	粒
ORG	粕
OGS	粖
OEG	粗
OHK	粘
OMG	粙
VOJ	粛
OSG	粞
SOU	粟
XOX	粥
ODJ	粨
IVW	粱
OGJ	粳
OYW	粹
OGE	精
OJS	粿
ONH	糈
ORB	糉
ODE	糊
OUX	糍
OXU	糑
OAT	糒
OCY	糔
OOV	糖
OTF	糙
OCC	糝
OLA	糞
OGM	糟
OAE	糤
OJG	糧
OXK	糨
OFD	糯
ODA	糲
TYO	糴
BMO	糶
XIU	糸
XSH	糽
XNH	糾
XVT	糿
XFY	紂
XKH	紃
XQY	約
XAG	紅
XVY	紉
XYY	紋
XDN	紌
XMW	納
XDY	紎
XUF	紏
XDH	紑
XWJ	紒
XGB	純
XXH	紖
XIT	紗
XQA	紙
XBY	級
XWV	紛
XFC	紜
XPQ	紞
GXI	素
XYT	紡
FPX	索
XRH	紤
XRW	紩
XHX	紪
HXX	紫
XMG	紬
SNX	紮
XLG	細
XDC	紱
XAN	紲
XJH	紳
XHC	紴
XPS	紵
XYG	紸
XVK	紹
XAF	紺
XMD	紻
XXJ	紼
XPX	紽
XWE	紾
XCK	紿
XBM	絀
XTB	絁
XTU	終
XEG	組
XMK	絅
XUG	絆
XRG	絈
XOC	絋
XCF	経
XWT	絍
XTG	絎
XFK	結
XVC	絕
XIG	絖
XLK	絗
XUQ	絘
XGH	絚
XYW	絞
XTK	絡
XQJ	絢
XUA	絣
XSG	絤
XWG	給
XAD	絨
XQI	絩
XLD	絪
VKX	絮
XYC	統
XXI	絲
XTA	絳
XQC	絶
XHQ	絸
XKE	絹
XRD	絺
XGK	綀
XDT	綁
XIE	綃
XVP	綅
XDW	綊
XPD	綋
XFP	綍
XEV	綏
XUK	綐
XLS	綑
XGV	經
XFN	綕
XON	継
XPF	綜
XSS	綝
XMF	綢
XUD	綣
XAA	綫
XEP	綬
XWY	維
XQR	綯
XPH	綰
XMU	綱
XCC	綴
XES	綵
XJS	綶
XTH	綹
XDS	綺
XPG	綻
XRT	綼
XHJ	綽
XFW	綾
XRM	綿
XOO	緂
XJX	緄
XBC	緅
XVL	緇
AHN	緊
XHD	緋
XTV	緌
XWC	総
XVI	緑
XFT	緒
XYJ	緕
XDG	緘
XAK	緙
XRI	線
XKB	緝
XWD	緞
XYU	締
XAL	緢
XWK	緥
XLN	緦
XUS	緧
XYN	編
XDM	緬
XLE	緭
XTJ	緮
XNK	緯
XWN	緱
XHI	緲
XGL	練
XRB	緵
XPL	緷
XJG	緹
XMN	緺
XGC	緻
XHM	緽
XVE	縁
XUW	縊
XUB	縌
XQB	縐
XUV	縑
XDR	縓
XLW	縕
XEX	縘
XAB	縙
XEE	縚
XGE	縛
XKM	縜
XFH	縝
XYK	縞
XPU	縡
HIT	縣
XGX	縤
XWH	縧
XJI	縨
XYR	縭
XPW	縮
XTW	縱
XLX	縲
XGJ	縳
XYX	縴
XJL	縵
XLV	縷
XAJ	縸
XSF	縹
XLP	縺
XTL	總
XGM	績
TXT	繁
XME	繃
XVJ	繅
XNW	繆
ERM	繇
XXC	繈
XFO	繊
XVO	繍
XQD	繎
XUL	繒
XJB	繓
XUJ	織
XAE	繖
XOQ	繗
XTO	繙
XDU	繚
XFF	繞
XVF	繡
XXK	繦
XAQ	繱
XQE	繲
XRY	繳
XYL	繵
XMA	繷
XLF	繹
XQV	繺
XXX	繼
XWO	纀
XAT	纄
XRX	纅
OXI	纇
XOA	纊
XFL	續
XOJ	纏
XHA	纑
XMM	纓
XQK	纔
XWW	纖
XTF	纘
GXH	纛
XAH	纜
XLL	纝
XDF	绔
XIM	绱
RMK	缶
RMB	缷
RMO	缹
RMN	缺
RMQ	缼
RMR	缿
RMX	罆
RMS	罈
RMI	罉
MMR	罌
RMJ	罎
RMA	罐
MRI	罓
MUY	罔
LDH	罘
LYG	罜
LCN	罞
LDF	罟
LUX	罤
LKE	罥
LEB	罦
LSS	罧
LDJ	罨
LHJ	罩
LHD	罪
LYJ	罰
LFM	罱
LFT	署
LLN	罳
LCO	罵
LCE	罷
LNW	罹
LVJ	罺
LNF	罻
LJA	罼
LDO	罽
LUL	罾
MRR	羀
LXK	羂
LAJ	羃
LXH	羄
LXW	羅
UGJ	羊
UFQ	羌
GHH	羐
UGW	羚
UGP	羜
UGN	羞
VTK	群
UGG	羥
UGC	羧
UGI	羨
UGT	義
UGO	羹
NNY	羽
NAG	羾
NAJ	羿
WCN	翁
DCN	翃
FCN	翅
NDC	翇
LNG	翈
UNG	翊
NUG	翋
NUF	翌
NRF	習
FKN	翓
MQN	翙
NYW	翠
NWN	翭
NLA	翼
IGQ	耀
FTX	老
FTE	耂
FTJ	者
FTQ	耇
FTT	耉
DMJ	而
MDM	耑
DII	耒
DIS	耓
DIB	耔
DIF	耕
DIC	耙
DIH	耜
DIW	耠
DIJ	耦
DID	耨
DIA	耩
DIY	耪
DIL	耬
DIX	耭
DIO	耱
BGH	耳
BSH	耵
BBH	耶
DBF	耷
BFC	耺
BPQ	耽
BDC	耾
BOY	耿
BAY	聀
BWV	聁
BWE	聄
BXE	聈
BBM	聉
BQT	聊
BQI	聎
BDM	聏
BFK	聐
BTD	聒
BKG	聖
BMG	聘
BGE	聙
BCI	聚
BPW	聜
BAK	聝
UBD	聞
BUA	聠
BWC	聡
BPG	聢
BEQ	聣
BYK	聤
BTK	聥
BTL	聰
FNW	聲
BFL	聴
BKH	聵
BQD	聸
BPN	聹
NBF	聼
BGF	聽
VGK	聿
VHK	肀
DCV	肆
MWW	肉
EET	肋
EWN	肌
EVN	肍
PEF	肎
EVY	肒
IEF	肖
EVG	肗
EFY	肘
KEF	肙
EFG	肚
EAG	肛
EFH	肝
ECY	肞
EFN	肟
EWC	股
EFC	肢
ECN	肥
EYT	肪
EGB	肫
EDN	肬
EMW	肭
HEF	肯
EDC	肱
YCE	育
ERH	肵
EXX	肶
EQW	肷
EWF	肸
EGM	肺
HPE	肻
EFJ	肼
EDY	肽
LEF	胃
ERW	胅
ERG	胉
MUQ	胊
ERC	胍
ECK	胎
MUB	胐
ENX	胒
EGU	胓
EUG	胖
EWE	胗
EDH	胚
ELH	胛
EQA	胝
EQN	胞
EXY	胟
ESK	胢
ETB	胣
TXE	胤
NHE	胥
EMD	胦
EAI	胨
EHG	胩
ELD	胭
ETA	胮
EDF	胯
EGX	胰
EIG	胱
EYN	胲
ETK	胳
EGC	胵
EQR	胸
EPV	胺
EUA	胼
EFF	胿
EXJ	脂
EQC	脃
EDO	脄
EQD	脆
ERE	脈
IWE	脊
ERS	脎
EOY	脒
EFP	脖
EGI	脙
EGV	脛
ETF	脡
ETX	脢
EAN	脦
MUC	脧
ERD	脪
EWK	脫
EEB	脬
EEV	脮
ENI	脲
EIR	脳
EDE	脹
ERT	脾
EJS	腂
EOO	腅
EMA	腆
ETV	腇
EEQ	腉
EYW	腋
ECC	腏
OWF	腐
EOW	腑
END	腒
EHD	腓
EPW	腔
EPQ	腕
EPF	腙
EPG	腚
ENG	腛
EXG	腞
EDW	腠
EMN	腡
EJM	腢
EJT	腥
EVT	腦
EFM	腩
EPL	腪
ETG	腫
ELN	腮
ERF	腯
ESV	腰
EWW	腳
ENH	腵
EWD	腶
EJG	腸
ETJ	腹
ERI	腺
EVE	腿
EYU	膀
EUV	膁
ELW	膃
EEH	膄
EOV	膅
EGK	膈
EUW	膉
EIW	膌
EEX	膎
EAK	膒
EON	膔
ELA	膕
ETD	膖
ESF	膘
EXK	膙
EIP	膛
ESW	膝
ENW	膠
EFV	膤
GSD	膥
EOQ	膦
MUU	膧
EFK	膨
EAF	膩
EDU	膫
EKH	膭
ETO	膰
ERL	膴
EAY	膵
EXT	膷
EDA	膸
EFA	膹
EYX	臃
ELQ	臅
EUJ	臆
EWG	臉
EKK	臊
ENY	臎
EFD	臑
EAW	臒
EAH	臔
EPA	臗
EVL	臘
EHA	臚
EHH	臞
EAD	臟
DND	臧
THD	自
THS	臬
GCF	至
FKP	臺
ETH	臼
QEF	臽
EWI	臾
EEF	舀
EAJ	舁
DWE	舂
EQO	舄
ELE	舅
EMG	興
EGN	舉
TDD	舌
TDQ	舐
WFK	舒
TDO	舕
NVP	舝
RLG	舞
TEI	舟
TEC	舥
TED	舦
TEY	航
TEW	般
TEX	舭
TEP	舵
TES	舸
TEJ	艃
TET	艇
TEN	艉
TEO	艔
TEF	艝
TEH	艣
TEQ	艪
VEI	艮
YVE	良
QCB	色
XJQ	艴
UAQ	艵
MDH	艷
BTB	艸
ASJ	艼
AVB	艽
ARU	艾
ABR	艿
AVR	芀
AWB	芁
AVY	芄
ACY	芆
AFJ	芉
ATF	芊
AGF	芋
AFN	芌
AQY	芍
AXB	芎
AFF	芏
ANB	芑
BHB	芔
AQU	芕
ADU	芖
AFW	芙
AGB	芚
APU	芝
ARN	芞
AQW	芡
ABN	芤
AWJ	芥
ABY	芨
AFQ	芫
AWV	芬
ACB	芭
AMW	芮
ANU	芯
AWX	花
AYR	芳
AQC	芶
AHF	芷
ARJ	芹
AAH	芽
AAV	苆
AAQ	苉
ADB	苊
AXH	苐
AQB	苑
ACK	苔
AMF	苖
ALF	苗
AMK	苘
AUF	苙
AEH	苚
ASK	苛
AUX	苝
AQN	苞
ANA	苠
ADK	若
ADF	苦
APS	苧
ANX	苨
ARF	苩
ALW	苬
AXE	苭
AWM	苮
ASG	苯
AXC	苰
AMD	英
AEG	苴
ARW	苵
AWI	苶
AAF	苷
AXU	苺
ANT	苾
AXJ	茀
ABM	茁
ADX	茂
AEK	茄
ACN	茅
AHX	茈
AGS	茉
ARG	茊
ATK	茖
AVV	茘
AVE	茛
ASF	茜
AVG	茟
APB	茡
AQQ	茤
AUQ	茨
AIY	茫
ADH	茬
AWD	茯
ARI	茱
AXX	茲
AIA	茳
ALD	茵
AWS	茶
AWA	茷
ABF	茸
AVK	茹
AYC	茺
AMG	茼
AQJ	荀
APV	荌
AGC	荎
AWT	荏
AGX	荑
AYN	荒
AUA	荓
AEE	荔
ADP	荙
AMJ	荝
AXF	荮
AKW	荶
AFP	荸
AEV	荽
ACW	荾
AKE	莂
AGE	莆
ATJ	莉
AGI	莍
AII	莎
AIP	莐
AGV	莖
ALJ	莗
AWH	莜
APF	莞
ATB	莠
AHQ	莧
AYV	莨
ATR	莪
AJD	莫
AVC	莭
ALE	莮
ABK	莻
AXG	莼
ADY	莽
APQ	菀
APH	菅
ABC	菆
AVD	菇
AVI	菉
AQO	菊
ALT	菌
AJX	菎
AIS	菏
AVL	菑
AJS	菒
AEB	菔
AJJ	菖
ARM	菗
AES	菜
ARD	菝
AIH	菠
AUD	菤
ASR	菥
ARP	菦
AOQ	菧
AUK	菩
APD	菪
AIV	菬
AIC	菭
AOV	菮
AGA	華
AHD	菲
AQF	菳
ADJ	菴
AVP	菷
AIE	菹
ASS	菻
AOO	菼
AHG	菽
AGD	菾
AYW	萃
AQR	萄
ART	萆
AEC	萉
ASW	萊
AJE	萌
ATV	萎
AQE	萏
APE	萓
ARV	萔
AEQ	萖
ASP	萙
AIQ	萢
AJM	萬
AQM	萯
APG	萱
AMN	萵
AEW	萸
AIT	落
AJT	葃
AWK	葆
AAN	葉
AXA	葒
ATI	葕
AFT	著
ASH	葙
AJQ	葛
AQG	葡
ATG	董
ALG	葨
ARC	葩
AGQ	葬
AXQ	葯
ADG	葳
AWG	葵
APL	葷
ALN	葸
AKB	葺
ARB	葼
ASV	葽
ASY	蒁
AYU	蒂
AIR	蒎
ARQ	蒐
AFH	蒖
AFI	蒜
ADR	蒝
ATE	蒩
AXM	蒳
AUB	蒴
AEX	蒵
AXW	蒶
AKM	蒷
ABI	蒸
AUV	蒹
AUT	蒺
AOP	蒾
AYK	蒿
ABT	蓀
APJ	蓂
AYX	蓄
AME	蓇
APW	蓉
AWC	蓊
AFC	蓋
ATL	蓖
AOW	蓙
ACE	蓪
AOD	蓭
ATW	蓯
ATH	蓰
AFU	蓻
ANW	蓼
AJA	蓽
AHL	蓾
AXK	蔃
AIF	蔆
AOJ	蔊
AGK	蔌
AJL	蔓
AOA	蔗
ACC	蔘
ANF	蔚
AHO	蔝
AYT	蔟
AWF	蔡
APN	蔤
ALU	蔨
ALR	蔪
ANH	蔬
ABW	蔭
ALA	蔮
ABG	蔯
ARS	蔱
ADA	蔵
AUM	蔽
AVA	蕁
AEU	蕂
ATO	蕃
AUN	蕄
ANN	蕊
AGW	蕐
ALM	蕒
AQT	蕕
AGJ	蕙
AJB	蕞
AFA	蕡
AEP	蕣
AED	蕦
ATT	蕧
AIJ	蕩
ARL	蕪
AVF	蕭
ADC	蕻
AMA	蕽
AFL	蕾
AOE	蕿
AIL	薀
ARY	薂
AIG	薄
ATM	薇
AXT	薌
AUJ	薏
AGL	薑
AQD	薝
AON	薦
ABU	薩
AUS	薪
AOG	薱
AEJ	薶
AFK	薹
ALY	藅
APA	藆
AHW	藈
ADI	藉
AVH	藎
ADN	藏
AER	藐
ATQ	藜
ADD	藞
ALL	藟
ARR	藠
ALC	藣
ARX	藥
ALV	藪
AUR	藱
ASA	藲
ADT	藶
AYJ	藹
AUW	藺
AIK	藻
AHA	蘆
AXL	蘊
AHH	蘋
AFE	蘎
AYE	蘐
AOS	蘑
ANK	蘗
AAT	蘙
ABE	蘟
AMM	蘡
AUE	蘢
AAM	蘣
ARE	蘤
ATX	蘩
AUG	蘭
ALB	蘻
ALX	蘿
AEM	虋
HAV	虍
HAW	虎
HAA	虐
HAY	虔
HAT	處
HAJ	虛
HAK	虞
KGN	號
HAS	虨
JSH	虰
JHY	虲
JBN	虵
JBG	虸
JAG	虹
JTN	虼
JDB	蚅
JCN	蚆
JNY	蚇
JGA	蚈
YJU	蚉
JYY	蚊
JMW	蚋
JDH	蚌
JXH	蚓
JFQ	蚖
JKH	蚛
JAH	蚜
JSY	蚞
WVJ	蚠
JWC	蚣
CYJ	蚤
JWR	蚥
JWJ	蚧
JFW	蚨
JQN	蚫
JNX	蚭
JWA	蚮
JMG	蚰
JGU	蚲
JXE	蚴
JSK	蚵
JMF	蚺
SNJ	蚻
JHC	蚾
JYG	蛀
JDC	蛂
JDG	蛄
JPX	蛇
NHJ	蛋
JMA	蛐
JCT	蛑
JTK	蛒
JLK	蛔
JFF	蛙
JRI	蛛
JVE	蛝
JYW	蛟
JEE	蛠
JNG	蛡
JUA	蛢
JWG	蛤
JQQ	蛥
JGX	蛦
JMR	蛧
JGC	蛭
JGV	蛵
JGI	蛷
JIE	蛸
JCE	蛹
JDW	蛺
JWK	蛻
JLH	蛼
JMY	蛽
JTR	蛾
LQJ	蜀
JTD	蜂
JHQ	蜆
RRJ	蜇
JKG	蜈
JEB	蜉
JKE	蜎
JTB	蜏
JTF	蜓
JQL	蜔
JSW	蜙
JND	蜛
PNT	蜜
JYC	蜟
JLT	蜠
JBL	蜢
JJX	蜫
JBI	蜬
JQE	蜭
JAK	蜮
ECJ	蜰
JRT	蜱
JTV	蜲
JJS	蜾
JPQ	蜿
JCC	蝃
JMU	蝄
JIW	蝋
JTU	蝌
JVC	蝍
JJH	蝐
WYJ	蝕
JRG	蝗
JYN	蝙
JQM	蝜
JLE	蝟
JUS	蝤
NFJ	蝨
JRB	蝬
JTJ	蝮
JDE	蝴
JAN	蝶
JMN	蝸
JJL	蝹
JFM	蝻
UQF	螀
JYV	螂
JWN	螄
JEX	螇
JDR	螈
JUV	螊
JEH	螋
GKM	融
JUT	螏
JTL	螕
JME	螖
JOV	螗
JRQ	螝
JCO	螞
JPJ	螟
JUW	螠
JWH	螩
JON	螰
JPW	螲
JIP	螳
JSF	螵
ANJ	螶
JLR	螹
JLX	螺
JLV	螻
JYX	蟀
JLA	蟈
JAV	蟏
JAD	蟒
JHX	蟕
JFK	蟛
JIA	蟝
JTO	蟠
JNN	蟤
JAM	蟥
JKK	蟬
JRL	蟱
JVA	蟳
JBK	蟶
GEJ	蟸
JYL	蟺
JUG	蟻
JFU	蟽
JQD	蟾
JUQ	蠀
JXG	蠅
JLG	蠉
JLQ	蠋
JJQ	蠍
JOO	蠑
JAP	蠓
JFD	蠕
JAL	蠛
JLL	蠝
JVL	蠟
JDA	蠣
JYF	蠩
EJJ	蠫
JAT	蠮
JMM	蠳
AQA	蠶
TLD	血
TLN	衄
TLI	衆
TLA	衊
TGS	行
TSY	術
TNK	衛
TVD	衟
TQD	衡
YEU	衣
PUC	衩
PUB	衪
PUE	衫
PUP	衴
FKE	袁
EKY	袈
YQN	袌
PUQ	袍
PUX	袎
PUM	袖
YRW	袠
PUH	被
XYE	袰
YQQ	袲
FYE	裁
PUK	裎
YEM	裔
PUW	裕
YKC	裛
PUG	補
YQG	裦
PUR	裨
PUJ	裸
RMH	製
JSE	褁
PUY	褊
YRQ	褢
PUD	褥
YCO	褭
YLI	褱
PUO	褲
PUN	褶
YFW	褻
YKK	襄
PUT	襖
PUS	襟
PUI	襠
PUA	襪
PUL	襬
PUU	襯
SVF	要
STT	覆
HQB	見
CHQ	覌
FWH	規
HQR	覐
EHQ	覓
PYH	視
HKH	覘
QIH	覙
REH	覛
FOH	覝
HQH	覞
TVH	覣
USH	親
HAO	覷
HQT	覹
AKK	觀
QEH	角
TQE	觕
HXQ	觜
UDQ	觠
QMF	觴
YYY	言
YSH	訂
YHY	訃
VYD	訄
YVN	訅
QYD	訇
YFH	計
YNF	訊
YQY	訋
YAG	訌
YCY	訍
YGF	訏
YBN	訑
YKH	訓
MYF	訔
YMH	訕
YTA	託
YNN	記
UYD	訚
YWX	訛
YWV	訜
YAH	訝
YXH	訠
YRH	訢
YRR	訤
YMW	訥
YPQ	訦
YHG	訨
YYT	訪
YIT	訬
YWC	設
YGA	訮
YBY	訯
YGB	訰
YTF	許
YRY	訴
YLG	訵
YSK	訶
YSY	訹
YWE	診
YGH	証
HXY	訾
YHX	訿
YHK	詀
YDG	詁
YWF	詂
YYX	詃
YQA	詆
YMD	詇
LYF	詈
YKQ	詋
YXE	詏
YPX	詑
YCK	詒
YFC	詓
YVK	詔
YGU	評
YHC	詖
YMK	詗
YBM	詘
YDC	詙
YJG	詚
YEG	詛
YPS	詝
YNG	詡
YQJ	詢
YXJ	詣
YWN	詤
YAA	試
YFF	詩
YPT	詫
YRG	詬
YQD	詭
YFK	詰
YTD	話
YUG	詳
YOY	詸
QDW	詹
YTK	詻
YDO	詼
YBG	誀
YUA	誁
YQI	誂
YDI	誄
YRI	誅
YDF	誇
YGC	誈
YFN	誌
YVY	認
YQT	誑
YCT	誒
YTH	誕
YFP	誖
YTJ	誗
YGV	誙
YIE	誚
YVP	誛
YCW	誜
YGK	語
YDN	誠
YKG	誤
YTX	誨
YWK	說
YUK	説
YJS	課
YPF	誴
YRD	誵
YYW	誶
YMU	誷
YHD	誹
YSW	誺
YIJ	誻
YPE	誼
YEQ	誽
YMF	調
YRT	諀
YCC	諁
YQE	諂
YSS	諃
YOO	談
YTV	諉
YQO	諊
YGE	請
YQV	諍
YBC	諏
YWG	論
YPG	諚
YEW	諛
YAN	諜
YPL	諢
YMN	諣
YTG	諥
YGL	諫
YUQ	諮
YLN	諰
YSF	諲
YFM	諵
YFT	諸
YUT	諺
YAD	諾
YAF	謀
YJQ	謁
YLE	謂
YJT	謃
YQB	謅
YAY	謊
YOP	謎
YEH	謏
YEX	謑
YHA	謔
YLW	謖
YYU	謗
YUV	謙
YUW	謚
YAM	講
YDR	謜
YTM	謝
YQR	謠
YER	謡
YTL	謥
YYR	謧
YAJ	謨
YGM	謮
YLP	謰
YLV	謱
YXF	謴
YNR	謵
YGQ	謸
YAK	謹
YJL	謾
YFJ	謿
YUL	譄
YCN	譎
YUS	譐
YRL	譕
YAQ	譖
YUJ	識
YSJ	譚
YUO	譜
YXG	譝
YMA	譨
YEA	譭
YLF	譯
YFD	譳
YOG	譵
YAW	護
YUE	譾
YDH	譿
YFL	讀
YQM	讂
YLL	讄
YXX	變
YQK	讒
YYK	讓
YBE	讔
YBB	讘
YIP	讜
YYN	讠
YPJ	谉
GKU	豆
GEI	豕
UEU	豙
GEW	豛
GEC	豝
GEQ	豞
QKE	象
GEV	豤
GER	豨
GEN	豭
GED	豲
MGE	豳
ETY	豸
EQY	豹
EFT	豺
EVK	貂
EWS	貅
ETE	貈
EDJ	貊
ERQ	貌
EJF	貍
EAL	貓
ETL	貔
HMU	貞
CMU	貟
QMU	負
MFT	財
AMU	貢
AYM	貣
MBN	貤
WVM	貧
WXM	貨
MRC	販
XFM	貫
GMU	責
MPS	貯
ANM	貰
HXM	貲
AFM	貳
KHG	貴
CDM	貵
MTP	貶
LMU	買
MTG	貹
MKQ	貺
XJM	費
MCK	貽
EKM	賀
FAM	賁
MTK	賂
MYN	賅
UQW	資
SMU	賈
MTL	賉
MOF	賍
MDX	賎
MMY	賏
MWF	賒
PNM	賔
MGI	賕
MJQ	賜
MUK	賠
FLM	賣
MAA	賤
RRM	質
MDE	賬
MPL	賱
MUV	賺
MAM	購
PAW	賽
MMT	贁
MDY	贆
MUL	贈
MQD	贍
MVH	贐
MDN	贓
MFL	贖
MIP	贘
FWW	赍
FOU	赤
FOQ	赥
FOT	赦
FOJ	赨
FOF	赫
FHU	走
FUY	赱
FHH	赴
FHM	赸
FHR	赾
FHE	趄
FHV	超
FHG	越
FHJ	趕
FHI	趟
FHB	趣
FHP	趤
FHQ	趨
FHT	趲
KHU	足
KHW	趴
KHH	趾
KHR	跌
KHQ	跑
KHA	距
KHV	跟
KHD	跨
KHI	踏
KHJ	踢
KHE	踩
KHO	踱
KHC	踴
LRK	蹔
KHT	蹤
KHM	蹦
KHF	躊
KHS	躚
KHP	躥
TMD	身
LGH	車
LNN	軋
LVN	軌
PLJ	軍
LKF	軎
LGQ	軏
LDY	軑
LFH	軒
LVY	軔
LMH	軕
LGG	軖
LHC	軙
LDB	軛
LMW	軜
LQA	軝
LTF	軞
LQW	軟
LKQ	軦
LXE	軪
LWE	軫
LAG	軭
LGU	軯
LQN	軳
LDC	軷
LMG	軸
LKW	軹
LVK	軺
LSK	軻
LRW	軼
LAA	軾
LUA	軿
LDM	輀
AWL	輂
LYW	較
LIG	輄
LTE	輈
FLX	載
LGC	輊
LIE	輎
LSG	輏
LPF	輐
LBN	輒
LQK	輓
LGE	輔
LGV	輕
LEQ	輗
LBC	輙
LGM	輛
LVL	輜
LCC	輟
LJS	輠
LQE	輡
LJX	輥
LPH	輨
HDH	輩
LYK	輬
LKB	輯
LDW	輳
LJQ	輵
LUS	輶
LWG	輸
LTJ	輹
LJL	輼
LCD	輽
LNA	輾
ELG	輿
LLW	轀
LPD	轄
LON	轆
LGJ	轉
LLP	轋
LFV	轌
LYC	轍
LTD	轎
LNB	轏
LOG	轐
LDU	轑
LFA	轒
LTO	轓
LOQ	轔
LFD	轜
LAH	轞
LRX	轢
LDT	轣
LHA	轤
LAU	轥
LDG	轱
LTU	轷
UFJ	辛
DUF	辜
CKU	辝
THU	辠
UDE	辦
UDX	辮
UDY	辯
DFE	辱
EHU	辵
GPD	辷
BPE	辸
VPE	辺
FPK	辻
TYP	込
MPK	辿
GFP	迂
FNP	迃
TNP	迄
NFP	迅
BPV	迆
NPE	迉
EPD	迌
QBP	迎
DYP	迏
RPK	近
YWP	迒
RCP	返
GDP	迗
HKP	迠
NXP	迡
ANP	迣
MKP	迥
EKP	迦
JHP	迧
CKP	迨
MPD	迪
RPD	迫
YGP	迬
RWP	迭
QHP	迯
SYP	述
PXP	迱
FCP	迲
LKP	迴
OPI	迷
UAP	迸
QQP	迻
QJP	迿
VEP	退
UDP	送
QIP	逃
FBP	逇
TMK	逈
IEP	逍
TBP	透
GEP	逐
WGS	途
YPD	這
CEH	通
GKP	逜
RRP	逝
KGP	逞
TFK	造
CWT	逡
TDH	逢
LPK	連
AJP	逪
VIP	逮
MFK	週
WYP	進
TVP	逶
UEP	遂
HMP	遉
PLP	運
YNM	遍
MNM	過
NHF	遐
RGP	遑
NKA	違
RHA	遞
FKW	遠
JNP	遢
GMA	遭
OAO	遮
LVP	遱
SDN	遷
NNA	選
KKU	遻
DUJ	遼
RYT	邀
LGK	還
VLR	邋
KCB	邑
SBH	邒
NBH	邔
VKC	邕
MBH	邖
FBH	邗
GFB	邘
VBH	邚
ABH	邛
FWB	邞
WVB	邠
YBH	邡
GAB	邢
NGB	那
RBH	邤
DTB	邦
OBH	邩
QKB	邭
AFB	邯
CKB	邰
RGB	邱
VKB	邵
UXB	邶
QAY	邸
FFB	邽
RIB	邾
FKB	郆
QJB	郇
THB	郋
FFK	郌
KKB	郘
GKB	郚
EBB	郛
FOB	郝
UKB	部
YKB	郭
OOB	郯
BCB	郰
UAB	郱
SSB	郴
HNV	郻
AJV	郾
NHB	郿
UXE	鄁
KKF	鄂
SFB	鄄
PLB	鄆
XTY	鄉
XTR	鄕
KMB	鄖
KFL	鄙
XBH	鄳
SGS	酊
SGQ	酌
SGN	配
SGB	酏
ISG	酒
SGR	酗
SGW	酚
SGP	酡
FSG	酨
SGX	酯
SGF	酵
SGT	酷
SGE	酹
SGU	醅
SGY	醉
SGA	醋
SGJ	醒
TOS	醔
SGO	醚
SGL	醞
ATD	醫
TOI	釆
TOM	釉
TOL	釋
TGJ	重
JFC	野
JGJ	量
FIT	釐
QQQ	金
QNN	釓
QJH	釗
QSH	釘
QET	釛
WRF	釜
QFH	針
QWY	釟
QWN	釠
WQF	釡
QQY	釣
QIY	釥
QKG	釦
QKH	釧
QBG	釨
QAG	釭
QVY	釰
QCY	釵
QFG	釷
QVG	釹
QRH	釿
QCN	鈀
QYT	鈁
QPQ	鈂
QGA	鈃
QEG	鈅
QWC	鈆
QFW	鈇
QMW	鈉
QNY	鈊
QWX	鈋
QNW	鈌
QGB	鈍
QXH	鈏
QRC	鈑
QBY	鈒
QIT	鈔
QNH	鈕
QWV	鈖
QCQ	鈗
QFC	鈘
QSY	鈢
QGH	鈣
QJG	鈤
QOY	鈥
QFQ	鈨
QYY	鈫
QNX	鈮
QBM	鈯
QYM	鈰
QSK	鈳
QGM	鈵
QCK	鈶
QDG	鈷
QDC	鈸
QHC	鈹
QHN	鈻
QDM	鈽
QMG	鈾
QLG	鈿
QLH	鉀
QWE	鉁
QRW	鉄
QAN	鉅
QHK	鉆
QPX	鉈
QYX	鉉
QQN	鉋
QNT	鉍
QRG	鉑
QYG	鉒
QAF	鉗
QQT	鉚
QWF	鉜
QUG	鉝
QGN	鉞
QMD	鉠
QSG	鉢
QXY	鉧
QEK	鉫
QHG	鉬
QJY	鉵
QYW	鉸
QTK	鉻
QUA	鉼
QCT	鉾
QVE	銀
QQJ	銁
QYC	銃
QDI	銇
QWT	銋
QMM	銏
QGD	銒
QGX	銕
QQK	銘
TQG	銜
QWS	銝
QFI	銢
QVK	銣
QYE	銥
QIG	銧
QPV	銨
QDE	銪
QQC	銫
QDX	銭
QXI	銯
QAR	銰
QJF	銲
QWK	銳
QGI	銶
QIE	銷
QUX	銻
QWW	銼
QQA	銽
QAI	銾
QCE	銿
QKK	鋁
QUF	鋅
QMY	鋇
QFP	鋍
QPF	鋎
QPD	鋐
QCW	鋑
QTD	鋒
QEV	鋖
QGV	鋞
QVP	鋟
QEB	鋢
QHQ	鋧
QGE	鋪
TJQ	鋫
QDN	鋮
QDQ	鋴
QBC	鋷
QND	鋸
QJS	錁
QXG	錄
QUD	錈
QEE	錋
QRT	錍
QQE	錎
QBS	錒
QJX	錕
QVL	錙
QQV	錚
QDF	錛
QPG	錠
QDS	錡
QAA	錢
QCC	錣
QRM	錦
QPH	錧
QAL	錨
QMA	錪
QJQ	錫
QGJ	錬
QSO	錰
QVI	録
QBL	錳
QSW	錸
QHE	錹
QQG	鍂
QXX	鍇
QGL	鍊
QMN	鍋
QOA	鍍
QRF	鍎
QNK	鍏
QPL	鍕
QMJ	鍘
QWD	鍛
QJM	鍝
QHM	鍞
QJT	鍟
QDH	鍥
TOQ	鍫
QLN	鍶
QFT	鍺
QWH	鎀
QIR	鎃
QLW	鎅
QUE	鎆
QJN	鎉
QYU	鎊
QUV	鎌
QER	鎐
QPW	鎔
QIM	鎖
QUB	鎙
QJI	鎤
QRS	鎩
QUW	鎰
QTH	鎳
QCO	鎷
QPY	鎺
QVM	鎻
QMT	鎽
QHL	鏀
QVJ	鏁
QXF	鏆
QLP	鏈
QJL	鏝
QUT	鏟
QSF	鏢
QLV	鏤
LRQ	鏨
QLR	鏩
QME	鏰
QUL	鏳
QXK	鏹
QVF	鏽
QAE	鏾
QFF	鐃
QBJ	鐊
QIJ	鐋
QUS	鐏
QDU	鐐
QSJ	鐔
QAQ	鐕
QUJ	鐘
QVA	鐞
QUO	鐠
QXJ	鐨
QLQ	鐲
QFL	鐳
QFK	鐵
QLF	鐸
QFA	鐼
QFU	鐽
QEP	鑀
QFN	鑄
QGW	鑈
QAW	鑊
MMQ	鑍
QPN	鑏
QAH	鑑
QRR	鑕
QLL	鑘
QAT	鑝
QRX	鑠
QHB	鑡
QON	鑣
QJA	鑤
QQO	鑥
QPA	鑧
QHA	鑪
QWG	鑰
QYK	鑲
QBB	鑷
QHH	鑺
QSR	鑻
QLX	鑼
QTF	鑽
QNI	钃
QAU	钄
QNR	钖
QAK	钷
QKM	铞
QAD	锘
QRQ	锨
QQR	锪
QUK	锫
DEU	長
DCQ	镹
DCT	镺
DCR	镻
DCD	镽
UHN	門
UTE	閁
UGD	閂
UWI	閃
UDD	閆
UFK	閈
UFT	閉
UYE	閍
UDC	閎
USI	閑
UED	閒
UJD	間
UYI	閔
UII	閖
ULK	閘
UYM	閙
UUD	閚
UNT	閟
UYN	閡
UTK	閣
UWA	閥
UFF	閨
USD	閪
ULS	閫
UYV	閬
UWK	閱
UJJ	閶
RSU	閷
UDJ	閹
UJY	閺
UQE	閻
UQA	閽
USV	闄
UIT	闊
UGL	闌
URI	闎
UFC	闔
UUB	闕
UIP	闛
UXX	關
UMT	闝
UNB	闞
UFU	闥
BET	阞
BNF	阠
BGQ	阢
BTN	阣
BBN	阤
BIY	阥
BUF	阧
BDB	阨
BDH	阫
BYW	阬
BCQ	阭
BFQ	阮
BHG	阯
BFJ	阱
BYT	防
BQA	阺
BTH	阼
BSK	阿
BPX	陀
BHC	陂
BWF	附
BQQ	陊
BGM	陋
BDJ	陌
BTA	降
BRI	陎
BDE	陏
BVE	限
BCW	陖
BIE	陗
BGV	陘
BXX	陛
BDW	陜
BDT	陝
BHH	陟
BFH	陡
BPF	院
BLH	陣
BWG	除
BQH	陥
BUK	陪
BHD	陫
BBC	陬
BDS	陭
BWY	陰
BQO	陱
BTF	陲
BGJ	陳
BRT	陴
BFW	陵
BQR	陶
BQE	陷
BSF	陻
BFT	陼
BJG	陽
BAD	陿
BAJ	隁
BWD	隂
BJM	隅
BTG	隆
BDG	隇
BDA	隋
BRG	隍
BUV	隒
BGK	隔
BKM	隕
BWN	隖
BRQ	隗
BUW	隘
BIJ	隙
BIP	隚
BUJ	障
BVJ	隟
BEV	隠
BUT	隡
BFF	隢
BOQ	隣
BNK	隦
BUE	隧
BTM	隩
BFA	隫
BGW	隬
BYU	隮
BFN	隯
BJX	隰
BEA	隱
BIT	隲
BHA	隵
DWW	雁
DCW	雄
WYS	集
TDW	雉
WYH	雋
HXW	雌
YXT	雍
EGW	雎
TKW	雒
KJW	雖
MYA	雘
WYW	雙
YRB	離
FVF	雪
FSU	雬
FYU	雯
FYR	雱
FFC	雲
FUF	雴
FWY	零
FLF	雷
FQN	雹
FDM	需
FIS	霂
FIE	霄
FYF	霅
FTF	霆
FDF	震
FIG	霈
FFO	霊
FGV	霋
FMF	霌
FUV	霎
FHD	霏
FIX	霐
FIH	霑
FEQ	霓
FIY	霔
FSS	霖
FSH	霜
FNH	霞
FIA	霟
FEY	霡
FER	霢
FNR	霫
FAE	霰
FBT	霳
FAK	霸
FNK	霹
FMA	霻
FEJ	霾
FAP	靀
FDT	靂
FYJ	靄
FKK	靈
FID	靋
GEF	青
UGE	靖
GEE	靜
AKF	革
PVA	鞌
UJF	音
UJV	韶
UJB	韷
UJT	韸
UJR	韹
UJA	韺
UJK	韻
DMU	頁
SDM	頂
ADM	項
KDM	順
EDM	須
HDM	頉
GDM	頊
DBD	頋
WCD	頌
FCD	頍
YWD	頏
FQD	頑
WVD	頒
GBN	頓
HCD	頗
CFD	頚
PVD	頞
TKD	頟
FKD	頡
HAH	頥
QID	頫
FOD	頳
XFI	頴
TBD	頺
HHD	頻
TWD	頽
EHX	頿
WYD	顀
OOD	顃
JSD	顆
LND	顋
JGH	題
PTK	額
YDE	顏
PLD	顐
ODY	類
YNW	顧
YLK	顫
JXX	顯
GHW	颪
DYD	飆
WRN	飏
WRO	飚
NUT	飛
WYV	食
WYR	飯
WYQ	飲
WYM	餇
UFW	養
WYB	餌
HQC	餐
WYA	餞
WYL	餵
WYX	饑
QNB	饣
QNC	馂
QNJ	馃
QNS	馇
QNM	馉
QNF	馌
QNA	馓
UTH	首
TJF	香
TJW	馚
TJD	馛
TJE	馟
TJJ	馤
TJT	馥
TJP	馪
COI	馬
UCO	馮
COR	駁
COV	駋
COY	駐
VCC	駑
COQ	駒
COE	駔
EKC	駕
COK	駛
COP	駝
COM	騁
COJ	騍
COD	騎
EUD	騰
COC	騷
COO	騼
COL	騾
COS	驃
COA	驅
COF	驍
CON	驏
COT	驕
COW	驗
COB	驟
COH	驢
COU	驥
COG	驪
CGJ	驲
CGL	骃
CGC	骉
CGU	骍
CGV	骎
CGP	骔
CGW	骙
CGF	骦
MEF	骨
MEH	骳
MES	骵
MEQ	骶
MEY	骸
MET	骼
MEU	骿
MEJ	髁
MEO	髍
MEN	髎
MEL	髏
MEA	髒
MED	髓
MEM	體
MEP	髖
YKM	高
DCE	鬃
HGG	鬧
OBX	鬯
RQC	鬼
FCR	魂
TVR	魏
QOX	魮
QOJ	魯
QOD	魷
QOC	鮐
QOQ	鮑
QOW	鮒
QOP	鯇
QOM	鯛
QOB	鯫
QOV	鯽
QOR	鰉
QOK	鰐
QOL	鰓
QOE	鰩
QOS	鰾
QOF	鱈
QOO	鱗
QOG	鱷
QOH	鱸
QGS	鲄
QGG	鲆
QGT	鲊
QGR	鲌
QGF	鲼
QGY	鳊
QGC	鳋
QGO	鳙
VWV	鳩
CWV	鳮
WDH	鳳
WVW	鳻
DHW	鴀
PQW	鴆
VCW	鴑
NTW	鴓
CAW	鴘
QBW	鴛
QKW	鴝
JGW	鴠
XEW	鴢
DWV	鴣
LWV	鴨
XJW	鴲
PVW	鴳
QIW	鴵
RIW	鴸
VKW	鴽
WSW	鵂
YOW	鵉
EVW	鵎
KEW	鵑
EEW	鵬
QEW	鵮
AJW	鵲
OOW	鶑
UJW	鶕
TOW	鶖
DEW	鶘
PLW	鶤
NHW	鶥
PWY	鶴
MEW	鶻
TUW	鷑
NWE	鷚
LVW	鷜
IEX	鸂
MMW	鸎
WBQ	鸧
ALQ	鹋
VIJ	鹔
NHQ	鹛
QYN	鹱
HLO	鹹
ONJ	鹿
SWW	麥
AGM	黃
TQT	黎
TWI	黏
LFO	黑
JFO	黒
XHN	黽
FQX	黿
FCX	鼁
FFX	鼃
RIX	鼄
HND	鼎
BHN	鼐
FKU	鼓
QIF	鼗
ENU	鼠
THL	鼻
HBJ	齒
HBX	齔
HBA	齖
HBR	齗
HBH	齜
HBC	齝
HBE	齟
HBW	齡
HBQ	齣
HBV	齦
HBY	齩
HBK	齪
HBL	齫
HBD	齮
HBB	齱
HBT	齲
HBP	齳
HBU	齴
HBN	齷
HBF	齻
HBS	齼
HWB	龁
OUE	龐
TXD	龜
TTX	龝
LHK	㐃
VNB	㐇
FNB	㐊
ENB	㐍
YNB	㐎
GNB	㐏
MNB	㐕
ONB	㐘
OLN	㐣
WKG	㐰
WER	㐱
WQY	㐴
WNN	㐶
WBM	㑁
WXY	㑄
WJC	㑠
WLQ	㑩
RWU	㒵
PHU	㓀
UDG	㓈
UYC	㓍
YBK	㓙
AJH	㓚
HCJ	㓟
HKJ	㓠
VLJ	㓯
SOJ	㔄
DXB	㔫
ARH	㔸
FET	㔹
HLK	㔽
MBB	㕀
DUD	㕇
CCU	㕕
CYY	㕚
WKF	㕣
KVN	㕤
KNT	㕧
KYT	㕫
KSY	㕲
KGG	㕵
KRG	㕷
IKX	㕾
KVG	㖀
KJX	㖂
WJK	㖋
KOH	㖢
KBI	㖤
KVI	㖨
KBC	㖩
KEC	㖬
KXM	㖰
QKO	㗮
KSL	㘄
LEE	㘞
LLK	㘡
LIJ	㘤
FAL	㙹
DBJ	㚎
DDU	㚐
VDU	㚑
DSU	㚓
DQK	㚚
VVF	㚣
VOT	㚧
VLG	㚼
VQN	㚿
VRC	㛂
VOF	㛇
VSG	㛉
VWS	㛊
VRD	㛓
VMY	㛝
VDJ	㛪
VPO	㛮
VSJ	㜁
VNA	㜊
VEA	㜒
VLQ	㜛
LRV	㜞
VLV	㜢
VLM	㜥
VRX	㜰
VRR	㜱
VHH	㜹
VBF	㜽
PCU	㝊
PBJ	㝋
PQY	㝌
PPU	㝎
PNC	㝕
PTH	㝚
PAM	㝤
PFK	㝨
GNI	㝳
NCI	㞋
NBD	㞌
NCV	㞎
NUD	㞐
BHW	㞣
MWU	㞤
MBR	㞧
MBG	㞨
VMJ	㞪
MPU	㞫
NMJ	㞯
MJF	㞱
MKH	㞲
MYU	㞵
MYY	㞶
MXY	㟂
MWX	㟆
MKU	㟕
MRA	㟛
MVI	㟤
MCD	㟥
MLL	㠥
HNN	㠯
MHX	㠲
MHV	㠴
OAI	㡲
OUD	㡴
OKW	㡶
OYD	㢇
ODS	㢊
OBS	㢌
OXT	㢕
ONL	㢞
HPV	㢟
XMH	㢫
XLR	㢴
XMQ	㢷
XUM	㢼
TDY	㣕
NYU	㣺
VNU	㣽
NYT	㤃
NRC	㤆
NVI	㥆
NBK	㥛
EAV	㥯
NOG	㦠
NRX	㦡
NLX	㦬
RVT	㧅
RXN	㧈
XJT	㪄
JST	㪙
YGJ	㪯
YWY	㫃
JXB	㫐
JET	㫑
JAJ	㫒
JBF	㫗
JKQ	㫛
JBH	㫞
JQJ	㫬
JRM	㫼
JIM	㫾
JCK	㬃
JPY	㬕
JUL	㬝
JWI	㬰
SBT	㭁
SIY	㭂
SCQ	㭇
ASU	㭉
SCA	㭓
SLF	㭗
SQM	㭥
SLE	㭷
HLW	㮚
SCL	㮭
SEH	㮴
XSD	㯋
SLQ	㯮
MQW	㰞
CKQ	㰧
HSK	㱒
IWN	㲹
IAN	㲺
PIU	㲾
IOT	㲿
IAY	㳀
ILH	㳌
IYE	㳖
ISV	㴗
IBX	㶌
IUC	㶒
WOI	㶡
OVB	㶢
OXE	㶭
OEF	㷐
OYO	㷜
OMT	㷨
OBB	㸎
TFH	㸩
TKH	㸪
TRH	㸫
TCN	㸭
TMY	㸽
GCY	㺨
GHY	㺪
GDU	㺯
GVO	㻏
GBC	㻓
GLV	㻲
GLQ	㻿
DRC	㼋
LET	㽖
LWY	㽗
UFD	㽵
UNV	㽶
UPQ	㽸
URC	㽹
UMD	㾄
UHD	㾇
UQD	㾣
URH	㾷
RCU	㿝
HCV	㿪
PSL	㿾
QHD	䀏
HET	䀐
HTX	䀲
HYV	䀶
HLE	䁌
HSV	䁏
HKB	䁒
HRB	䁓
HER	䁘
HJP	䁙
HKM	䁚
HRQ	䁛
HJI	䁜
HYU	䁤
HUL	䁬
HLM	䁲
HYL	䁴
HNK	䁹
HEL	䂃
TDV	䂏
DXN	䂗
DBH	䂙
DAY	䂝
TBH	䄦
TBT	䄧
STU	䅇
UNN	䇃
UAY	䇅
UVI	䇐
TAU	䇝
TDF	䇢
TSF	䇴
TKC	䇼
TYF	䇾
TBV	䈨
EOU	䊆
OPS	䊉
OME	䊘
XVN	䊵
XHG	䊼
XSY	䊾
XMR	䋄
XVG	䋖
XOY	䋛
XND	䋧
XQG	䋮
XSV	䌁
XOV	䌅
XNR	䌌
XBB	䌰
LFJ	䍐
LSU	䍒
LOU	䍘
LLD	䍛
LRB	䍟
NGF	䍿
DNG	䎁
BEG	䎳
TOB	䎹
BRM	䎺
BVI	䎼
BPU	䏁
VIN	䏋
WEF	䏌
CEF	䏍
EXH	䏖
EIT	䏚
EGS	䏞
EQQ	䏧
EBG	䏪
EIE	䏴
EUK	䏽
EDS	䐀
EJX	䐊
EVC	䐚
EIM	䐝
EXU	䐞
ETM	䐿
ENK	䑀
ATU	䒘
AYF	䓂
AFO	䓇
ABL	䓝
ACL	䓿
AVO	䔥
ABD	䔺
AOR	䕇
TJU	䖝
JFY	䖞
JJY	䖵
JUO	䗒
JOS	䗫
SDU	䙲
PXH	䙾
YBT	䚮
YJH	䚯
YXN	䚰
YIY	䚱
YET	䚲
QYF	䚻
YRC	䛀
YLH	䛅
YMG	䛆
YVJ	䜈
ESY	䝗
EIA	䝣
JCM	䝨
MIM	䞆
MJJ	䞎
LWN	䡄
LQL	䡘
LLH	䡛
LUE	䡵
LTH	䡻
LEG	䢁
BPD	䢊
EGP	䢐
MPI	䢙
WBH	䢳
VLB	䣎
QLK	䤧
QBI	䤴
QPO	䤹
QCL	䥁
PJJ	䥌
QLC	䥯
QPE	䥱
QNG	䦀
URK	䦐
BVK	䧂
BLG	䧃
BSG	䧈
BHQ	䧋
BKE	䧎
BOV	䧜
BOG	䧤
FXC	䨎
FNF	䨒
OHD	䨾
PQD	䪴
KVW	䬭
CGK	䯄
CGB	䯅
LIW	䳴
HBM	䶡
