aaa	葡萄牙
aab	工联
aad	葚
aaf	工地
aag	勤劳致富
aah	工龄
aai	工艺水平
aaj	蕴藏量
aak	苏共中央
aam	䔈
aao	戒烟
aaq	工钱
aar	戒指
aas	工本
aat	莫斯科
aau	工艺美术
aaw	工会
aax	蒙蒙细雨
aay	工效
abb	3
abc	萾
abf	节支
abh	节目
abi	菡
abj	节电
abk	藬
abm	䔴
abp	3
abr	蒸气
abs	3
abt	䕖
abu	茁壮
abw	蒢
aby	巧取豪夺
aca	芭蕉
acg	㦯
ach	3
acj	3
ack	䕂
acm	3
acn	欺骗性
acp	3
acr	3
acs	3
acv	3
acx	3
ada	苦苦
adb	巨大障碍
adc	欺骗
add	巨大成就
ade	苈
adf	蓐
adg	基于
adh	苤
adi	勘测
adj	苦果
adk	其中
adm	荋
adn	基础性
ado	基业
adp	勘察
adq	蒙古包
adr	其后
ads	切不可
adt	基础知识
adu	期间
adv	莫不如此
adw	期
adx	苦练
ady	期望
aea	苏区
aeb	苏联
aec	薍
aed	莫须有
aee	功力
aef	功过
aeg	莇
aeh	苚
aek	苏中
aem	䕟
aep	藐视
aeq	葋
aer	菜肴
aes	荔枝
aet	散
aeu	散装
aew	菜价
aey	功效
afa	某项
afb	甘孜
afc	劳动能力
afd	甘愿
afe	劳动服务公司
aff	劳动者
afg	七十五
afi	芜湖
afj	劳动时间
afk	薳
afl	匵
afm	黄埔同学会
afn	区域性
afp	劳动定额
afq	莰
afr	劳动报酬
afs	著述
aft	某种
afu	邯郸
afv	劳动群众
afw	藿
afx	劳动纪律
afy	劳动就业
aga	七五期间
agb	萅
agc	㦶
agd	七百
age	蕤
agf	巧干
agg	甚至于
agh	艹
agj	甚至是
agk	菫
agl	莆田
agm	苪
agn	匸
agq	塟
agr	熙来攘往
agt	七千
agu	荆门
agv	萐
agw	七亿
agy	某一方面
aha	菲薄
ahb	3
ahc	3
ahd	欺上压下
ahe	3
ahf	邪教
ahg	雅致
ahh	匷
ahk	颐
ahm	3
ahn	工具书
ahq	薒
ahs	3
aht	鸦
ahu	3
ahv	3
ahx	䔝
ahy	节目主持人
aia	东莞
aib	工学院
aic	菭
aid	东面
aie	落脚
aif	医治无效
aig	蒲
aih	蔋
aii	东海
aij	东明
ail	范畴
aio	落座
aip	落空
aiq	萢
air	萡
ais	薄板
ait	荣誉称号
aiu	东北
aiv	蒅
aiw	落伍
aix	萍乡
aiy	东方
aja	节日期间
ajc	3
ajd	墓
ajf	草
ajh	攻坚战
ajj	划归
ajk	3
ajl	东盟国家
ajn	节日快乐
ajp	墓穴
ajq	蓝色
ajr	幕后
ajs	草根
ajt	萌生
ajv	匽
ajw	划时代
ajy	草房
akb	革除
akc	䓃
akd	勤奋
ake	莂
akf	鞋
akg	惑
akh	莡
aki	甚嚣尘上
akj	落叶归根
akk	莒
akm	燕山
akt	鞠躬
aku	嬊
akv	3
akw	勒令
akx	3
ala	世界范围
alb	苗子
ald	蒽
alf	劳累过度
alg	葨
alj	世界日报
alk	花园口
all	蘲
aln	世界屋脊
alo	3
alp	瞢
alq	世界银行
alr	蔪
als	苗木
alt	世界各地
alu	世界闻名
alw	世界领先地位
alx	世界经济全球化
aly	世界文化
ama	蕽
amd	共同愿望
amf	觏
amg	英烈
amh	共同点
ami	黄浦
amj	荒山野岭
amm	黄冈
amn	共同性
amo	3
amp	共同之处
amq	黄色
amr	黄瓜
ams	黄梅
amt	共同繁荣
amu	英姿
amw	共同体
amy	黄帝
ana	巨著
anb	苦心孤诣
anc	3
and	恐惧感
ane	3
anf	巨款
ang	基层政权
anh	世上
ani	戈壁滩
ank	甘居中游
anm	勚
ann	警惕性
ano	3
anp	基层社
anq	匠心独具
anr	3
ans	䢡
ant	劳改释放
anu	巨资
anw	世人
anx	苦心经营
any	苡
aoa	工业区
aob	3
aoc	3
aod	工业布局
aol	工业国家
aom	3
aon	薼
aoo	惹火烧身
aop	蒾
aor	䕇
aos	荒唐可笑
aot	䕰
aou	工业总产值
aov	菮
aow	营业人员
apa	营区
apb	工农联盟
apd	荣辱
ape	劳力
apf	蔻
apg	苎
api	荧光
apj	蓂
apm	巨额赔偿
apn	落实情况
apo	工农业总产值
apq	菀
apr	䓨
aps	劳模
apt	劳务
apu	荣立
apv	荌
apw	劳作
apy	䔗
aqa	菊花
aqb	警卫
aqd	葱郁
aqe	敬爱
aqf	敬老
aqg	藓
aqj	黄金时代
aqk	苟
aql	䓒
aqm	萯
aqn	警民
aqo	炁
aqp	敬礼
aqq	茤
aqr	芴
aqs	世外桃源
aqt	荻
aqu	获准
aqv	旡
aqw	敬佩
aqx	葱绿
aqy	警方
ara	芹菜
arc	萚
ard	莃
arf	欧元
arg	甘拜下风
ari	欧洲
arj	苅
ark	䔱
arm	蒛
arn	芞
aro	3
arq	鸥
arr	幕后操纵
ars	蔱
art	区长
aru	区间
arv	蒑
arw	医护人员
arx	3
asa	基本工资
asc	基本矛盾
asd	艺术大师
asf	艺术境界
asg	基本理论
ash	基本点
asi	艺术水平
ask	艺术品
asl	基本思想
asn	苍松翠柏
asp	基本完成
asr	基本制度
ass	草本植物
ast	基本特征
asv	葽
asw	艺术作品
asx	基本结束
asy	东西方
ata	工程项目
atb	获得了
atd	翳
ate	蒰
atf	获得者
atg	翘
ath	攻占
ati	医治
atj	攻坚
atk	划等号
atl	劳务输出
atm	藢
atn	警备司令部
atp	医务室
atq	薄利多销
atr	工程质量
att	医德
atu	医疗
atv	萟
atw	切身体会
atx	萎缩
aty	劳务市场
aua	获益匪浅
aub	医疗队
aud	东北三省
aue	蕑
auf	莘
aug	葁
aui	薪水
auj	蔁
auk	莌
aul	蒙头转向
aum	虌
aun	蕄
auo	3
auq	薪金
aur	藱
aus	䔵
aut	工资管理
auv	蔅
auw	荣毅仁
aux	苝
auy	共产主义战士
avb	䒵
avc	蔇
avd	切磋
ave	䕅
avh	3
avi	切削
avj	3
avk	蒘
avp	菷
avs	3
avt	萧条
avu	3
avv	䓸
avx	3
avy	共建文明
awa	花草
awb	工人阶级
awc	工作能力
awd	恐龙
awe	工作服
awf	茌
awg	荼
awh	革命战争
awi	工作水平
awj	节假日
awk	共鸣
awl	花圈
awm	巫山
awn	薛
awo	共庆
awp	切合实际
awq	花鸟
awr	苍白
aws	著作权
awt	工作重点
awu	莅
awv	勤俭建国
aww	苁
awx	花费
awy	蕉
axa	虇
axe	药膳
axf	葤
axg	药理
axi	䒺
axj	藴
axk	蔃
axl	3
axr	3
axt	蔠
axv	3
axx	蒈
axy	药房
aya	芳草
ayd	C
aye	䕍
ayf	荒坡
ayi	b
ayj	芒果
ayk	藁
ayl	共商国是
ayn	芒
ayo	荒废
ayr	工商所
ayt	芳香
ayu	蒡
ayv	蓢
ayw	菸
ayx	东方红
baa	䧖
bac	3
bae	3
bak	䧢
bal	3
bam	3
baq	3
bar	隔靴搔痒
bau	3
bav	3
baw	联营公司
bax	3
bay	陈设
bbb	子子孙孙
bbe	3
bbg	䦻
bbh	䧝
bbi	3
bbj	3
bbk	3
bbl	3
bbo	3
bbp	孔孟之道
bbs	3
bby	防卫计划
bcd	3
bcf	取走
bcg	3
bci	鄹
bcj	取景
bcl	取回
bcm	3
bcn	㜿
bco	䧞
bcp	3
bcq	阭
bcr	3
bcs	棸
bcu	取道
bcw	聚会
bcy	取证
bda	堕落
bdb	阴盛阳衰
bde	承受
bdf	承载
bdg	联成一片
bdl	3
bdm	陑
bdn	3
bdo	3
bdr	承接
bds	陭
bdt	随身
bdu	隔三差五
bdw	取而代之
bdy	随州
bea	櫽
bed	出力不讨好
bee	䧟
beg	阻
bek	3
bel	3
bem	3
ben	3
beo	3
ber	阻挠
bet	䧦
beu	阴间
bfd	隭
bff	隢
bfg	3
bfh	陚
bfj	䎴
bfo	3
bfp	3
bfq	‰
bfr	3
bfs	3
bfu	3
bfx	3
bgb	卫队
bgc	3
bgd	耳聋
bge	险恶用心
bgf	╒
bgh	聇
bgj	敶
bgk	䎸
bgm	隔山
bgp	陋室
bgr	隐恶扬善
bgs	隔板
bgu	隔音
bgv	3
bgw	陷于僵局
bgx	陷于绝境
bhd	除旧布新
bhe	3
bhf	3
bhg	耳目一新
bhi	3
bhj	3
bhl	3
bhm	3
bho	3
bhr	3
bhs	3
bht	3
bhu	3
bhv	3
bhx	3
bia	3
bib	顄
bid	聚沙成塔
big	随波逐流
bij	阳光明媚
bil	3
bin	3
bio	3
bip	陆海空
bis	3
bix	3
bjb	"
bjc	聪明能干
bjd	也是不可能的
bje	3
bjf	卫星地面站
bjj	3
bjk	[
bjl	3
bjo	3
bjs	3
bjt	3
bjw	聪明伶俐
bjy	阳高
bkc	凾
bkd	随口而出
bkh	䦿
bki	3
bkm	孙中山先生
bkn	3
bkr	3
bkt	亟待
bkv	3
bkw	职位
bkx	3
bky	耳听为虚
blc	3
bld	3
blf	阵地
blj	3
blk	3
bll	3
blm	3
bln	3
blo	3
blq	3
bls	3
blt	3
blv	3
bma	出苗
bmc	隔岸观火
bmd	出奇
bme	㔘
bmf	出去
bmg	出来
bmi	出汗
bmk	出路
bmn	出局
bmo	出庭
bmq	出名
bmr	出气
bms	3
bmt	出自
bmu	出门
bmw	聘任
bmy	出访
bna	3
bnb	联展联销
bnc	3
bnd	3
bne	3
bnh	阝
bnm	3
bnn	耴
bno	孔庙
bnp	3
bnt	了得
bob	出席了大会
boc	3
boe	3
bof	职业培训
bog	䧨
boh	3
boj	3
bok	3
bom	3
bon	3
bos	3
bot	3
bou	出席并讲话
bow	职业介绍
box	3
boy	防腐剂
bpc	3
bpd	取之不尽
bpf	孤寡老人
bpg	䧑
bph	3
bpi	辽河
bpl	3
bpm	3
bpn	3
bpo	3
bpr	耽搁
bps	辽西
bpv	3
bpw	聺
bqa	隐匿
bqb	陷阱
bqg	隐形
bqj	3
bqk	㝃
bql	3
bqm	3
bqn	隐忧
bqr	出尔反尔
bqt	隐私
bqx	承包费
bra	3
brb	3
bre	3
brf	函授教育
brh	3
bri	陎
brj	3
brk	3
brl	3
bro	3
brq	孤独
brs	防护林带
brv	3
brw	阿拉伯数字
brx	3
bsb	3
bsc	3
bsd	3
bse	3
bsf	䧣
bsl	▃
bsm	3
bsn	3
bsp	3
bsq	3
bsr	3
bss	3
bsx	3
bsy	3
bta	职务工资
btb	卫生院
btd	降压
bte	3
btf	联系地址
btg	隆重开幕
bti	降温
btj	䧗
btk	耳鼻喉科
btl	出版界
btn	防御性
bto	联系业务
btp	联系实际
btr	随身携带
bts	防微杜渐
btt	降息
btu	出版单位
btw	联系人
btx	愻
bty	职称评定
bub	联产承包
bud	障碍
bue	鐆
buf	孤立无援
buj	聪明
bul	3
bun	陶冶情操
bup	联军
bur	子弟兵
buu	陪着
buw	陪伴
bux	聪颖
buy	联户
bvb	3
bvc	3
bvd	3
bvj	隟
bvl	3
bvm	3
bvn	3
bvq	3
bvs	3
bvt	3
bvv	3
bvx	3
bvy	3
bwa	坠落
bwb	聚集了
bwd	附有
bwe	险胜
bwf	联合声明
bwg	队列
bwh	附上
bwi	联合举行
bwj	㜾
bwk	附中
bwl	联合国安理会
bwm	险峰
bwn	阶段性
bwq	除名
bwr	聘任制
bwt	险种
bwu	隐含着
bwv	隝
bww	联合会
bwx	联合经营
bwy	附设
bxb	3
bxg	䧘
bxh	3
bxi	阶级觉悟
bxj	3
bxl	3
bxm	3
bxo	3
bxq	3
bxr	3
bxv	3
bxw	3
bxx	聫
bxy	3
bya	出谋划策
byf	防雨
byg	隔离带
byi	卪
byj	也就是说
byk	䧚
byl	3
bym	3
byn	阸
byo	防爆
byp	防灾
byt	防务
byu	防疫
byv	3
byw	防化
caa	能工巧匠
cab	3
cac	3
cad	䪻
caf	3
cak	3
cal	3
caq	3
cax	3
cay	劲旅
cbb	3
cbc	3
cbd	3
cbe	3
cbf	3
cbi	3
cbk	3
cbl	3
cbm	3
cbn	3
cbo	3
cbp	3
cbq	3
cbr	3
cbs	3
cbu	3
cbv	3
cbx	3
cca	3
ccb	又及
ccc	叠
cce	双脚
ccf	欢欢喜喜
cck	3
ccl	双轨
cco	熊熊燃烧
ccr	双打
ccs	桑植
ccu	双亲
ccx	3
ccy	双方
cda	3
cde	参加
cdg	参天
cdj	奙
cdk	3
cdl	马克思
cdp	对大家来说
cdq	3
cds	3
cdv	3
cdw	参保
cdx	3
cdy	双百方针
ceb	劝阻
cec	3
ced	通达
cee	通胀
cef	能干
ceh	恿
cei	参加活动
cej	通畅
cen	劝导
ceo	3
ceq	双边贸易
cer	能手
ces	3
cet	通行
ceu	通产
cev	3
cew	通俗
cex	通缉
cey	通话
cfb	对子
cfe	3
cff	对过
cfg	对正
cfi	圣洁
cfj	对虾
cfk	对路
cfl	3
cfm	对岸
cfn	对局
cfo	圣火
cfq	对角
cfr	对接
cft	对称
cfu	对准
cfv	3
cfw	圣人
cfx	圣母
cfy	对方
cga	骐
cgb	骗取
cgc	驿
cgd	驮
cge	驯服
cgf	参与者
cgg	马列
cgj	驲
cgk	马路
cgl	驱车
cgn	骗局
cgo	3
cgp	马赛
cgq	驺
cgr	驻扎
cgs	马术
cgt	骢
cgu	又一次
cgw	骅
cgx	3
cgy	驴
cha	3
chb	3
chc	骑虎难下
chd	3
chf	3
chg	3
chh	3
chi	3
chj	3
chk	3
chl	3
chm	3
chn	3
cho	3
chp	3
chs	3
cht	3
chu	3
chv	3
chw	3
chx	3
chy	3
cib	3
cic	3
cid	3
cie	3
cig	邓小平文选
cih	3
cii	台湾海峡
cik	3
cil	3
cio	3
cip	3
cit	3
ciu	能源部
cix	3
ciy	3
cja	3
cjb	3
cjc	3
cjd	3
cje	3
cjg	3
cjh	3
cji	3
cjj	3
cjk	3
cjl	3
cjm	3
cjn	3
cjo	3
cjq	3
cjr	3
cju	3
cjv	3
cjw	3
cjx	3
cjy	3
cka	3
ckb	台联
ckc	3
ckd	3
ckf	台南
ckg	瓵
ckl	3
ckn	乨
ckq	㰧
ckr	3
ckt	欢蹦乱跳
cku	辝
ckv	3
cky	台词
cla	3
clb	3
clc	3
cld	3
cle	3
clf	3
clg	3
cli	3
clj	3
clk	3
cll	3
cln	3
clo	3
clp	3
clq	3
cls	3
clt	3
clv	3
clw	3
clx	3
cly	3
cma	3
cmb	3
cmc	3
cme	3
cmf	3
cmg	3
cmi	观光
cmk	3
cml	3
cmm	3
cmr	对内搞活
cms	3
cmt	3
cmu	观音
cmv	3
cmx	3
cna	巴东
cnc	能屈能伸
cnd	难以克服
cne	3
cnf	予以考虑
cnh	矛
cni	预演
cnj	3
cnn	难以避免
cnp	预祝
cnq	预兆
cnr	马尼拉
cns	预想
cnt	预先
cnu	巴彦
cnw	柔情似水
cnx	巴结
cny	预计
coa	駏
cob	䣕
coc	騒
cod	駓
coe	䮑
cof	馶
cog	駤
coh	驉
coi	騨
coj	騉
cok	驒
col	䮫
com	駚
con	駜
coo	驜
cop	騌
coq	駣
cor	駯
cos	驔
cot	駞
cou	騚
cov	騄
cow	駖
cox	3
coy	駮
cpa	3
cpb	3
cph	3
cpi	3
cpj	3
cpl	3
cpm	3
cpn	3
cpo	3
cpq	3
cps	3
cpv	3
cpw	3
cpx	3
cpy	3
cqb	对外联络
cqc	欢迎参观
cqg	对外开放政策
cqh	3
cqj	3
cql	3
cqm	3
cqn	欢心
cqq	对外贸易经济合作部
cqr	对外援助
cqt	欢迎垂询
cqv	3
cqw	驻外使馆
cqx	对外经济贸易
cqy	允诺
cra	3
crc	3
crd	3
crg	3
crh	3
crj	3
crk	3
crl	3
crm	3
cro	3
crq	3
cru	3
crv	3
crw	3
crx	3
cry	3
csa	3
csb	3
csc	3
csd	通权达变
cse	3
csf	3
csg	3
csh	3
csi	3
csj	3
csk	3
csl	3
csm	3
csn	3
cso	3
csp	3
csq	3
csr	3
csv	3
csw	3
csx	3
cta	难辞其咎
ctc	3
ctd	逘
cte	3
ctf	预算赤字
ctg	对我来说
cth	3
ctj	3
ctk	3
cts	3
ctt	牟利
ctw	对簿公堂
cty	双向交流
cub	3
cuc	3
cue	3
cuf	3
cuh	3
cuj	3
cuk	3
cul	3
cum	3
cun	3
cuo	3
cup	3
cuq	3
cur	3
cus	3
cut	3
cuu	3
cuv	3
cvd	3
cvf	3
cvg	3
cvh	3
cvi	3
cvj	3
cvk	3
cvl	3
cvm	3
cvn	3
cvo	3
cvp	3
cvq	3
cvr	3
cvs	3
cvt	3
cvv	3
cvw	3
cvx	3
cvy	3
cwc	难分难解
cwe	难办
cwf	难堪
cwg	对华政策
cwj	通俗易懂
cwk	通信员
cwl	3
cwn	难怪
cwq	难逃
cwr	通信兵
cws	3
cwt	难得
cwu	对华关系
cwv	鳮
cww	难保
cwy	难为
cxa	3
cxb	3
cxd	3
cxe	3
cxf	3
cxg	3
cxh	3
cxi	3
cxj	3
cxk	3
cxl	3
cxm	3
cxn	3
cxp	3
cxq	3
cxr	3
cxs	3
cxt	3
cxu	3
cxv	3
cxx	3
cxy	3
cye	3
cyh	3
cyo	3
cyq	3
cyu	能言善辩
cyy	㕚
daa	礷
dab	3
dad	大草原
dae	毻
daf	硬功夫
dah	在某些特殊情况下
daj	尤其是
dak	㚜
dal	百花园
dam	碤
dan	不甘心
dap	不切实际
daq	有其名而无其实
dar	成功的
dat	在某种程度上
daw	丰功伟绩
day	成功率
dba	3
dbc	太阳能电池
dbd	奇耻大辱
dbf	在职干部
dbg	不耻下问
dbh	㿴
dbk	3
dbl	3
dbm	大陆同胞
dbt	百孔千疮
dbw	大出风头
dcd	不能不
dce	髡
dcf	码元
dcg	不难理解
dch	䦊
dci	奋勇当先
dcj	3
dcl	䦉
dcn	雄心
dco	礮
dct	镺
dcu	厺
dcw	雄风
dcx	3
dcy	犮
dda	大蒜
ddb	大院
ddc	大通
ddd	大
dde	大脑
ddf	大夫
ddg	砺
ddh	大步
ddi	大潮
ddj	硕果
ddk	大路
ddl	大田
ddm	大同
ddn	大忙
ddo	大米
ddp	大军
ddq	在不久的将来
ddr	大气
dds	大概
ddt	大街
ddu	大门
ddv	大娘
ddw	大公
ddx	大纲
ddy	靥
dea	有节
deb	胡子
dec	不受欢迎的人
ded	有碍
dee	有力
def	有趣
deg	感受到
deh	龙腾虎跃
dei	不妥当
del	不加思索
den	有情
deo	有序
dep	戞
deq	有钱
der	有所
des	而且要
det	历程
deu	有意
dew	历代
dex	有缘
dey	有为
dfa	龙井茶
dfb	百无聊赖
dfc	奔驰
dfd	夸大
dfe	辰
dff	夳
dfg	砖瓦
dfh	夺目
dfi	硕士学位
dfk	辱骂
dfl	大无畏
dfn	刳
dfp	成才之路
dfr	压制
dfs	大规模的
dft	奔向
dfu	不过关
dfv	不过如此而已
dfw	压价
dfx	春雨绵绵
dfy	成都市
dga	厂区
dgb	咸阳
dgc	三台
dgd	石灰
dge	三月
dgf	感动
dgg	有一天
dgh	大开眼界
dgi	感染
dgj	硬是
dgk	厨
dgl	古田
dgm	古典
dgn	研发
dgo	三废
dgp	不一定
dgq	三角
dgr	感到担心
dgs	感想
dgt	
dgu	石头
dgv	三好
dgw	古代
dgx	三级
dgy	厂房
dha	在此基础上
dhb	存取
dhc	不对
dhd	彗
dhe	不力
dhf	破坏
dhg	戚
dhh	不肯
dhi	在学
dhj	不易
dhk	砧
dhl	还回
dhm	否则
dhn	不敢
dho	还应
dhp	在家
dhq	不久
dhr	破损
dhs	不要
dht	不管
dhu	破产
dhv	挈
dhw	存储
dhx	还给
dhy	不变
dia	磲
dib	硬汉子
dic	耛
did	有没有
die	大兴县
dif	耕地
dig	硄
dih	耚
dii	耥
dij	春光明媚
dik	3
dil	耕田
din	䎣
dio	大酒店
dip	不治之症
diq	3
dir	㼍
dis	感光材料
dit	大学生
diu	耗资
diw	不法分子
dix	耭
diy	成活率
dja	厚薄
djc	3
djd	不明不白
dje	嬮
djf	百元
djg	有鉴于此
dji	在野党
djj	成果鉴定
djk	3
djn	不明飞行物
djp	大显神通
djr	百年
djt	百科
dju	厚道
djw	百倍
dkd	大喊大叫
dkf	大中城市
dkg	有别于
dkh	大踏步
dki	右派
dkj	历史时刻
dkk	磾
dkl	有中国特色
dkm	奏鸣曲
dkn	有史以来
dko	3
dkq	3
dkr	不足挂齿
dkt	历史知识
dku	历史问题
dkv	3
dkw	历史悠久
dkx	历史纪录
dky	成品率
dlc	不畏艰苦
dld	三思而后行
dlf	奋进
dlj	3
dlk	硘
dll	礧
dlo	3
dlq	3
dlr	3
dls	硱
dlv	3
dlw	㎜
dlx	磥
dly	3
dma	布鞋
dmb	面子
dmc	原则通过
dmd	歪曲历史
dme	耐用
dmf	大幅增长
dmg	面颊
dmh	面目
dmj	面
dmk	3
dmn	耐心
dmo	面料
dmp	面容
dmq	而外
dmr	厕所
dmt	不同程度
dmu	不同意
dmw	面值
dmy	古典文学
dna	尤其
dnb	尮
dnd	盛大
dne	尨
dnf	雄心勃勃
dng	盛事
dnh	㝿
dni	大惊小怪
dnj	㞁
dnk	大飞跃
dnl	㞇
dnm	盛典
dnn	大局已定
dno	3
dnp	大展宏图
dnq	盛名
dnr	大屠杀
dns	不尽相同
dnt	成片
dnu	盛产
dnv	不怀好意
dnw	成份
dnx	成绩
dny	成熟
doa	矿藏
dod	三座大山
doe	不断胜利
dof	不断增强
dog	不断开辟
doh	3
doi	灰尘
don	不断改善
doo	灰烬
dor	矿泉
dot	矿长
dou	不断总结
dow	不断体现
doy	态度蛮横
dpa	不定期地
dpc	3
dpd	不寒而栗
dpf	有害无益
dpg	达到
dpi	大礼堂
dpj	大祸临头
dpk	在实践中
dpl	牵连
dpm	3
dpo	大家庭
dpp	不安定因素
dpq	不容忽视
dpr	有害的
dps	大案要案
dpt	有害物质
dpu	成家立业
dpv	3
dpw	在社会上
dpx	丰富经验
dpy	不容许
dqa	确切
dqc	3
dqd	古色古香
dqe	勀
dqf	砸锅卖铁
dqg	三角形
dqh	龙争虎斗
dqi	春色满园
dqn	有错必纠
dqo	大多数人的
dqp	布鲁塞尔
dqq	大锅饭
dqr	克制
dqs	3
dqt	大错特错
dqw	确信
dqx	3
dqy	确认
dra	有所区别
drb	压担子
drd	研制成
drf	原载
drg	原理
dri	原油
drj	不失时机
drl	成年累月
drm	原由
drn	爽快
drp	大年初一
drq	厄瓜多尔
drr	有所提高
drs	碑林
drt	原告
dru	原意
drw	原件
dry	原文
dsa	在本世纪内
dsc	奇观
dsd	大可不必
dsf	不相干
dsg	不可一世
dsh	不相上下
dsi	厅堂
dsj	奇景
dsk	剞
dsn	不可避免地
dso	存栏数
dsq	古树名木
dsr	不可抗拒
dss	不可想象
dst	在校生
dsu	大西北
dsw	不可逾越
dsy	不可言状
dta	三等功
dtb	故障
dtc	3
dtd	不知不觉
dte	䃑
dtf	面向未来
dtg	不利于
dth	故此
dti	不科学
dtj	寿星
dtl	磇
dtn	帮忙
dto	磻
dtp	面向社会
dtr	不知所措
dts	不得要领
dtt	不管怎样
dtu	故意
dtw	百科全书
dty	不知为什么
dua	雄姿英发
dub	确立了
duc	3
dud	奋斗历程
due	厚着脸皮
duf	有关规定
dug	磁带
duh	大半辈子
dui	不减当年
duj	成问题
duk	䂱
dul	破关斩将
dum	春意盎然
dun	碰壁
duo	奋斗业绩
dup	而立之年
duq	磁铁
dur	在新的一年里
dus	磸
dut	有关条款
duu	矿产资源
duw	三资企业
duy	在北京召开
dva	3
dvf	砕
dvg	不妨一试
dvh	3
dvi	大好河山
dvk	3
dvm	3
dvn	3
dvq	3
dvr	3
dvt	碯
dvu	不好意思
dvw	在群众中
dvy	不妨试试
dwa	夏令营
dwb	大个子
dwc	不仅能在
dwd	百货大楼
dwe	不舒服
dwf	成人教育
dwg	硷
dwh	胡作非为
dwi	泰
dwj	不仅是
dwk	大合唱
dwl	有偿转让
dwn	大会发言
dwp	存储容量
dwq	春色
dwr	大公报
dws	大体相当
dwt	‰
dwu	奉送
dwv	不但如此
dww	不仅仅是
dwx	大使级
dwy	碓
dxa	3
dxb	牵强附会
dxc	3
dxd	有张有弛
dxe	3
dxg	不绝于耳
dxi	龙江
dxj	大约是
dxk	不费吹灰之力
dxo	历经磨难
dxq	3
dxs	3
dxt	三级简码
dxu	成绩单
dxw	在编人员
dxx	䃈
dxy	龙
dya	有效期
dyd	不言而喻
dyf	大市场
dyg	太平
dyi	犬
dyj	不良影响
dyk	碠
dyl	䃶
dym	3
dyn	有效性
dyo	在主席台就座的有
dyp	成交额
dyr	不良反应
dys	有话要说
dyt	碎片
dyu	不良资产
dyv	硠
dyw	研讨会
dyy	在讲话中
eae	受苦受难
eaf	腜
eag	毁于
eaj	腊
eak	貙
eam	䐵
eaq	䐶
eat	3
eaw	㩓
eax	3
eay	㬻
ebd	采取不正当的手段
ebe	㔜
ebg	受聘于
ebj	3
ebl	3
ebm	貀
ebn	边防局
ebo	3
ebs	3
ebt	服役
ebu	边防前线
ebv	3
ebx	3
ecb	3
ecg	3
ecp	3
ecs	3
ecu	3
ecv	3
ecx	3
edc	胈
edd	脍不厌细
edf	采石场
edh	肧
edi	3
edk	3
edl	3
edm	媭
edn	䏵
edp	3
edu	䐻
edw	力不从心
edy	朋友遍天下
eea	月工
eee	劦
eef	月坛
eeg	月末
eei	䏮
eej	3
eel	3
eeq	腉
eer	胁迫
eet	月入
eew	月份
efc	胠
efd	頱
efe	肝胆
eff	胿
efh	虢
efi	悬壶济世
efk	脚跟
efl	3
efn	䏯
efq	肤色
eft	䐗
efu	边境冲突
efw	臛
egb	䢸
egc	胵
egd	助威
ege	脯
egf	县直
egg	受到表彰
egh	3
egi	悬赏
egj	腖
egk	脨
egl	3
egm	县内
egn	且慢
ego	助燃
egr	加速推进
egt	县长
egu	肺病
egv	䑖
egw	受到追究
egx	腈纶
eha	用功
ehb	3
ehc	鄋
ehf	用武
ehg	用来
ehh	臞
ehi	用光
ehk	用品
ehm	3
ehn	用心
ehs	3
ehv	3
ehy	用语
eib	3
eic	3
eid	3
eif	3
eih	3
eii	3
eik	3
eio	3
eis	3
eix	3
eiy	3
eja	3
eje	3
ejf	㦟
ejg	䑗
ejj	蠫
ejl	䝢
ejo	3
ejq	3
ejr	3
eju	3
ejv	3
ejw	3
eka	架式
ekb	䐕
ekc	驾驭
ekd	脱口而出
ekg	加班
ekh	贺卡
eki	加水
ekj	贺电
ekk	貚
ekm	贺岁
ekn	加剧
ekp	脚踏实地
ekq	3
ekr	架势
eks	架构
ekt	加长
eku	贺兰
ekw	加价
eky	贺词
elc	3
elf	爱国志士
elg	腲
elj	3
elk	3
ell	3
elm	3
elp	3
els	㬷
elv	貗
elx	䐯
ely	爱国主义教育
ema	悬崖勒马
emc	3
emd	貒
eme	3
emf	䫇
emg	璺
emi	3
emj	3
emo	3
emr	3
ems	3
emt	3
emu	3
emw	采购供应站
emy	3
ena	3
enc	3
end	胸怀大局
ene	3
eng	毁尸灭迹
enm	3
enn	加快发展
enp	3
enr	力气
ent	加以重视
enu	鼷
enw	爱憎分明
eny	臎
eoa	3
eob	3
eoc	3
eod	3
eoe	3
eog	3
eoh	3
eoi	3
eoj	3
eok	3
eol	3
eom	3
eop	3
eor	3
eos	3
eot	3
eox	3
epa	受宠若惊
epb	边陲
epc	受难
epd	腾空而起
epe	受用
epf	边境
epg	受理
eph	3
epj	3
epk	3
epl	爱祖国
epn	爱民
epo	3
epp	受审
epq	䏙
epr	爱护
eps	3
ept	3
epu	受奖
epw	受伤
epy	爱恋
eqe	彩色胶卷
eqf	3
eqj	彩色电视
eqk	胸口
eql	3
eqm	3
eqn	褜
eqo	边角废料
eqr	肳
eqs	3
eqt	3
equ	胸前
eqw	鶂
era	3
ere	遥遥
erh	䝖
eri	䏭
erj	3
erm	鹞
ero	3
erp	3
erq	乳白色
err	壆
ert	服兵役
erw	爱护公物
esa	3
esc	3
esf	彩霞
esj	采暖
esn	3
esr	彩扩
ess	腰酸
est	3
esu	膝盖
esw	采伐
esx	彩绘
esy	股票市场
eta	服务工作
etb	胣
etd	膖
ete	貈
etf	胜者
etg	胜于
eth	服务上门
eti	服务小姐
etj	服务电话
etk	服务器
etl	䝦
etn	服务性行业
eto	䐐
ett	服务行业
etu	服务站
etw	胜任
ety	服务市场
eua	脱落
euc	3
eud	媵
eug	膳
euh	3
euj	受益最大
euk	䏽
eum	3
eup	爱美之心
euq	脱销
eur	3
eus	3
eut	䐮
euw	膳食
euy	脱盲
eva	3
evb	3
evd	3
evf	妥协
evg	办好事
evh	3
evj	3
evm	3
evo	3
evp	3
evq	3
evs	3
evv	3
evx	3
evy	䏰
ewb	3
ewc	䐥
ewd	В
ewe	办妥
ewf	服从需要
ewg	办理
ewh	办卡
ewi	办法
ewj	3
ewk	3
ewl	3
ewn	爱人民
ewp	貌合神离
ewr	股价指数
ews	办公楼
ewt	股息
ewu	斞
ewv	䳎
eww	股份
ewx	в
ewy	助人为乐
exa	3
exc	3
exd	鷄
exg	腞
exj	胇
exm	3
exo	3
exq	3
exr	3
ext	边缘科学
exv	3
exx	䏶
exy	助纣为虐
eyb	膀子
eyc	3
eye	脑力
eyf	胶南
eyh	3
eyk	㬿
eyl	采访团
eym	3
eyn	舆论导向
eyr	用户手册
eys	3
eyt	脑筋
eyu	脉冲
eyw	肮
eyx	胘
eyy	舆论谴责
faa	示范基地
fab	3
fad	规范破产
fae	无功受禄
faf	⒘
fag	超薄型
faj	塻
fak	塸
fam	歕
fan	进攻性
fao	3
fap	靀
faq	墆
far	坑蒙拐骗
fas	塔楼
fat	无期徒刑
fau	霸道
fav	3
faw	示范作用
fay	霸主
fba	地基
fbc	3
fbd	无孔不入
fbe	地力
fbf	地域
fbg	地理
fbh	地上
fbi	䨡
fbj	地电
fbk	进出口公司
fbn	进取心
fbq	地狱
fbr	地势
fbs	垜
fbt	地毯
fbu	地道
fbv	3
fbw	地价
fby	地市
fca	去世
fcb	支出
fcc	走马观花
fcd	云龙
fce	运用
fcf	运载
fcg	动静
fch	却步
fci	云海
fcj	朅
fck	云贵
fcl	运转
fcm	3
fcn	动情
fcp	支农
fcq	㰦
fcr	去年
fcs	动机
fct	动物
fcu	云
fcv	刼
fcw	动作
fcx	动弹
fcy	动议
fda	朝三暮四
fdb	地面卫星接收站
fdc	垮台
fdd	震感
fde	需用
fdf	垮
fdg	坏死
fdh	赶不上
fdi	老太婆
fdj	却不是
fdm	颥
fdn	震慑
fdp	真不容易
fdr	未成年人
fds	老大哥
fdt	喜不自禁
fdu	城关
fdv	老大娘
fdw	坏人
fdx	震级
fdy	城郊
feb	䨗
fee	协办
fef	埓
feg	坥
fer	㙾
fes	埰
fet	协和
feu	南腔北调
fev	3
few	协作
fey	协商
ffa	二十七
ffb	运动队
ffc	鼓起勇气
ffd	塔吉克斯坦
ffe	墙脚
fff	土
ffg	二十一
ffh	埴
ffi	博士学位
ffj	刲
ffk	郌
ffl	违者罚款
ffn	雩
ffo	霊
ffp	填写
ffq	墙角
ffr	博士后
fft	土地管理
ffu	封闭
ffv	土建
ffw	堵住
ffx	㘽
ffy	土方
fga	寸草
fgc	干劲
fgd	二百
fge	十月
fgf	⑾
fgg	十五
fgh	雨
fgi	雨水
fgj	干旱
fgk	雨中
fgl	地形图
fgm	地球同步轨道
fgn	未来发展的
fgo	干粮
fgp	地下窝点
fgr	士兵
fgs	干校
fgt	博得
fgu	干净
fgv	干群
fgw	十佳
fgx	十强
fgy	坏事变好事
fha	起草
fhb	超出
fhc	直通
fhd	盐碱
fhe	雪上加霜
fhf	赶
fhg	趔
fhh	起步
fhi	起源
fhj	越是
fhk	走路
fhl	起因
fhm	赸
fhn	赳
fho	起火
fhp	起家
fhq	武钢
fhr	趋势
fhs	越权
fht	走私
fhu	武装
fhv	超群
fhw	趁
fhx	走红
fhy	真诚
fia	霮
fid	示威
fie	老少边穷
fif	违法者
fig	无济于事
fii	违法活动
fij	越洋电话
fik	老河口
fim	埫
fin	违法必究
fio	3
fip	未定
fiq	违法犯罪分子
fir	无法接受
fis	教学相长
fit	未知
fiu	示意
fiv	卖淫嫖娼
fiw	远洋货轮
fix	示弱
fiy	南海诸岛
fja	埋藏
fjb	进出
fjd	专题研究
fjf	埋
fjg	进来
fjh	坤
fji	埋没
fjj	进贤
fjk	朝中
fjl	塭
fjm	朝内
fjn	进发
fjp	越野赛
fjq	埋怨
fjr	坦白
fjt	进程
fju	进门
fjw	进修
fjx	蛓
fjy	坦率
fkb	郆
fkc	鼓足勇气
fkd	露面
fke	露脸
fkf	鼓起
fkg	喜事
fkh	墤
fki	嘉兴
fkj	去哪里
fkk	鼓噪
fkm	霣
fkn	趣味性
fko	喜庆
fkp	吉安
fkq	欯
fkr	吉凶
fks	㙅
fkt	进口税
fku	彭
fkv	夫唱妇随
fkw	进口货
fky	进口商品
fla	运输工具
flb	3
flc	3
fld	载有
flf	雷雨
flg	堽
fli	二连浩特
flj	顽固坚持
fll	㙼
flm	皾
flp	䢮
flr	3
fls	3
flt	雷射
flu	戴着
flw	地图集
fly	载文
fma	霻
fmd	坱
fme	塴
fmf	坝址
fmg	南开
fmh	远见卓识
fmi	南湖
fmk	3
fmo	3
fmp	南安
fmr	3
fmt	南和
fmu	南部
fmv	3
fmw	南华
fmx	南纬
fmy	坍
fna	专营
fnb	堀
fnd	声威
fnf	专款
fng	专心致志
fnh	韦
fni	声誉
fnj	场景
fnk	声响
fnl	卖国
fnn	圠
fnp	专案
fnq	声名
fnr	亏损
fns	亏本
fnt	声称
fnu	卖
fnv	㘲
fnw	磬
fnx	卖给
fny	卖方
fob	赤子
fof	䞕
fog	䞓
foh	赬
foi	无底洞
foj	㙻
fok	3
fol	3
fon	赮
fop	井底之蛙
foq	赥
for	无数的
fos	3
fot	螫
fou	㶣
fow	专业人才
foy	专业课
fpa	过期
fpb	鹁
fpc	3
fpd	真实感
fpf	过境
fpg	彀
fpi	过滤
fpj	过早
fpk	老字号
fpl	填补国内空白
fpn	索性
fpo	过火
fpp	填补空白
fpq	埦
fpr	幸福的
fps	坾
fpt	过重
fpu	过半
fpw	过分
fpx	专家组
fpy	无神论
fqa	远期
fqb	无限
fqc	寸金难买寸光阴
fqd	无不
fqe	元月
fqf	无声
fqg	无形
fqh	无非
fqi	无水
fqj	远景
fqk	坸
fql	无罪
fqn	均已
fqo	均应
fqp	无害
fqq	远销
fqr	均据
fqs	无权
fqt	无私
fqu	元首
fqv	埩
fqw	无人
fqx	顽强
fqy	远离
fra	老掉牙
frb	地质队
frc	直接对话
frd	亏损面
frf	十年规划
frg	无所事事
fri	喜气洋洋
frk	3
frl	墲
frn	直抒己见
fro	3
frp	零的突破
frr	地质年代
frt	无所适从
fru	支持单位
frw	直接领导
frx	直接经验
fry	无的放矢
fsa	吉木萨尔
fsb	3
fsd	丧权辱国
fse	3
fsf	载歌载舞
fsh	无可非议
fsi	南极洲
fsj	墰
fsm	3
fsn	3
fso	3
fsr	无可挽回
fss	栽树
fst	栽种
fsu	无可辩驳
fsv	㙘
fsw	䨫
fsx	无可比拟
fsy	霍林郭勒
fta	老式
ftb	进行了
ftc	考验
ftd	无私奉献
fte	雾
ftf	远程教育
ftg	都来
fth	老虎
fti	专利法
ftj	煮
ftk	载入史册
ftm	进行曲
ftn	进行改革
fto	真知灼见
ftp	老家
ftq	走私犯
ftr	专利技术
fts	教材
ftt	考入
ftu	老将
ftv	超乎寻常
ftw	都会
ftx	耄
fty	教育
fua	武装警察
fub	无产阶级革命家
fuc	3
fud	幸存
fue	武装力量
fuf	垃圾
fug	二次开发
fuh	培养目标
fui	增辉
fuj	超新星
fuk	无意中
ful	境界
fum	增删
fun	超前发展
fup	起决定作用
fuq	幸免
fur	干部制度
fus	老资格
fut	丧生
fuu	武装冲突
fuv	幸好
fuw	培养人才
fuy	增效
fvb	3
fvc	3
fvf	喜怒无常
fvg	垏
fvi	㙌
fvj	3
fvk	3
fvp	埐
fvq	3
fvs	3
fvx	封建统治者
fvy	雪亮
fwa	截获
fwb	十分陌生
fwc	真假难辨
fwd	堆砌
fwe	堆肥
fwf	辇
fwg	零下
fwh	无休止
fwi	十分注意
fwj	十分明确
fwk	堢
fwm	椝
fwn	十分必要
fwo	塔什库尔干
fwp	十分之
fwq	截然
fwr	干休所
fws	规格
fwt	十分重要
fwu	十分关注
fwv	坋
fww	夫人
fwx	墢
fwy	截
fxa	3
fxb	3
fxc	䨎
fxd	毐
fxi	无比兴奋
fxj	坲
fxn	㘭
fxo	3
fxq	3
fxw	增强信心
fxx	霛
fxy	戋
fya	教育工作者
fyc	堉
fyd	城市面貌
fyf	献计献策
fyg	地方政府
fyi	二话没说
fyj	无论是
fyk	壕
fyl	壈
fyn	教育改革
fyp	教育家
fyq	地方色彩
fyr	教育质量
fys	无计可施
fyt	地方税
fyu	教育部
fyv	教育群众
fyw	教育体制
fyx	城市经济
fyy	卖方市场
gaa	开工
gab	与世隔绝
gad	形态
gae	开采
gaf	开动
gag	刑事
gah	开战
gai	开水
gaj	刑
gak	型号
gal	开国
gam	开山
gan	开辟
gao	开凿
gap	正式宣布
gaq	开销
gar	开挖
gas	开枪
gat	开篇
gau	开阔
gav	开刀
gaw	开会
gax	开花结果
gay	正式访问
gbd	事出有因
gbf	3
gbg	击球
gbh	3
gbl	3
gbn	珠联璧合
gbo	3
gbq	3
gbr	3
gbs	3
gbu	3
gbw	击伤
gby	3
gca	㺹
gcb	到了
gcc	3
gcd	万马奔腾
gcf	致
gcg	至于
gch	到点
gci	死马当活马医
gcl	3
gcn	瑈
gcp	致密
gcq	玧
gct	天马行空
gcu	致意
gcv	3
gcw	到会
gcx	3
gcy	致谢
gda	⑦
gdb	环卫
gdc	天台
gdd	▼
gde	@
gdf	亚太地区
gdg	⑤
gdh	″
gdi	天堂
gdj	一大早
gdk	吞噬
gdl	□
gdm	天赋
gdn	天性
gdp	
gdr	『
gds	＼
gdt	①
gdu	正确道路
gdv	⑨
gdw	正确领导
gdx	‘
gdy	更有效地
gea	青草
geb	一肚子气
gec	䝌
ged	青春
gee	青县
gef	表露
geg	燹
geh	逋
gei	表演
gej	更加紧密地
gel	䀃
gem	青贮
gen	青翠
geo	青烟
gep	瑷
geq	青铜
ger	逐年
ges	青松
get	更加重视
geu	表决
gev	䝓
gew	两用人才
gex	青绿
gey	青州
gfa	平均工资
gfb	迈进了
gfd	一去不复返
gff	平均增长
gfg	五十万
gfh	一起上
gfi	表示满意
gfj	平均日产量
gfk	玩味
gfl	五十四
gfn	平均收入
gfo	天真烂漫
gfp	表示祝贺
gfq	一专多能
gfr	表示热烈欢迎
gfs	3
gft	再进行
gfu	表示决心
gfw	正规化
gfy	平均主义
gga	一世
ggb	一下子
ggc	一致通过
ggd	一大
gge	五月
ggf	一场
ggg	一下
ggh	一点
ggi	一举
ggj	一时
ggk	一路
ggl	一回
ggm	一致同意
ggn	一心
ggo	球迷
ggp	一字
ggq	玻璃钢
ggr	五年
ggs	琹
ggt	一条
ggu	一道
ggv	万事如意
ggw	一段
ggx	一线
ggy	一致认为
gha	正式
ghb	一目了然
ghc	下马
ghd	正确
ghe	下月
ghf	一些地方
ghg	鄢
ghh	羐
ghi	正常
ghk	下跌
ghl	政界
ghm	下山
ghn	下属
ghp	逐步完善
ghq	正名
ghr	下手
ghs	下榻
ght	下午
ghu	一些单位
ghv	逐步建立
ghw	弄虚作假
ghx	下级
ghy	正义
gia	表演艺术家
gib	救出
gic	3
gid	一尘不染
gie	政治力量
gif	求教
gig	逐渐形成
gii	救治
gij	救星
gil	政治思想
gim	求同
gin	政治局
gip	求实
giq	政治危机
gir	救援
gis	至少可以
git	求生
giu	政治关系
giv	珱
giw	政治体制改革
gix	政治经济学
giy	裘
gja	畱
gjc	下里巴人
gjd	亘古
gjf	更替
gjg	更正
gjh	瑁
gji	更少
gjj	更早
gjm	㻦
gjn	更改
gjp	䢋
gjq	更名
gjr	更迭
gjs	形影相吊
gjt	理科
gju	一星半点
gjv	表里如一
gjw	与日俱增
gjy	更为
gkb	事隔
gkc	开足马力
gkd	事态
gkf	逼真
gkg	整理
gkh	橐
gki	束
gkj	整日
gkk	逗号
gkl	带回
gkm	鬲
gkn	一鸣惊人
gko	整数
gkp	事宜
gkr	一口气
gks	事权
gkt	事先
gku	豌
gkw	事件
gkx	整编
gky	整齐
gla	3
glc	3
gld	珚
gle	3
glf	天罗地网
glg	画画
gli	一团漆黑
glj	3
glk	一连串的
gll	瓃
glp	两国之间
gls	3
glt	列车长
glu	画卷
glw	一连几天
gly	正因为这样
gma	下岗工人
gmb	现出
gmc	叀
gmd	现有
gme	两边
gmf	瑞士
gmg	珊瑚
gmh	刺眼
gmi	棘
gmj	曺
gmm	两岸
gmn	责怪
gmo	两广
gmp	再审
gmq	现金
gmr	现年
gms	两极
gmt	再造
gmu	现状
gmv	一见如故
gmw	璀
gmx	丙纶
gmy	郦
gna	与其
gnb	开辟了
gnc	3
gnd	平民百姓
gnf	政局动荡
gng	欤
gnh	瑂
gnj	开怀畅饮
gnl	3
gnn	玘
gno	3
gnr	玚
gns	3
gnt	恶性循环
gnu	恶性竞争
gnw	开展合作
gny	开发试验区
goa	亚东
gob	严防
goc	3
god	事业成功
goe	政府采购
gof	来者
gog	晋
goh	恶战
goi	亚洲
goj	严明
gok	来路
gom	开业典礼
gon	恶心
goo	恶魔
gop	政府官员
gor	来年
gos	政府机构
got	晋升
gou	政府间
gov	更应如此
gow	来华
goy	来讲
gpa	3
gpd	来之不易
gpf	一穷二白
gpg	现实表现
gpj	开宗明义
gpk	3
gpn	烈军属
gpt	副社长
gpu	天安门
gpw	一家人
gpy	事实说明
gqa	万荣
gqb	列出
gqc	万难
gqd	万古
gqe	劢
gqf	麸
gqg	死刑
gqh	㱜
gqi	列举
gqj	裂
gqk	青铜器
gql	列国
gqm	一针见血
gqn	残局
gqo	残废
gqp	列宁
gqq	裂解
gqr	万年
gqs	赘述
gqt	鳌
gqu	裂痕
gqv	残忍
gqw	殁
gqx	列强
gqy	列为
gra	碧蓝
grb	青年联欢节
grd	一拥而上
gre	3
grf	开拓者
grg	一年一度
grh	3
gri	珠江
grj	3
grk	一失足成千古恨
grl	青年团
grm	珤
grn	互换性
grp	一技之长
grq	一手包办
grr	来势凶猛
grs	3
gru	一年半载
grx	瓅
gry	事后诸葛亮
gsa	严格区分
gsc	3
gsd	膥
gsf	理想境界
gsg	一查到底
gsi	正本清源
gsj	严格监督
gsl	3
gsn	一相情愿
gso	3
gsq	3
gsr	严格控制
gss	互相配合
gst	╒
gsu	末端
gsv	3
gsw	互相合作
gta	麦苗
gtb	麦子
gtd	政策研究
gtf	严重地
gtg	正处于
gth	3
gtj	天长日久
gtk	一生中
gtl	政策界限
gtm	一般见识
gtn	一般性
gto	五笔数码
gtp	敷衍塞责
gtq	瓈
gtr	政策措施
gts	一盘棋
gtt	副处长
gtu	平等竞争
gtw	政务公开
gty	珠穆朗玛
gua	致闭幕词
gub	平陆
guc	副总参谋长
gud	郏
gue	瑐
guf	万美元
gug	平整
gui	平淡
guj	平日
guk	琣
gum	开门见喜
gun	平民
gup	事前审计
gur	青壮年
gus	慭
gut	平等
guv	㻩
guw	带头人
gux	副总编
guy	五颜六色
gva	巠
gvc	3
gvf	坙
gvg	珒
gvh	疌
gvm	3
gvp	一怒之下
gvq	3
gvr	3
gvt	珺
gvu	3
gvv	开始建立
gvw	一九八四年
gwa	珍藏
gwc	现代戏
gwd	与众不同
gwe	珍爱
gwf	现代教育
gwg	一件事
gwi	现代汉语
gwj	下个星期
gwk	一个中心
gwl	救命恩人
gwm	壐
gwn	责任心
gwo	3
gwp	万分之
gwq	一会儿功夫
gwr	五体投地
gwt	现代科学
gwu	更何况
gwv	一贫如洗
gww	现代化建设
gwx	环保组织
gwy	两个文明建设
gxd	正经历着
gxe	下级服从上级
gxf	天经地义
gxg	副经理
gxi	毒液
gxp	一纸空文
gxr	毒气
gxt	一贯重视
gxu	毒瘤
gxv	3
gxw	毒化
gxx	㼄
gxy	一贯主张
gya	开放区
gyb	下议院
gyc	斑驳
gyd	理论研究
gyf	一望无际
gyg	融为一体
gyh	玣
gyi	理论学习
gyk	恶语中伤
gyl	玉田
gym	玉雕
gyn	王永民
gyo	玉米
gyp	理论家
gyr	理论指导
gys	玉树
gyt	副市长
gyu	班次
gyw	副主任委员
gyx	玹
gyy	斑斓
haa	瞸
hab	3
hac	3
had	䁳
hae	虘
hag	遽
hai	3
hak	瞘
hal	勴
han	虚荣心
hao	戯
haq	
har	虚报
has	虨
hat	歑
haw	虚假
hax	虚幻
hay	㓺
hba	齰
hbd	䶢
hbf	￡
hbi	3
hbj	䶚
hbk	䶫
hbm	䶤
hbo	3
hbs	䶗
hbt	䶜
hbu	䶘
hbv	3
hbw	䶨
hbx	3
hcd	颇丰
hch	非驴非马
hcl	3
hco	3
hct	䀵
hcx	3
hcy	悲欢离合
hda	矋
hde	3
hdf	蜚声
hdg	歳
hdh	悲
hdi	非法
hdj	䁆
hdn	悲愤
hdo	3
hdp	3
hdr	3
hdt	非得
hdu	悲凉
hdw	悲伤
hdx	䋰
hdy	目不识丁
hea	3
hed	3
hee	3
hef	鼎力支助
hei	3
hek	3
hem	3
hen	3
heo	3
hep	瞹
hev	3
hew	3
hex	3
hey	3
hfa	3
hfb	3
hfc	眃
hfe	3
hff	䁱
hfg	3
hfi	眛
hfj	3
hfl	3
hfm	3
hfo	3
hfr	3
hft	旧地重游
hfv	3
hfw	睦邻
hfy	悲喜交集
hga	非正式会议
hgb	上限
hgc	上台
hgd	上面
hge	上边
hgf	上进
hgg	上班
hgh	眄
hgi	上海
hgl	上回
hgm	上岗
hgn	上届
hgo	上座
hgp	上家
hgq	上钩
hgr	上报
hgs	眜
hgt	上千
hgu	上前
hgw	督促
hgx	上下级
hgy	上交
hha	䁦
hhd	凹凸不平
hhe	3
hhg	频带
hhh	目睹
hhj	3
hhm	3
hhn	鼑
hhp	鷪
hhr	步兵
hht	步行
hhu	频道
hhw	氍
hhy	步调
hia	3
hic	3
hid	非常丰富
hie	睄
hif	3
hig	雌激素
hih	3
hii	非常清楚
hik	3
hip	矘
hir	非常抱歉
hit	非常重视
hiw	非常保守
hix	点滴经验
hiy	非常设机构
hja	上星期
hjc	3
hjd	旧有
hjf	卓越
hjg	睼
hjk	3
hjl	3
hjm	3
hjo	3
hjq	睗
hjr	3
hju	3
hjv	3
hjy	3
hka	战功
hkb	点出
hkd	此路不通
hke	睊
hkf	战场
hkh	瞆
hkj	㓠
hkl	战车
hkm	䁚
hkn	占尽
hko	点燃
hkq	点名
hkr	点播
hkt	战备
hku	点将
hkv	3
hkx	点缀
hla	3
hlc	3
hlf	战略协作伙伴关系
hlg	䁵
hlh	战略战术
hli	3
hlj	3
hlo	鹸
hlq	3
hlr	战略的
hlt	战略稳定
hlx	3
hma	㕟
hmb	3
hmc	3
hme	3
hmg	眮
hmh	3
hmj	3
hmk	3
hml	3
hmm	3
hmn	卨
hmo	3
hmq	3
hmr	3
hms	3
hmt	3
hmw	3
hmx	3
hnd	卢布
hne	3
hnf	3
hnh	睱
hni	県
hnj	3
hnl	3
hnn	䁕
hno	3
hnp	3
hns	3
hnw	矅
hny	3
hoc	3
hod	3
hoe	3
hof	3
hoh	3
hoj	3
hok	3
hol	3
hom	3
hon	3
hop	3
hos	3
hot	3
hou	3
how	3
hox	3
hpa	3
hpc	3
hpg	非军事化
hpi	3
hpk	3
hpm	3
hpo	3
hpp	3
hpr	3
hpu	3
hpx	3
hqa	睧
hqc	韰
hqe	3
hqg	3
hqh	睁眼
hqk	睌
hqm	战争赔偿
hqp	3
hqr	䀛
hqs	3
hqu	战争状态
hra	3
hrf	瞃
hrj	3
hrk	3
hrm	3
hro	3
hrr	䀿
hrs	3
hrv	3
hsa	3
hsb	3
hsc	3
hsd	3
hse	3
hsf	非机动车
hsi	3
hsl	3
hsm	3
hso	3
hsp	3
hsq	3
hsr	3
hsx	3
hsy	3
hta	3
htc	3
htd	䀱
htf	眊
htg	步入正轨
hth	矏
htj	3
htl	3
htq	3
hts	3
htv	3
hty	3
hua	3
hub	3
huc	3
hud	睠
hue	瞯
hug	瞤
hui	3
huj	虎头蛇尾
huk	3
hum	3
hup	3
huq	3
hur	目前的情况
huw	悲痛欲绝
huy	3
hva	3
hvb	3
hvc	3
hvd	3
hvf	3
hvi	睩
hvn	3
hvo	3
hvp	㱕
hvs	3
hvv	3
hvw	3
hwa	非公莫入
hwb	龋
hwd	非公有制经济
hwe	眕
hwg	睑
hwi	3
hwn	辪
hwp	具体安排
hwr	具体指导
hwu	具体意见
hwv	瞗
hww	具体做法
hwx	3
hwy	盼望
hxb	3
hxc	3
hxf	虚张声势
hxj	㫮
hxl	3
hxm	胔
hxq	紫金
hxr	矊
hxt	此处
hxu	此前
hxw	飺
hxx	䀝
hya	3
hyb	3
hyd	3
hye	3
hyf	3
hyh	3
hyi	3
hyj	3
hyk	䁁
hym	3
hyn	眿
hyo	3
hyp	3
hyq	3
hys	3
hyw	㱖
iaa	湛蓝
iab	江陵
iad	漭
iae	江边
iaf	汇款
iag	懑
iah	满眼
iai	灌溉
iaj	濗
iak	港口
ial	渵
iam	江山
ian	渠
iao	瀳
iap	潆
iaq	漠然
iar	光荣的
ias	灌木
iat	光荣称号
iau	汇总
iav	港九
iaw	汇集
iay	洪亮
ibb	小孩子
ibc	㵵
ibg	涉及到
ibi	涵洞
ibk	㴠
ibl	渎职罪
ibo	3
ibq	3
ibv	3
ibw	光阴似箭
iby	涵义
ica	汉墓
icb	汉阳
icc	㴉
icd	汉寿
ice	㳙
icf	涌进
icg	涌现
ici	治学
ick	汉川
icn	渘
icp	治军
ics	常驻机构
ict	涌向
icu	滩头
icw	治愈
icx	3
icy	汉语
ida	活在世上
idb	没有及时
idc	㳒
idd	泣不成声
ide	洧
idf	溽
idg	源于
idh	洊
idi	淹没
idj	学成归国
idk	㳓
idm	洏
idn	厳
idq	尚不多见
idr	堂而皇之
ids	深不可测
idt	激励和鼓舞
idu	湖北
idw	渥太华
idx	漫不经心
idy	兴奋剂
iea	湼
ieb	滥用职权
ied	光彩夺目
iee	逍遥
ief	浮动
ieg	浮现
ieh	㴞
iei	溪流
iej	揱
iek	㵑
ieo	3
iep	满腹牢骚
ier	满腔热忱
iet	淫秽
ieu	常胜将军
iew	肖像
iex	满腹经纶
ifa	法医
ifb	潮阳
ifc	潜能
ifd	满载而归
ife	漫无边际
iff	洼
ifg	滚雪球
ifh	滇
ifi	湖南省
ifj	当地时间
ifk	澍
ifl	瀻
ifm	法网
ifn	潜心
ifp	法案
ifq	潜逃
ifr	洁白
ifs	浅析
ift	潜艇
ifu	党支部书记
ifv	3
ifw	水土保持
ifx	流动红旗
ify	法郎
iga	举世
igb	涌现出
igc	洷
igd	＞
ige	溥
igf	举动
igg	清理整顿
igh	举止
igi	清洗
igj	光电
igk	濑
igl	举国
igm	漕
ign	泧
igo	辉煌
igp	清官
igq	辉
igr	滞后
igs	清醒
igt	清算
igu	清新
igv	湽
igw	誉
igx	光线
igy	光亮
iha	小区
ihb	波及
ihc	碆
ihd	濊
ihe	沾边
ihf	波动
ihg	淑
ihh	澁
ihi	泪水
ihj	濒临
ihk	涉足
ihl	小国
ihn	水上飞机
iho	小灶
ihp	婆家
ihq	涉外
ihr	波折
ihs	3
ihu	小将
ihv	婆媳
ihw	小伙
ihx	小费
ihy	小调
iia	浩浩荡荡
iib	淘汰了
iic	沧海桑田
iid	水泥厂
iie	水力
iif	水域
iig	消灭
iii	水泥
iij	水晶
iik	消遣
iil	水田
iim	湖光山色
iin	江泽民说
iio	光辉灿烂
iip	水害
iiq	水饺
iir	浓浓的
iis	清清楚楚
iit	裟
iiu	洋溢着
iiv	法治建设
iiw	水分
iix	水乡
iiy	消亡
ija	小时工
ijd	光明磊落
ijf	温馨
ijg	漫画
ijh	㴘
iji	混淆
ijj	浅显易懂
ijl	水旱轮作
ijm	濒临崩溃
ijn	温情
ijo	清晰度
ijp	㵃
ijq	渇
ijr	湿气
ijs	淉
ijt	漫长
iju	水电部
ijw	测量仪
ijx	水电费
ijy	渴望
ikd	3
ikf	港口城市
ikg	洖
ikh	潞
iki	3
ikk	湂
ikm	党中央领导下
ikn	3
ikp	3
ikv	3
ila	漍
ild	满园春色
ilf	畓
ilg	㳑
ili	少男少女
ill	灅
ilo	3
ilp	治国安民
ilq	3
ilr	壍
ilt	3
ilu	溿
ilw	溭
ily	渐变
ima	油菜
imd	尚不
ime	油腻
imf	滑坡
img	海峡两岸
imi	㴥
imj	江山易帜
imk	氅
iml	滑轮
imn	党内民主
imo	油库
imp	洞穴
imq	湍急
imt	滑稽
imu	注册资本
imv	3
imw	注册登记
imy	测评
ina	洗心革面
inb	汤阴
ind	深情厚意
ine	3
inf	泥土
ing	学以致用
inh	湑
ini	泥泞
ink	澼
inn	汛情
ino	3
inq	3
inr	漏气
ins	3
int	学习先进
inu	漏斗
inw	学习体会
iny	满怀豪情
ioa	淡雅
ioc	3
iog	灇
ioh	3
ioi	小康水平
iom	3
ion	少数民族地区
ioo	濙
iop	㴹
ior	海底捞月
iot	小康生活
iov	滽
iow	油料作物
iox	3
ioy	法庭调查
ipa	学期
ipb	学院
ipd	演奏
ipe	常用
ipf	浣
ipg	泻
iph	党龄
ipi	深深
ipj	学时
ipk	掌
ipl	深思
ipm	党内
ipn	党性
ipo	淀粉
ipp	沉寂
ipq	溶解
ipr	掌握
ips	学术
ipt	深入
ipu	党章
ipv	洝
ipw	沉
ipx	浓缩
ipy	演讲
iqa	温饱工程
iqb	3
iqd	洈
iqf	兴犹未尽
iqg	浑然一体
iqi	泡沫
iqk	洺
iqo	瀂
iqq	没多久
iqr	淘气
iqs	3
iqt	泖
iqu	汮
iqw	海外华人
iqy	汋
irb	掌握了
irc	派驻
ird	浠
irf	激增
irg	浜
irh	沠
iri	浙江
irk	派员
irl	泊车
irm	淛
irn	激情
irp	举手之劳
irq	溾
irr	举手投足
irs	3
irt	汽笛
irv	游手好闲
irw	激化
irx	小泉纯一郎
iry	党的方针
isa	清查工作
isd	学术研究
ise	添枝加叶
isf	河南
isg	没想到
isi	河水
isj	酒量
isk	酒吧
isl	学术团体
ism	河岸
isn	光杆司令
iso	河床
isq	3
isr	漂白
iss	潸
isu	当机立断
isw	学术会议
isy	漂亮
ita	水利工程
itb	洛阳
itd	鋈
ite	活力
itf	活动
itg	海事
ith	涎
iti	海水
itj	省时
itk	海口
itl	党和国家领导人
itm	海岸
itn	党委书记
ito	湫
itp	当务之急
itq	海岛
itr	海拔
its	流行歌曲
itt	省长
itu	水利部
itv	深入群众
itw	省份
itx	深入贯彻
ity	学生证
iua	洴
iub	涪陵
iud	浂
iue	洋县
iuf	学前教育
iug	润
iuh	3
iui	润滑
iuj	漳
iuk	滋味
iuo	湴
iuq	㶄
iur	沉痛的教训
ius	海关检查
iut	ˇ
iuu	兴冲冲
iuw	洋人
iux	省部级
iuy	洋房
ivb	汝阳
ivd	游刃有余
ivf	当地
ivg	当天
ivi	沼泽
ivj	当晚
ivk	当中
ivn	当心
ivp	当家
ivq	当铺
ivr	当兵
ivt	浸种
ivu	当着
ivv	水灵灵
ivw	当代
ivx	3
ivy	涉嫌诈骗
iwa	沿革
iwb	小分队
iwc	滃
iwd	沿袭
iwe	没用
iwf	法人地位
iwg	洽
iwh	滺
iwi	沿江
iwk	雀跃
iwl	3
iwm	浴巾
iwn	没收
iwo	党风廉政建设
iwp	淮安
iwr	学分制
iws	㳜
iwt	沿街
iwu	淮北
iwv	党风建设
iww	法人代表
iwx	沎
iwy	汄
ixd	3
ixe	泑
ixf	消费者协会
ixj	浪费时间
ixk	漒
ixo	3
ixp	3
ixr	3
ixt	小组第一
ixv	3
ixw	小组会
ixx	沘
iya	游艺
iyb	游子
iyc	鎏
iyd	兴衰成败
iye	㵝
iyf	流域
iyg	游击
iyh	流言蜚语
iyi	滚滚
iyj	浏览
iyk	小商品
iyl	澟
iyn	瀛
iyo	江主席
iyp	注定
iyq	温文尔雅
iyr	深刻的
iys	常设机构
iyt	游
iyu	滂
iyw	淤
iyx	滀
iyy	深刻认识
jac	3
jad	师范大学
jaf	暴雨
jag	归功于
jai	师范学院
jaj	蟆
jak	虹口
jal	蠴
jam	暪
jan	昛
jap	曚
jas	日薄西山
jat	暴行
jau	3
jav	蠨
jaw	蛊惑人心
jax	3
jbc	最难
jbd	时隔不久
jbe	朂
jbf	最坏
jbg	电子琴
jbi	电子学
jbj	时隐时现
jbm	曓
jbn	最迟
jbr	电子技术
jbs	3
jbt	最短
jbu	电子部
jbw	电子信息
jby	最为
jcb	3
jcf	竖起
jch	3
jci	3
jco	3
jcp	坚实
jcr	紧缺
jct	坚称
jcu	紧凑
jcv	3
jcw	紧邻
jcx	坚强
jcy	3
jda	曞
jdb	最大限度
jde	䗅
jdf	明确规定
jdg	蛎
jdh	暳
jdj	蝴蝶
jdk	3
jdl	3
jdm	蝡
jdn	晠
jdo	3
jdp	3
jdq	3
jdr	明确的
jds	明码标价
jdt	明确答复
jdu	蟟
jdv	3
jdw	螓
jec	3
jed	盟友
jeg	暖
jei	日月潭
jej	明晰
jel	㬭
jeo	明灯
jep	曌
jeq	蜺
jer	电脑技术
jet	暖和
jeu	电脑总公司
jew	电力供应
jey	明朗
jfa	时节
jfc	墅
jfd	里面
jff	旱地
jfg	时事
jfh	虷
jfi	时尚
jfj	早日
jfk	野味
jfn	旱情
jfo	㬨
jfp	时宜
jfq	里外
jfr	时势
jft	里程
jfu	时差
jfw	时候
jfy	时刻
jgd	旺盛
jge	晡
jgf	时来运转
jgg	是一致的
jgh	匙
jgj	早来晚走
jgk	曧
jgl	师团
jgm	昁
jgn	3
jgo	㬐
jgp	晴空
jgq	昜
jgt	旺季
jgu	暗下决心
jgv	㫸
jgw	师父
jgx	蝳
jgy	晴朗
jha	曥
jhd	㫵
jhe	冒用
jhf	冒进
jhg	㫔
jhh	蠷
jhj	申明
jhk	监督员
jhl	3
jhm	申购
jhn	曰
jhp	虫灾
jhq	畃
jhs	畅想
jht	毷
jhu	监督站
jhv	3
jhw	畅叙
jhy	申诉
jib	3
jih	3
jii	3
jik	3
jil	3
jin	3
jip	蟐
jiq	3
jis	3
jiv	3
jiw	㬁
jix	3
jja	电影节
jjb	电影院
jjd	昌盛
jjf	日趋
jjg	蛳
jjh	蝐
jji	曝光
jjj	日照
jjk	蚂蚁啃骨头
jjl	明显转变
jjm	电影周
jjn	电影剧本
jjp	暥
jjq	日销
jjr	明显提高
jjs	电影票
jjt	昌乐
jju	日美
jjw	日化
jjx	蜫
jjy	日记
jka	3
jkb	3
jkd	3
jkf	3
jkg	冔
jkk	䗭
jkl	3
jkn	3
jko	3
jkp	3
jku	3
jkw	3
jkx	3
jlb	3
jlf	曙
jlg	蠉
jlj	3
jlm	3
jln	3
jlo	3
jlp	3
jlu	3
jlv	3
jlw	归国创业
jlx	曪
jly	㬅
jmf	晭
jmg	日内瓦
jmh	帅
jmi	3
jmj	映照
jmk	3
jml	3
jmn	3
jmo	3
jmv	3
jmw	蠵
jmx	3
jnd	电厂
jnf	电场
jng	愚民政策
jnh	蝞
jni	电流
jnj	时快时慢
jnk	暐
jnn	㬆
jno	电炉
jnp	电容
jnq	电钮
jnr	电热
jns	电极
jnt	䖩
jnw	电传
jnx	电线
jny	电离
joa	蟅
jod	3
joe	3
jof	显赫
jog	曗
joj	时断时续
jok	3
jol	3
jom	3
joo	䗊
jop	3
joq	暽
jot	显微
jou	蠊
jov	㷖
jow	3
jox	3
joy	临床试验
jpa	电视艺术片
jpd	电视大赛
jpe	3
jpf	紧密地团结
jpg	蝖
jpj	电视电话
jpl	电视连续剧
jpn	监察局
jpo	蜂窝煤
jpp	3
jpr	坚定的信心
jps	紧密配合
jpt	电视系列片
jpv	㫨
jpw	晕倒
jpy	电视记者
jqa	晨钟暮鼓
jqd	紧急磋商
jqe	蜭
jqg	日久天长
jqh	遏止
jqi	晀
jqj	星岛日报
jqk	煦
jqm	㬇
jqn	蚫
jqo	䗇
jqq	昂然
jqr	最多的
jqt	歇息
jqu	昂首
jqw	曷
jqx	3
jqy	虳
jra	3
jrc	蛌
jrd	坚持原则
jrg	最后一次
jrh	螔
jrj	3
jrk	3
jrn	暣
jro	3
jrr	晣
jru	最后决议
jrv	3
jrw	畅所欲言
jsa	3
jsc	3
jsf	日本朝日新闻
jsg	归根到底
jsi	果酒
jsj	蟫
jsm	3
jsp	日本军国主义
jss	果木
jsv	3
jta	虴
jtd	蛞
jte	临县
jtf	最先进的
jtg	曛
jth	蚱
jti	临汾
jtj	临时
jtk	临别
jtl	螕
jtm	䖮
jtn	㫓
jto	星座
jtp	蜂窝
jtq	景德镇
jtr	临近
jts	最重要
jtt	临行
jtu	星移斗转
jtw	晚秋作物
jty	鉴
jub	坚决防止
juc	3
jud	日益丰富
jue	曨
juf	日益增多
jug	蜣
jui	暗淡
juj	暗暗
juk	时间跨度
jul	㬝
jum	3
jun	日益改善
jur	日益提高
jut	日益复杂的
juu	昂首阔步
jux	坚决纠正
juy	最新调查表明
jvd	最好成绩
jve	螁
jvf	蟰
jvg	归于
jvi	曃
jvj	晚婚晚育
jvk	归口
jvm	3
jvo	归类
jvp	㫶
jvq	3
jvr	照抄
jvs	归档
jvt	照片
jvv	3
jvw	归途
jwc	昖
jwd	坚信不移
jwf	电化教育
jwg	蜍
jwh	䗛
jwi	最低水平
jwl	3
jwm	3
jwn	螐
jwp	3
jwq	3
jwr	䗄
jws	3
jwt	明信片
jwv	蛜
jwy	蛉
jxd	坚强不屈
jxg	蝝
jxj	昲
jxk	3
jxl	3
jxo	3
jxs	3
jxu	坚强意志
jxv	3
jxx	歞
jyb	影子
jyc	㬚
jyd	イ
jyf	蠩
jyg	时刻表
jyi	い
jyj	蝙蝠
jyk	晾
jym	最高峰
jyn	电话局
jyp	时刻牢记
jyq	电话银行
jyr	螭
jys	最高标准
jyt	蝣
jyu	最高奖
jyv	㫰
jyw	最高人民法院
jyx	最高纪录
jyy	电话交换机
kaa	中医药管理局
kac	3
kad	哈萨克斯坦
kah	囕
kaj	唶
kak	中共中央政治局委员
kam	嗊
kan	呭
kao	3
kaq	㖴
kar	哄抢
kat	听其自然
kau	中共北京市委书记
kav	3
kaw	嗒
kba	3
kbb	吸附
kbd	3
kbg	吸毒
kbi	㖤
kbj	3
kbl	3
kbn	吸收
kbp	3
kbt	3
kbv	3
kbw	3
kbx	吸纳
kca	3
kcc	唱对台戏
kcd	3
kce	㗈
kcf	3
kcg	串通一气
kch	3
kci	3
kcl	3
kcm	3
kcn	㖻
kcr	3
kcs	3
kct	叹息
kcv	3
kcx	3
kde	哊
kdf	只不过
kdg	喴
kdh	呸
kdj	咟
kdm	喕
kdn	㕱
kdo	顺应
kdr	路不拾遗
kds	3
kdt	中顾委
kdu	噘
kdv	3
kdw	顺便
kdy	只有这样
kee	㗖
kef	喝彩声
keg	喛
kej	别是
kek	咀嚼
kem	3
keo	㘀
keq	别名
ker	另据
ket	别处
keu	3
kfa	跨越式发展
kfb	别无出路
kfc	呍
kfe	3
kff	吐露
kfg	鄙夷
kfh	唗
kfi	喷洒
kfj	唯才是举
kfk	嘭
kfo	另起炉灶
kfp	嚏
kfr	中老年人
kft	哮
kfu	哭丧着脸
kfw	别无他法
kfx	3
kgb	呈现出
kgd	顺理成章
kge	吴县
kgf	足球场
kgg	呈现
kgj	㖦
kgk	唔
kgm	听天由命
kgn	咓
kgp	忠于祖国
kgq	号角
kgr	呈报
kgt	号称
kgv	啑
kgw	吓倒
kgy	吁请
kha	躇
khb	路子
khc	跆
khd	跋
khe	啃
khf	趺
khg	遣
khh	踔
khi	中法
khj	踝
khk	跟踪
khl	中国
khm	跚
khn	跽
kho	蹼
khp	蹿
khq	跪
khr	中的
khs	︹
kht	踽
khu	踯
khv	躐
khw	跺
khx	呲
khy	踉
kia	3
kib	3
kic	3
kid	鄂温克
kii	中小学校
kil	3
kin	3
kio	3
kiq	3
kir	顺水推舟
kit	中学生
kiv	3
kiw	㘍
kix	3
kiy	3
kjd	3
kje	唱腔
kjf	嘢
kjg	㖷
kjo	3
kjp	3
kjq	顺时针
kju	喅
kjv	3
kjw	3
kkb	郘
kkc	串通
kkd	嚣
kke	哵
kkf	颚
kkg	吃喝玩乐
kkh	器具
kki	顺口溜
kkk	噪
kkl	口罩
kkm	
kkn	咄咄怪事
kkp	口福
kkq	口外
kkr	踊跃报名
kks	品格
kkt	串行
kku	口头
kkw	口令
kky	品评
kla	中国工商银行
kld	中国历史
klf	中国专利局
klg	中国政府
kli	中国汽车工业联合会
kll	中国国际贸易促进委员会
kln	中国民主同盟
klp	中国农工民主党
klq	啰
klt	中国特色
klw	中国人民银行
klx	中国统配煤矿总公司
kly	中国文学
kma	中央工作会议
kmd	啱
kme	中央办公厅
kmf	中央直属机关工作委员会
kmg	中央政治局
kmi	中央党史研究室
kmk	吊唁
kml	中央国家机关工作委员会
kmn	喎
kmp	中央军委主席
kmq	吊销
kmr	喘气
kmt	喘息
kmu	中央决定
kmv	3
kmw	呙
kmx	中央组织部
kmy	中央文献研究室
kna	吃尽苦头
knb	噉
kne	3
knf	叫声
kng	喔
knh	吜
knk	另辟蹊径
knn	噀
knp	3
knr	㗩
kns	3
knt	跃居第一
knw	中心任务
knx	叫绝
kny	唯心论
koa	嚝
koc	3
kod	3
koe	3
kof	3
kog	㗼
koj	3
kok	3
kol	3
kom	3
kon	3
koo	㘇
kor	3
kos	嚤
kot	3
kou	3
kow	3
kox	3
kpa	㘔
kpb	3
kpc	3
kpg	㗌
kph	3
kpi	3
kpj	3
kpk	鸣冤叫屈
kpm	3
kpo	3
kpp	3
kpr	3
kpt	哰
kpu	嘘寒问暖
kpw	听之任之
kpy	3
kqd	嘫
kqg	鸣锣开道
kqh	3
kqi	咷
kqk	哆嗦
kql	3
kqo	3
kqr	唿
kqt	兄长
kqw	吻合
kqy	吹遍
krd	顺手牵羊
krg	喤
krh	嗁
kri	史学
krj	3
krl	3
krm	嚹
krr	另据报道
krt	哄抬物价
krv	3
krw	中年人
kry	史诗
ksb	3
kse	3
ksg	呠
ksk	叮咛
ksn	3
kso	3
ksq	3
kss	呆板
kst	3
ksx	3
kta	吃苦
ktd	嘺
ktf	顺利进行
ktg	只身来到
kth	咋
kti	嗅觉
ktj	唎
ktk	呼叫
ktn	顺利发展
kto	跨行业
ktp	路透社
ktq	吃饱
ktr	吹牛拍马
ktt	吃香
ktu	唯物辩证法
ktw	中和作用
kty	响亮
kua	3
kuc	3
kud	啳
kuf	嗴
kug	咩
kuj	噇
kul	啴
kum	3
kun	
kuo	3
kur	3
kus	中关村科技园区
kut	喭
kuv	嗛
kuw	唥
kux	㘂
kvb	3
kvc	嘅
kvj	3
kvl	3
kvm	3
kvq	3
kvs	3
kvu	3
kvv	3
kvx	3
kvy	3
kwb	只限
kwc	吺
kwd	只顾
kwe	路途遥远
kwf	哙
kwg	噔
kwj	吤
kwk	喉咙
kwn	中华民族
kwo	3
kwq	哗然
kwr	㕮
kws	只要
kwt	只身
kwu	中俄关系
kwv	只好
kww	中华人民共和国主席
kwx	吪
kwy	唯
kxa	3
kxc	3
kxd	3
kxf	3
kxg	嚩
kxl	3
kxo	3
kxp	3
kxs	3
kxv	3
kxw	㖎
kxx	吡
kyd	3
kye	3
kyh	3
kyk	嚎
kyn	唳
kyo	3
kyp	3
kyt	只言片语
kyu	忠言逆耳
kyw	啐
kyx	噰
kyy	听说读写
laa	輚
lac	3
lae	3
lak	爴
lan	3
lao	轻工业产品
las	3
lat	3
lau	轥
lav	3
law	輁
lba	国际劳动妇女节
lbd	国际友人
lbf	国防教育
lbg	国际形势
lbi	男子汉
lbk	3
lbn	国际惯例
lbq	国际象棋
lbs	国际歌
lbt	国防科工委
lbu	国防部
lbw	国际合作
lbx	国际比赛
lby	国际交往
lca	轻巧
lcb	轰隆
lcc	轻骑
lcd	Γ
lcf	轻者
lch	3
lci	α
lck	軩
lcl	轻轨
lcn	畏难情绪
lcr	3
lct	轻微
lcu	3
lcv	3
lcw	轻信
ldb	转达了
ldc	䡌
ldd	国有大中型企业
lde	恩爱
ldf	略有增加
ldg	因素
ldh	囨
ldi	黑龙江省
ldj	因果
ldk	3
ldl	3
ldm	輭
ldn	恩情
ldp	固安
ldq	欭
lds	輢
ldt	轣
ldu	软硬兼施
ldv	3
ldw	国有企业改革
ldy	畎
leb	男队
lee	轁
lef	㽟
leg	罝
leh	3
lei	3
lej	3
lem	3
leo	3
lep	3
ler	㘥
les	3
let	男篮
lex	3
lfa	围攻
lfb	转子
lfc	黑马
lfd	四十三
lfe	置办
lff	园地
lfg	四十五
lfh	转眼
lfi	黑洞
lfj	黑影
lfk	转口
lfl	围困
lfm	黑山
lfn	转发
lfo	默
lfp	䡹
lfq	署名
lfr	黑白
lfs	转机
lft	转移
lfu	回过头来
lfv	四十九
lfw	黑人
lfx	转给
lfy	转为
lgb	国防
lgc	畏难
lgd	国大
lge	圃
lgf	国都
lgg	国画
lgh	囸
lgi	罪恶滔天
lgj	罪恶昭彰
lgk	睘
lgl	国界
lgm	輌
lgn	国民
lgo	国度
lgp	国宝
lgq	軏
lgr	车把
lgs	国格
lgt	国籍
lgu	车站
lgw	国人
lgx	3
lgy	国事访问
lhb	3
lhd	四百
lhf	罪过
lhg	四平
lhh	3
lhl	3
lhn	皿
lho	3
lhq	四角
lhr	3
lht	四千
lhv	3
lhw	圆桌会议
lia	3
lib	3
lid	因小而失大
lih	3
lik	3
lil	3
lim	3
lio	3
lip	疂
liv	3
ljb	3
ljc	3
ljd	3
lje	3
ljf	3
ljg	輰
ljh	3
lji	3
ljj	3
ljk	3
ljl	辒
ljm	3
ljn	3
ljo	3
ljr	3
ljt	3
ljv	3
ljw	3
ljy	3
lka	回敬
lkc	3
lkd	回春
lkf	回声
lkg	圆形
lkh	回眸
lki	回流
lkk	回响
lkl	圆圈
lkm	圆周
lkn	回避
lkr	回执
lkt	回复
lku	回音
lkv	3
lkw	四中全会
lky	回旋
lla	3
llb	轰轰隆隆
llc	3
lle	3
llf	轻轻地
llg	轰轰烈烈
lli	3
lll	逻辑思维
llm	3
llo	3
llq	3
llw	轀
llx	3
lly	圐
lma	3
lmc	3
lmd	Γ
lme	3
lmf	輖
lmg	略见一斑
lmh	䚑
lmi	3
lmj	3
lmk	3
lml	3
lmm	3
lmo	3
lmp	3
lmq	国内贸易
lmr	3
lms	3
lmu	国内首创
lmv	3
lmw	㽯
lmx	γ
lna	国民警卫队
lne	3
lnf	回忆起
lng	辅导班
lnk	䡶
lnm	3
lnn	囻
lno	3
lnu	图书资料
lnw	疁
lnx	思绪
lob	3
loc	3
loe	3
loi	3
lok	3
lol	3
lom	3
loo	3
lor	3
los	3
lot	3
lov	3
low	3
lox	3
loy	3
lpa	国家医药管理局
lpc	国家预算
lpd	置之不理
lpe	置之脑后
lpf	国家规定
lpg	连带
lpi	国家测绘局
lpk	国家另有规定
lpl	畹町
lpm	国家财产
lpn	连忙
lpp	国家安全部
lpq	国宾馆
lpr	国家技术监督局
lps	国家权力
lpt	国家重点
lpu	固定资金
lpv	国家建筑材料工业局
lpw	连任
lpx	国家经贸委
lpy	国家主席
lqa	軝
lqb	3
lqf	㝶
lqh	3
lqj	斀
lql	䡘
lqp	因名额有限
lqq	䡔
lqr	黯然失色
lqs	3
lqu	黑名单
lqv	3
lqw	软化
lqy	转危为安
lrc	罛
lrd	磛
lrf	暂无
lrh	覱
lrj	黑白电视机
lro	3
lrt	暂告
lrw	暂住
lry	3
lsa	恩格斯
lsb	3
lse	3
lsf	黔西南
lsg	思想政治觉悟
lsi	思想混乱
lsl	3
lsm	3
lsn	3
lso	3
lst	3
lsu	思想道德素质
lsw	思想修养
lsy	因材施教
lta	3
ltb	国务院总理
ltd	四处奔波
lte	輈
ltf	軞
ltg	置身于
lti	国务活动家
ltk	车牌号
ltl	罪行累累
ltm	因特网服务提供者
ltn	图片展
ltp	田径赛
ltq	图解
ltr	因私护照
ltt	略微
ltu	国务部长
ltw	国务会议
ltx	畮
lty	回答记者提问
luc	3
lud	圏
luf	3
lug	轙
lui	3
luj	罯
lul	㽪
lum	3
lun	3
luo	3
lup	3
luq	3
lut	轻音乐
lva	3
lve	3
lvf	男女老少
lvh	3
lvi	3
lvm	3
lvo	3
lvq	3
lvr	3
lvs	3
lvv	3
lvx	3
lwb	轮子
lwc	撃
lwd	因人而异
lwe	轮胎
lwg	软件开发
lwh	3
lwi	输液
lwj	四个坚持
lwl	软件园
lwm	3
lwn	软件展览会
lwo	固体燃料
lwp	团体冠军
lwr	输掉
lwt	轮船
lwu	输送
lww	輍
lwx	界线
lwy	国会议员
lxa	3
lxd	连续不断
lxf	累进
lxg	团结与合作
lxi	软弱涣散
lxj	3
lxm	3
lxo	3
lxp	3
lxr	3
lxs	3
lxt	团结和带领
lxv	3
lxw	团结合作
lxx	团组织
lya	3
lyd	图谋不轨
lyf	较远
lyg	軴
lyh	3
lyj	较早
lym	3
lyn	甿
lyo	3
lyq	男主角
lyr	䍠
lys	3
lyt	较重
lyu	䍤
lyv	䡙
lyw	回旋余地
lyx	圝
maa	曲艺
mac	3
mad	内蒙古
mae	3
maf	䝸
mag	艶
maj	㟙
mal	3
mam	同工同酬
man	岠
mao	3
map	典礼
maq	嶜
mas	3
mat	迪斯科
mav	3
maw	敟
may	㟐
mba	3
mbc	3
mbe	3
mbf	3
mbg	同出一辙
mbh	郥
mbl	3
mbn	邮戳
mbo	3
mbq	㟹
mbt	嶐
mbv	3
mcc	㠁
mce	3
mcf	3
mch	3
mcj	3
mcl	3
mcn	3
mco	3
mcp	3
mcq	3
mcr	3
mct	3
mcu	3
mcv	3
mcx	3
mdc	3
mde	峟
mdf	崖
mdg	央求
mdh	岂有此理
mdi	岩洞
mdk	3
mdm	贿赂
mdn	岂不怪哉
mdp	央视
mdq	䒋
mdr	㟲
mds	㟢
mdt	见不得人
mdu	嶛
mdv	3
mdw	賰
mea	䯦
mec	3
med	骨灰
mee	剻
mef	骨干
meg	嵈
meh	髗
mej	䯜
mem	骨肉
men	䯌
mep	髌
meq	骲
mer	骺
met	财力物力
meu	髊
mev	㟎
mew	骪
mex	䯚
mey	髇
mfb	3
mfd	冄
mfe	骨干力量
mff	周刊
mfg	周到
mfh	巅
mfi	周游
mfj	3
mfk	周口
mfl	财团
mfn	䎃
mfo	3
mfp	财神
mfq	崁
mfr	周折
mft	财务
mfu	崭露头角
mfv	3
mfw	财会
mfy	赋诗
mga	由于某种原因
mgc	峌
mgd	由下而上
mge	同胞
mgf	财政赤字
mgg	财政政策
mgh	同龄
mgi	同党
mgj	同盟
mgk	戙
mgn	同情
mgo	同业
mgp	贩毒案
mgq	财政负担
mgr	财政年度
mgs	同档
mgt	由于种种原因
mgu	财政部
mgw	峡谷
mgx	同乡
mha	网上营销
mhb	由此及彼
mhc	帊
mhd	由此而
mhe	㡥
mhf	帐款
mhg	由于
mhh	帔
mhi	㠺
mhj	幔
mhk	帜
mhn	贝
mho	贝类
mhp	帵
mhq	㡄
mhr	贴近
mhs	帐本
mht	帐篷
mhu	帐单
mhw	同龄人
mhy	网上交易
mib	3
mic	3
mih	3
mil	3
mio	3
miq	3
mir	3
mis	3
miw	巀
mix	3
miy	3
mjd	囬
mje	3
mjg	崵
mjh	赗
mjk	3
mjl	3
mjq	嵑
mjr	3
mjs	3
mjy	3
mka	3
mkc	3
mke	3
mkf	3
mkj	3
mkk	嵓
mkl	3
mkm	3
mkn	3
mko	3
mks	3
mkt	3
mkv	3
mkx	3
mky	3
mla	3
mlb	3
mlc	3
mle	3
mlf	3
mlg	嵔
mlh	㠑
mli	3
mlm	3
mlo	3
mlp	3
mlq	3
mls	3
mlt	3
mlx	3
mly	3
mma	删节
mmb	崎岖险阻
mmc	3
mmd	㟨
mme	山腰
mmf	山坡
mmg	删
mmi	山河
mmk	山口
mml	3
mmm	崇山峻岭
mmq	鑍
mmr	山泉
mms	山顶
mmu	删减
mmv	䨉
mmw	山风
mmy	岗亭
mnb	崛
mnd	崌
mnf	嶎
mng	㟃
mnh	岂止
mnm	峨眉山
mnn	同情心
mnp	3
mnu	3
mnw	觊觎
mny	同性恋
mob	3
moc	3
mod	3
moe	3
mof	賍
mog	贌
moh	3
moi	3
moj	3
mok	3
mol	3
mom	3
mop	3
mor	3
mov	嵻
mox	3
moy	3
mpc	3
mpd	贮存
mpe	3
mpf	賩
mph	3
mpi	山穷水尽
mpm	3
mpn	3
mpr	同室操戈
mps	3
mpt	㟉
mpu	周密部署
mpw	财神爷
mpy	赈灾义演
mqa	嵥
mqb	觃
mqd	迥然不同
mqe	嶰
mqg	岁末
mqi	3
mqj	賯
mqk	巉
mqn	翙
mqp	3
mqq	内外勾结
mqs	3
mqt	见长
mqu	赡养
mqx	3
mqy	见证
mrb	嵏
mrd	网友
mre	3
mrf	贩卖
mrg	贩毒
mrh	网点
mri	网游
mrj	网易
mro	3
mrq	㟴
mrr	羀
mrs	3
mru	刚毅
mry	3
msb	3
msc	3
mse	3
msg	3
msh	3
msl	3
msm	3
msn	3
mso	3
msp	3
msu	3
msx	3
mtd	见物不见人
mtf	败露
mth	岞
mtk	峈
mtm	嶶
mtn	败局
mtr	财务报表
mtt	财务科
mtu	内务部
mtv	嵂
mtw	贬低
mty	见利忘义
mua	䑃
mue	贚
muf	赠款
mug	内部事务
muh	3
mui	3
muk	嵜
mul	嶒
mum	3
muq	胊
mus	同病相怜
mut	嵼
muu	膧
muv	嵰
muw	网站信息
mux	财产继承
mva	3
mvb	3
mvc	3
mvd	3
mvf	3
mvh	3
mvj	3
mvm	3
mvn	3
mvo	3
mvp	3
mvq	3
mvs	3
mvu	3
mvv	3
mvw	3
mvx	3
mvy	岃
mwa	内蒙
mwd	内耗
mwe	䝩
mwf	岗位培训
mwg	内政
mwh	峜
mwi	内河
mwk	冏
mwm	朙
mwn	内情
mwp	岗位补贴
mws	3
mwt	内向
mwu	内阁
mwv	嶌
mww	内含
mwx	㟆
mwy	岑
mxb	3
mxc	3
mxd	3
mxf	网络教育
mxm	3
mxn	3
mxo	3
mxs	3
mxt	网络知识
mxu	嵶
mxx	财经纪律
mya	䵊
myg	崇高事业
myh	3
myi	3
myj	峕
myk	崇高品质
myl	3
myn	峐
myp	3
myq	3
myr	崇高的理想
mys	3
myu	嵭
myw	峧
naa	民营
nad	愖
nae	民用
naf	民进
nag	改革开放
nah	㤉
nai	民法
naj	惜
nak	民革中央
nal	民国
nam	愩
nan	民情
nao	3
naq	憯
nar	改革措施
nas	异样
nat	民航
nau	惬意
nav	心花怒放
naw	民众
nax	慌张
nay	民主
nbb	那阵子
nbd	屈辱
nbg	以防万一
nbi	3
nbj	3
nbl	3
nbm	㤕
nbn	尽职尽责
nbo	3
nbp	3
nbq	3
nbt	饏
nbu	3
nbv	3
nbx	3
nca	3
ncb	3
nce	悀
ncg	怪事
nch	3
ncl	3
ncn	忬
nco	3
ncq	3
ncr	惨白
nct	恈
ncx	3
ncy	慅
nda	墯
ndb	民不聊生
ndc	恨不能
ndd	怀有
nde	㤢
ndf	剧增
ndg	剧烈
ndh	剧目
ndi	3
ndj	㤿
ndk	怀中
ndm	愐
ndn	剧情
ndq	居留
ndr	慡
nds	书面材料
ndt	剧种
ndu	心灰意冷
ndw	怀化
ndy	书面讲话
nec	3
nee	慆
neg	怚
nel	3
neo	3
nep	㥅
ner	尼加拉瓜
net	必须符合
neu	民用产品
nev	3
new	㥚
nex	必须统一
nfa	发动攻势
nfc	恸
nfd	迅雷不及掩耳
nfe	3
nff	迅雷
nfg	收支平衡
nfh	买壳上市
nfi	尉
nfk	心直口快
nfn	怯声怯气
nfo	㷉
nfp	屠宰
nfq	避雷针
nfr	迅捷
nft	导航
nfu	层次
nfv	迅即
nfw	发起人
nfx	层级
nga	以毒攻毒
ngb	发表了
ngc	剭
ngd	情愿
nge	以理服人
ngf	发表声明
ngg	情形
ngh	心理上
ngi	恒温
ngj	那是
ngk	悟
ngm	慒
ngn	情怀
ngo	3
ngp	民事案件
ngq	慠
ngr	情操
ngs	屋顶
ngt	以下简称
ngu	民政部
ngw	以下几点
ngx	民事纠纷
ngy	情谊
nha	疏散
nhb	郿
nhc	叏
nhd	奘
nhf	收款
nhg	以点带面
nhi	疏漏
nhj	疍
nhk	收听
nhl	㿿
nhn	收买
nhp	眉宇
nhq	收留
nhr	收看
nht	收盘
nhu	丑闻
nhw	悼念
nhx	收缴
nhy	悼词
nia	3
nib	3
nie	以少胜多
nig	情溢于表
nii	心潮澎湃
nik	3
nil	劚
nin	屁滚尿流
nio	3
nip	戃
nit	犀利
niu	心满意足
niv	3
niw	3
niy	3
njb	3
njd	展览大厅
njf	发明专利
njg	愓
njk	劈里啪啦
njl	慢车
njm	㦙
njo	3
njp	展览室
njq	尼日尔
njv	3
njw	那时候
njy	㥗
nka	韎
nkc	避难
nke	悁
nkg	悜
nkh	翀
nkk	㦍
nkl	3
nkm	愪
nko	3
nkp	3
nks	3
nku	辟
nkx	3
nlb	3
nlc	3
nlf	3
nlg	懁
nlh	3
nli	3
nlj	3
nll	3
nlm	3
nln	忧国忧民
nlo	3
nlq	3
nlt	3
nmb	3
nmc	3
nmd	怏
nmi	届满
nmj	届时
nmk	3
nml	3
nmn	以邮戳日期为准
nmo	3
nmq	3
nms	3
nmt	3
nmu	收购站
nmv	3
nmw	已见分晓
nmx	3
nna	居民区
nnb	局限
nnc	3
nnd	书面
nne	心惊胆战
nnf	发展过程
nng	巳
nnh	发展战略
nni	发展潮流
nnk	发展史
nnl	发愤图强
nnm	屡屡见诸报端
nnn	已
nnq	尽快解决
nnr	书报
nns	发展机会
nnt	快乐
nnu	发展前景
nnv	忧心如焚
nnw	尸体
nnx	发展经济
nny	书记
nob	3
noc	3
noe	3
noj	3
nok	3
nol	3
nom	3
non	慵懒
nop	3
noq	3
nor	3
not	3
nov	慵
npa	3
npb	3
npd	悔之不及
npf	悰
npg	愃
npi	3
npk	3
npl	翚
npn	懧
npo	3
npr	3
npt	㤞
npu	3
npv	3
npw	悾
npx	3
nqa	惛
nqd	恨铁不成钢
nqf	飞针走线
nqg	必然王国
nqh	3
nqj	惸
nqk	悗
nql	3
nqn	怉
nqr	以怨报德
nqs	3
nqw	局外人
nqy	㣿
nrb	惾
nrd	屈打成招
nre	3
nrg	屈指一算
nrl	3
nrn	惶惶
nro	3
nrp	3
nrr	懫
nrs	发挥模范作用
nrt	情势升高
nru	情投意合
nrv	3
nrw	发挥余热
nry	憿
nsb	3
nsc	尽可能多的
nsd	心术不正
nse	3
nsf	慓
nsg	㤓
nsk	3
nsl	3
nsm	3
nsp	3
nsq	3
nsr	飞机制造
nss	惏
nsu	3
nsv	3
nsw	3
nsx	3
nta	发芽
ntb	发生了
ntc	改观
ntd	发达
nte	改用
ntf	忏
ntg	发表
nth	覕
nti	发觉
ntj	发明
ntk	飞行员
ntl	发黑
ntm	发自内心
ntn	性情
nto	发烧
ntp	恪守
ntq	发包
ntr	性质
nts	性格
ntt	改造
ntu	必将
ntv	异乎寻常
ntw	发货
ntx	发给
nty	发言
nua	屏蔽
nub	悦耳
nud	买
nue	㥞
nuf	局部地区
nug	羼
nui	情况汇报
nuj	翌日
nuk	慰问品
nul	以美国为首的
num	3
nun	习性
nuo	3
nur	飞舞
nus	买票
nut	飞往
nuw	层次分明
nux	刷新纪录
nuy	买主
nvb	3
nvd	敢怒而不敢言
nvf	㦎
nvh	3
nvi	䎑
nvj	3
nvm	3
nvo	3
nvq	3
nvr	3
nvu	3
nvv	心如刀割
nvx	3
nvy	㞍
nwa	惟恐
nwc	慃
nwd	以公有制为基础
nwe	尽全力
nwf	㤔
nwg	居住环境
nwh	3
nwi	恰当
nwm	3
nwn	愉悦
nwo	3
nwt	居领先地位
nwv	翂
nww	收信人
nwy	戳
nxb	㥝
nxc	3
nxd	已经成熟
nxe	怮
nxg	已经形成
nxj	恉
nxk	3
nxl	3
nxm	3
nxo	3
nxp	惊弓之鸟
nxq	3
nxr	3
nxs	3
nxu	已经决定
nxw	䲿
nxx	悂
nxy	惤
nya	民族区域自治
nyb	以防
nyc	㥔
nyd	忙碌
nye	心爱
nyf	心声
nyg	心理
nyh	以此
nyi	民主党
nyj	尽量
nyk	心中
nyl	心思
nyn	尽快
nyo	心底
nyp	心窝
nyq	民族独立
nyr	民族振兴
nys	心想
nyt	以往
nyu	以前
nyv	民主建国会
nyw	悴
nyx	翠绿
nyy	以为
oad	迷惑不解
oae	糤
oaf	烘干
oag	烧死
oah	熞
oai	炼油
oaj	度日
oak	煂
oal	㢜
oam	懬
oan	庹
oao	鹧
oap	䢠
oaq	廗
oar	遮掩
oas	3
oat	糒
oau	遮盖
oav	3
oaw	烧伤
oay	3
obc	3
obd	3
obe	3
obi	3
obj	3
obk	3
obl	3
obo	3
obp	3
obq	3
obr	3
obt	3
obu	3
obv	3
oby	3
ocb	3
occ	3
ocf	3
och	3
ocj	3
ock	㷘
ocl	3
ocn	糅
oco	3
ocp	3
ocq	3
ocr	3
ocs	3
ocu	3
ocv	3
ocx	3
ode	庆贺
odf	庆幸
odg	粝
odh	緳
odi	糊涂
odj	粨
odk	糊口
odl	3
odm	煗
odn	庬
odp	庆安
odr	类推
odw	广大人民
odx	精耕细作
ody	广大市民
oec	3
oee	熁
oeg	㡹
oeh	㷔
oek	3
oel	粗略
oem	3
oen	廫
oet	粗重
oev	3
ofb	3
ofc	廅
ofd	应运而生
ofe	3
ofg	断垣残壁
ofh	座无虚席
ofj	3
ofk	糦
ofm	䊖
ofn	䊭
ofo	焃
ofr	3
ofs	3
oft	庄重
ofv	3
ofw	廧
oga	精工
ogb	庄严承诺
ogd	精矿
oge	精彩
ogf	㡰
ogj	烜
ogk	炊事员
ogl	3
ogm	精髓
ogn	精辟
ogo	精炼
ogt	精选
ogu	黼
ogw	数理化
ogx	业经
ogy	精诚
oha	㢚
ohb	3
ohc	3
ohf	3
ohg	3
ohk	店员
ohn	3
oho	3
ohq	爘
ohr	3
ohs	3
ohu	3
ohv	3
ohw	3
oic	应允
oie	炒股
oif	烟消云散
oii	广泛深入地
oij	广泛影响
oik	3
oil	3
oin	应届
oir	应按
oit	－
oiv	3
oiw	炒作
oix	3
oiy	应变
oja	熚
ojc	3
ojf	粗暴干涉
ojg	煶
oji	㎜
ojk	3
ojl	䊡
ojo	火里业头四点米
ojp	3
ojt	煋
ojw	3
ojx	㡼
oka	3
okc	3
okd	3
okh	3
oki	3
okj	3
okk	煰
okl	3
oko	3
okp	3
oks	3
okt	3
oku	3
okv	3
okx	3
ola	廙
olb	3
old	煾
olf	燡
olg	糫
olj	3
olk	烟叶
olm	3
olq	3
olw	熅
olx	3
oma	粬
omb	3
omc	3
omd	炴
omg	烔
omi	3
oml	3
omq	3
omr	3
oms	3
omv	3
omw	庙会
ona	3
onb	煀
onc	3
ond	粗心大意
onf	籸
ong	断开
onh	废止
oni	断流
onj	麝
onk	廦
onm	3
onn	㷷
ono	炒买炒卖
onp	精心安排
onr	炀
ont	数以千计
onw	数以亿计
onx	断绝
ony	废弃
ooa	火药
oob	㷥
ood	炎夏
oof	粧
oog	爜
ooh	煔
ooi	火海
ooj	糖果
ook	3
oon	火情
ooo	火炬
oop	嫈
ooq	䢯
oor	炎热
oot	爆炸物
oou	火辣
oov	焿
oow	鶑
oox	断断续续
ooy	腐烂变质
opa	精神世界
opb	3
opd	爎
opf	精神支柱
opg	熔融
opi	精神污染
opo	熔炼
opp	迷宫
opq	㶩
opr	精神抖擞
ops	䊉
opu	精神准备
opv	3
opw	迷信
opy	迷恋
oqa	遴
oqb	煼
oqc	3
oqe	底肥
oqg	炊事
oqi	烑
oql	3
oqn	底层
oqo	底座
oqp	3
oqq	广角镜
oqr	灼热
oqs	3
oqt	底片
oqv	3
oqw	䶴
oqy	熘
orb	糉
orc	炍
ord	应邀而来
ore	3
org	数据更新
orj	广播电影电视部
orl	㷻
orp	3
orr	3
ort	数据管理
orv	3
orx	廐
ory	广播讲座
osa	3
osb	3
osf	熛
osg	庮
osh	烞
osi	灯泡
osm	3
osn	3
oso	糜烂
osp	3
osr	摩托
oss	摩
osu	床头
osw	灯会
ota	灹
otb	粚
otd	熢
otf	烍
otg	炸死
oth	糗
oti	业务学习
otj	3
otl	熜
oto	熄火
otq	熪
ott	业务科
otu	庝
otw	庄稼人
otx	䊈
oty	秌
oub	㡿
ouc	3
oud	麻痹大意
oue	精疲力竭
oug	烊
oui	烂泥
ouj	糡
oum	3
oup	3
ous	煪
out	3
ouu	火辣辣
ouv	熑
ouw	熌
ovc	3
ove	数月
ovf	熽
ovg	煡
ovh	鄌
ovi	唐海
ovn	3
ovp	数九寒天
ovq	3
ovr	数年
ovs	3
ovt	数千
ovv	3
ovw	数值
owa	3
owc	炈
owf	烩
owg	廥
owi	鹰潭
owj	炌
owk	3
own	粮食局
owp	3
owq	㢋
ows	度假村
owt	唐人街
owu	座次
owv	䲴
oww	膺
owx	粉丝
owy	粘合剂
oxa	3
oxb	3
oxc	3
oxf	3
oxg	3
oxi	颣
oxl	3
oxm	3
oxn	3
oxo	3
oxp	3
oxq	3
oxs	3
oxx	煯
oxy	3
oyd	应该成为
oyf	煽动
oyg	广平
oyi	炫耀
oyk	煷
oyl	精诚团结
oyn	庐
oyo	粮店
oyr	㷰
oys	粮票
oyt	废弃物
oyu	粮站
oyv	烺
oyw	粮食
oyy	广州
paa	社区工作
pab	宽限
pad	宽厚
paf	视若无睹
pah	宧
pai	寒流
paj	寒暑
pan	社区发展
pap	宽窄
par	安营扎寨
pas	宽松
pat	寒冬
pau	赛前
paw	塞
pba	字幕
pbe	3
pbf	实际增长
pbg	字画
pbo	3
pbp	3
pbr	空降兵
pbt	突出重点
pbu	实际意义
pca	3
pcc	3
pcd	客观原因
pce	3
pcf	客观真理
pcj	3
pcl	3
pcm	3
pcn	客观情况
pcq	3
pcs	3
pcv	3
pcw	3
pcy	宏观调节
pda	3
pdc	寄予
pdd	富有成效
pde	宠爱
pdf	宸
pdh	豁
pdi	3
pdl	寕
pdm	3
pdn	害己
pdq	豁免
pdr	被压迫民族
pds	牢不可破
pdt	寄往
pdu	冤大头
pdw	害人
pdy	寄主
pea	农艺
pec	3
ped	农历
pef	农运
peg	实用型
pei	宜兴
pej	宜昌
pem	3
pen	军用飞机
pep	农安
peq	冩
pes	农林
pet	农用物资
peu	实用新型专利
pev	农妇
pew	军用侦察机
pey	神采奕奕
pfc	3
pfd	穿云破雾
pff	神魂颠倒
pfg	完事
pfi	完满
pfj	宑
pfo	3
pfp	䢘
pfq	寇
pfs	3
pfu	完美
pfw	守信
pfx	完结
pfy	空城计
pga	军事基地
pgb	写了
pgd	写成
pge	家用
pgf	家教
pgg	定型
pgh	定点
pgi	室温
pgj	家里
pgk	宝贵
pgl	军事思想
pgm	定购
pgn	完整性
pgo	宝座
pgp	定额
pgq	定名
pgr	宣誓
pgs	军事机关
pgt	写入
pgu	定单
pgv	寁
pgw	定位
pgx	宣纸
pgy	宣言
phc	3
phd	3
phg	官吏
phi	3
phj	3
phl	3
phn	官司
pho	3
phs	3
phw	被占领土
phx	3
phy	官商
pia	3
pid	3
pif	空洞无物
pig	3
pih	3
pii	3
pil	3
pim	3
pin	3
pip	3
piq	3
piy	宗派主义
pja	3
pjc	3
pje	3
pjf	3
pjg	寔
pjl	3
pjo	定时炸弹
pjq	3
pjs	审核
pju	寓意
pjw	寒暑假
pjy	审计
pka	3
pkb	3
pkc	3
pkh	3
pki	3
pkl	3
pkq	察哈尔右翼后旗
pkt	宝贵生命
pkw	3
pky	空口说白话
pla	军医
plc	3
pld	宏图大略
ple	军力
plg	军政
pli	军港
pll	军界
plm	3
pln	军属
plp	寰宇
plq	3
pls	军械
plt	军舰
plu	军部
plw	宏图伟业
plx	社团组织
ply	军训
pma	3
pmb	3
pmc	3
pme	3
pmh	3
pmi	3
pmm	3
pmn	3
pmo	3
pmp	3
pmr	3
pms	3
pmt	3
pmu	3
pmw	3
pmx	3
pmy	3
pna	军民共建
pnd	家丑不可外扬
pnf	农民起义
png	补习班
pnh	定居点
pni	3
pnj	完璧归赵
pnk	3
pnl	寜
pnq	突飞猛进
pnt	宓
pnu	军民关系
pnw	农民企业家
pny	实习记者
poa	农业区划
poc	叜
pog	家庭环境
poi	3
poj	家庭暴力
pok	3
poo	3
pop	灾祸
pot	家庭生活
pou	宩
pow	家庭作业
poy	军火交易
ppa	视察工作
ppd	宽宏大量
ppf	寥寥无几
ppg	安安静静
ppj	3
ppk	冤家路窄
ppo	寥寥数语
ppp	之字宝盖补礻衤
ppq	之争
ppr	客客气气
pps	冠军杯
ppt	窃窃私语
ppu	之前
ppw	安定人心
ppy	牢牢记取
pqa	3
pqb	剜
pqc	3
pqd	䪴
pqe	3
pqh	3
pqj	3
pql	3
pqo	3
pqq	㝖
pqr	3
pqt	3
pre	3
prg	官兵一致
prj	3
prk	3
prm	3
prn	实质性谈判
pro	3
prp	实报实销
prt	安排生活
prv	3
prw	3
pry	宣誓就职
psb	3
psc	3
psd	农机厂
pse	3
psf	宁南
psg	宽松环境
psi	宁河
psk	3
psm	3
pso	3
pss	冧
pst	审查委员会
pta	家务劳动
ptb	社科院
ptd	神秘感
ptf	初等教育
ptg	福利事业
pti	客流
ptk	愙
ptl	客轮
ptm	3
pto	客座
ptp	安身之地
ptr	家长制
ptt	牢靠
ptu	额头
ptv	3
ptw	客货
ptx	3
pty	客商
pua	补药
pub	裙子
puc	实验
pud	实在
pue	实用
puf	褂
pug	实现
puh	初步
pui	褝
puj	袒
puk	农产品
pul	实况转播
pum	补贴
pun	袂
puo	实业
pup	被褥
puq	褪色
pur	被迫
pus	补丁
put	袼
puu	袢
puv	寝
puw	褓
pux	补给
puy	实施
pva	福如东海寿比南山
pvb	案子
pvc	3
pve	3
pvf	完好无损
pvg	安顿
pvi	被剥削阶级
pvj	3
pvl	䀂
pvm	3
pvn	安心
pvp	安神
pvq	安然
pvr	安抚
pvt	安生
pvu	案卷
pvv	3
pvw	案例
pvy	完好率
pwa	窃
pwb	宂
pwc	梥
pwd	突破
pwe	社会舆论
pwf	窥
pwg	社会环境
pwh	窝点
pwi	宣传活动
pwj	容量
pwk	窗口
pwl	突围
pwm	宣传周
pwn	安全性
pwo	䆦
pwp	社会福利
pwq	突然
pwr	空气
pws	穿梭
pwt	窖
pwu	邃
pwv	容忍
pww	社会化
pwx	容纳
pwy	社会主义市场经济
pxa	3
pxb	初级阶段
pxd	3
pxe	3
pxf	3
pxj	3
pxl	3
pxm	3
pxn	3
pxo	3
pxq	3
pxs	3
pxt	寲
pxv	3
pxw	穷乡僻壤
pxx	3
pya	审计工作
pyb	祖孙
pyc	神通
pyd	禊
pye	视力
pyf	禧
pyg	神速
pyh	视频
pyi	福清
pyj	礼遇
pyk	礼品
pyl	社团
pym	禂
pyn	祀
pyo	禟
pyp	祖宗
pyq	祢
pyr	礼拜
pys	神木
pyt	神秘
pyu	禚
pyv	神灵
pyw	室主任
pyx	视线
pyy	礻
qaa	鐷
qad	錤
qaf	急切地
qag	䥬
qah	铘
qai	鑮
qaj	镆
qak	鉕
qam	鍈
qan	鉪
qap	错字
qaq	金戈铁马
qar	锋芒所向
qas	3
qat	错乱
qaw	乌七八糟
qay	氐
qbc	駌
qbe	3
qbg	迎来
qbh	夘
qbj	鐊
qbl	㽜
qbn	釶
qbo	3
qbt	危险物品
qbu	迎送
qbw	迎风
qbx	3
qby	鈒
qcc	鏒
qcg	勾画
qch	3
qci	勾当
qcj	3
qcm	3
qcn	色情
qcp	3
qcs	3
qcv	3
qcy	色盲
qda	䥄
qdb	危及
qdc	鈜
qdd	铁矿石
qde	鍸
qdf	铁面无私
qdg	负有责任
qdh	争夺战
qdi	銇
qdj	銆
qdk	3
qdl	3
qdm	顉
qdn	䤞
qdo	3
qdp	留厂察看
qdq	久而久之
qdr	鲜艳的
qds	急不可待
qdt	危重
qdu	乌克兰
qdv	3
qdw	铸件
qdy	钛
qea	解惑
qeb	解聘
qed	触感
qee	錋
qef	触动
qeg	锄
qeh	触
qei	多加小心
qem	3
qep	鑀
qeq	多边贸易
qet	解释
qeu	解剖
qew	包办代替
qex	3
qey	解雇
qfc	鉣
qfd	名声大振
qfe	3
qff	銈
qfg	针刺
qfh	镇
qfj	3
qfk	銡
qfp	鋍
qfq	急需解决
qfs	3
qft	铑
qfu	﨨
qfv	3
qfw	鈇
qfx	针线
qga	鲜花
qgb	鲰
qgc	鱼台
qgd	鲕
qge	鳐
qgf	鲑
qgg	鲠
qgh	鲇
qgi	铺满
qgj	鲥
qgk	镉
qgl	鲴
qgm	负责同志
qgn	印刷
qgo	铼
qgq	金融危机
qgr	负责制
qgs	名列榜首
qgt	鲧
qgu	铗
qgv	鲟
qgw	负责人
qgx	銕
qgy	鲛
qha	錿
qhb	外孙
qhc	鈙
qhd	外面
qhe	外边
qhf	外壳
qhg	外来
qhh	
qhi	外省
qhj	外电
qhk	夞
qhl	外围
qhn	鈻
qho	3
qhp	迯
qhq	外逃
qht	外籍
qhu	钻头
qhv	3
qhw	外伤
qhy	外交
qic	3
qie	逃脱
qif	逃走
qig	独当一面
qii	䤬
qij	錔
qik	名演员
qim	鋿
qin	鱼水情
qio	3
qip	镗
qir	多党制
qit	销往
qiu	多渠道
qiw	外汇储备
qix	3
qiy	外汇市场
qjb	。
qje	3
qjf	贸易协定
qjg	钽
qjj	錩
qjk	（
qjn	鎉
qjo	3
qjq	贸易争端
qjt	鍟
qju	贸易部
qjv	3
qjy	贸易商
qka	象牙
qkb	兔子
qkc	3
qkd	䪷
qke	名胜
qkf	免去
qkg	名下
qkh	名目
qki	名流
qkk	名叫
qkm	名山
qkn	钟情
qkp	名额
qkq	勉
qkr	鉂
qks	狭路相逢
qkt	象征
qku	名将
qkv	3
qkw	铁路分局
qkx	铁路线
qky	名词
qla	3
qlb	3
qld	铟
qle	3
qlf	急转直下
qlg	包罗万象
qli	外国游客
qll	鑘
qlm	3
qlo	3
qlr	鏩
qls	3
qlt	外国血统
qlu	3
qlw	外国企业
qly	外国记者
qmc	3
qmd	金刚石
qmf	钢坯
qmg	负责
qmh	3
qmm	銟
qmp	3
qmr	䤱
qmt	铜牌
qmw	铜像
qmx	3
qna	馓
qnb	饺子
qnd	印刷厂
qne	饮用
qnf	包干
qng	饨
qnh	饭桌
qni	饮酒
qnj	馒
qnk	印刷品
qnm	馉
qnn	釲
qno	饮料
qnp	包容
qnq	馏
qnr	包括
qns	饤
qnt	饷
qnu	包装
qnv	多快好省
qnw	包含
qny	包裹
qoa	鑛
qob	鮿
qoc	鮻
qod	魾
qoe	鱫
qof	魼
qog	魨
qoh	鮛
qoi	魦
qoj	鯷
qok	鱢
qol	鮰
qom	鮦
qon	多米尼加
qoo	鯳
qop	魫
qoq	魡
qor	鮜
qos	鯠
qot	魠
qou	乌烟瘴气
qov	鎕
qow	魤
qox	鮨
qoy	触类旁通
qpc	3
qpd	名实不符
qpf	錝
qpg	夤
qpi	3
qpj	3
qpk	3
qpm	3
qpq	鈂
qpt	镇定自若
qpu	3
qpw	外祖父
qqa	金黄
qqb	多孔
qqc	钓鱼台
qqd	金矿
qqe	多边
qqf	多远
qqg	金融
qqi	多少
qqj	金钥匙
qqk	外贸顺差
qqm	多则
qqn	多发
qqo	狐狸精
qqp	多寡
qqq	金钱
qqr	金盾
qqs	金杯
qqt	金牌
qqu	多次
qqv	金婚
qqw	金华
qqy	镏
qrb	鍐
qrc	鈲
qrd	争执不下
qre	䤨
qrf	鍎
qrg	銗
qrh	䀜
qri	锦涛
qrj	㫚
qrk	名扬中外
qrl	名扬四海
qrm	匋
qrn	鎎
qro	3
qrq	忽然
qrs	铁板
qrt	乌拉特后旗
qru	铁门
qrv	3
qrw	忽悠
qrx	铁的纪律
qry	锦州
qsc	3
qse	3
qsg	铁板一块
qsm	3
qsq	3
qst	3
qsu	3
qsv	3
qsw	䥑
qsx	3
qsy	鉥
qta	獾
qtb	锈
qtc	犸
qtd	獗
qte	猨
qtf	猿
qtg	猜
qth	独占
qti	多种渠道
qtj	猖
qtk	独唱
qtl	狎
qtm	猪肉
qtn	
qto	犷
qtp	独家
qtq	狰
qtr	狠抓
qts	猎枪
qtt	犭
qtu	独立
qtv	犰
qtw	狯
qtx	猕
qty	狱
qua	独善其身
qub	铲除
qud	钦差大臣
que	鐗
quf	迎头赶上
qug	镧
quh	3
quj	镱
quk	乌兹别克斯坦
qul	鏳
qus	鳞次栉比
qut	独立自主的和平外交政策
quu	镜头
quw	独资企业
qux	包装费
qva	鐞
qvd	争艳
qve	争办
qvf	争霸
qvg	急于
qvh	饮鸠止渴
qvi	争光
qvk	争吵
qvl	急转
qvn	急剧
qvo	3
qvr	急迫
qvt	银行
qvu	争斗
qvw	多媒体电脑
qvy	急诊
qwb	3
qwc	鎓
qwd	争分夺秒
qwf	铃声
qwg	镫
qwh	鏅
qwk	名优品牌
qwn	匃
qwp	多做实事
qwq	铁合金
qws	䤪
qwt	锻造
qwu	名优产品
qww	销售价格
qwx	鈋
qwy	锥
qxb	3
qxc	3
qxd	3
qxe	3
qxf	鐑
qxh	鎭
qxi	銯
qxk	外强中干
qxl	3
qxn	3
qxo	3
qxp	3
qxr	3
qxx	鈚
qya	勉为其难
qyc	错误观点
qyd	留有
qyf	错误地
qyg	解放事业
qyi	夊
qyj	留日
qyk	镦
qyl	错误思想
qym	镶嵌
qyn	鸵
qyo	负效应
qyp	解放军报
qyq	外商独资企业
qyr	外商投资企业
qys	3
qyt	孵
qyu	外交部
qyv	遛
qyw	孵化
qyx	久经
qyy	留恋
raa	手工劳动
rab	捞取
rad	拒不
rae	拔苗助长
raf	搭载
rag	抗菌素
rah	捓
rai	技工学校
raj	揠
rak	擹
ral	描图
ram	制黄贩黄
ran	揲
rap	热切祈盼
raq	摕
rar	扫黄打非
ras	迫切要求
rat	措辞
rau	摸准
rav	撒娇
raw	搽
ray	拉萨市
rbb	摄取
rbc	掫
rbe	3
rbf	报载
rbg	拯救
rbh	提出上诉
rbi	拙劣
rbj	报时
rbl	捍卫国家主权
rbn	报收
rbo	报数
rbq	摄氏
rbr	扔掉
rbs	撤职查办
rbt	报复
rbu	报送
rbv	3
rbw	报人
rby	捍卫主权
rca	返工
rcb	把子
rcc	反对
rcd	返还
rcf	后台老板
rcg	反正
rci	摊派
rcj	捅马蜂窝
rck	指桑骂槐
rcl	反转
rcn	揉
rcp	擂台赛
rcq	挨饿
rcr	拚搏
rct	反射
rcu	抬头
rcv	3
rcw	摊位
rcy	搔
rda	拓荒
rdb	扩大出口
rdc	抜
rdd	希奇
rde	撕破脸皮
rdf	捺
rdg	找不到
rdh	抔
rdi	打破常规
rdj	拜师
rdm	欷
rdn	势在必行
rdo	拻
rdp	据不完全统计
rdr	拓扑
rds	势不可挡
rdt	迫不得已
rdu	撅
rdw	拜会
rdx	拉帮结派
rdy	所有这些
reb	捊
red	招架不住
ree	打肿脸充胖子
ref	拥戴
reg	㧮
reh	覛
rel	皭
rem	3
ren	3
rep	热爱祖国
req	搜狐
rer	拥挤
ret	劰
reu	打架斗殴
rev	挼
rew	挪用公款
rex	㨙
rfa	技工
rfb	质子
rfc	擂台
rfd	挂历
rfe	势均力敌
rff	年均增长
rfg	反过来
rfh	搷
rfi	护城河
rfj	质量
rfk	抚顺
rfl	挂图
rfm	白云山
rfn	推进改革
rfo	挂断
rfp	后起之秀
rfq	持久
rfr	挂接
rfs	质朴
rft	挂牌
rfu	质问
rfw	攉
rfx	反动统治
rfy	质询
rga	捕获
rgb	看到了
rgc	热烈欢迎
rgd	后面
rge	兵力
rgf	后进
rgg	接下来
rgh	后辈
rgi	后尘
rgj	挭
rgk	逅
rgl	抹黑
rgm	气吞山河
rgn	年事已高
rgo	反政府
rgp	所到之处
rgq	手下留情
rgr	捕捞
rgs	皌
rgt	捷径
rgu	搏斗
rgv	挳
rgw	后人
rgx	后缀
rgy	后方
rha	年节
rhb	看出
rhc	看戏
rhd	看成
rhf	披露
rhg	年来
rhh	看上
rhi	排水
rhj	年景
rhk	看中
rhl	卸车
rhm	年岁
rhn	拭目以待
rho	扑火
rhp	看守
rhq	挸
rhr	排斥
rht	排行
rhu	年间
rhw	看作
rhx	年纪
rhy	爪
ric	3
rid	换汤不换药
rie	撑腰
rif	搅动
rig	打游击
rii	白洋淀
rij	㧺
rim	3
rio	3
rip	抄写
riq	3
rir	后浪推前浪
ris	执法机关
rit	担当重任
riv	挥汗如雨
riw	挡风
rjb	提取
rjc	3
rjd	誓师大会
rje	㩎
rjf	提示
rjg	提
rjh	抗日战争
rji	㨪
rjj	抓紧时间
rjl	摱
rjm	3
rjn	反映情况
rjp	揭穿
rjq	提名
rjr	揭批
rjs	质量检验
rjt	提升
rju	质量关
rjv	3
rjw	提倡
rjx	提纲
rjy	打电话
rkb	扣子
rkd	接踵而来
rke	捌
rkf	捐献
rkg	失足青年
rkh	探听虚实
rki	3
rkj	︹
rkl	3
rko	3
rkp	兵贵神速
rkq	拀
rkr	捉摸
rks	气味相投
rkv	3
rkw	捉拿
rkx	扣费
rla	3
rld	接连不断
rlf	年轻干部
rlg	擐
rlh	舞步
rll	㩸
rlm	3
rln	拈轻怕重
rlo	3
rlq	斶
rlr	捆扎
rlw	舞会
rlx	挽回经济损失
rma	制式
rmb	抽取
rmc	3
rmd	抰
rme	制胜
rmf	失败者
rmg	摧残
rmh	掣
rmi	抽水
rmk	缺口
rmn	制导
rmo	揣摩
rmp	缺额
rmq	罀
rmr	皑皑
rms	抽检
rmt	缺德
rmu	抽奖
rmv	3
rmw	制售
rmy	抽调
rna	气功
rnb	氖
rnc	拨通
rnd	所有
rne	热情服务
rnf	掘进
rng	䎅
rnh	据点
rni	气派
rnj	气量
rnk	气味
rnl	扭转
rnm	扭曲
rnn	撰
rno	气焰
rnp	扎实
rnq	气馁
rnr	摺
rns	据查
rnt	氕
rnu	摒
rnw	擢
rnx	氢弹
rny	氦
rod	气度不凡
roe	3
rof	热火朝天
roi	3
rol	3
ron	鬼迷心窍
roo	找麻烦
rop	年度审议
rou	反腐斗争
rov	擞
row	反腐倡廉
roy	年度计划
rpa	按期
rpb	挖出
rpc	3
rpd	探矿
rpe	年富力强
rpf	挥霍
rpg	探求
rph	近视眼
rpi	近海
rpj	按时
rpk	打字员
rpn	打官司
rpp	探究
rpq	后视镜
rpr	挖掘
rps	探查
rpt	投案自首
rpu	近亲
rpw	擦
rpy	挥毫
rqa	抑或
rqb	换取
rqc	魑
rqd	换成
rqe	挣脱
rqf	担负起
rqg	挽救
rqh	持久战
rqi	抵消
rqj	㧦
rqk	搀
rqn	捣蛋
rqq	挣钱
rqr	抵制
rqs	摇钱树
rqt	排名第一
rqu	换装
rqw	兜售
rqy	抵京
rra	白菜
rrb	拉拉队
rrc	控制台
rrd	按捺不住
rre	折服
rrf	抓起
rrg	近年来
rrh	斦
rri	白沙
rrj	拍照
rrk	折中
rrn	招兵买马
rro	折断
rrp	白宫
rrq	白色
rrr	折扣
rrs	白杨
rrt	拆迁
rru	指挥部
rrv	娎
rrw	把握住
rrx	抵抗组织
rry	誓言
rsa	杀菌
rsb	投机取巧
rsd	技术成果
rse	打架
rsf	技术培训
rsg	技术开发
rsh	打点
rsi	技术学校
rsj	技术鉴定
rsk	打听
rsl	打转
rsn	技术性
rso	打火
rsp	杀害
rsq	打针
rsr	技术指导
rss	抽样检查
rst	技术先进
rsu	打着
rsw	技术含量
rsx	凶相毕露
rsy	抽样调查
rta	手艺
rtb	看得出
rtd	手套
rte	后备力量
rtf	卑
rtg	搬到
rth	手上
rti	手掌
rtj	手里
rtk	插嘴
rtl	手软
rtm	插曲
rtn	手臂
rto	皤
rtp	热身赛
rtr	报告指出
rts	手枪
rtt	插入
rtu	推向前进
rtv	擳
rtw	投入使用
rtx	招待费
rty	㐅
rua	投资项目
rub	打头阵
ruc	接驳
rud	择善而从
rue	接力
ruf	拉夫
rug	搓
rui	接洽
ruj	年产量
ruk	接吻
rul	接连
rum	拦网
run	抗逆性
ruo	掽
rup	拼写
ruq	拉锯
rur	抗美援朝
rus	投资机构
rut	接管
ruu	拼音
ruw	投资公司
rux	抚养费
ruy	按部就班
rva	殷切
rvb	抛出
rvc	摡
rve	势力
rvf	招考
rvg	热带
rvi	热水
rvj	招贤
rvk	热中
rvn	热情
rvq	按姓氏笔画为序
rvr	招手
rvt	执行
rvu	热门
rvw	垫付
rvy	执
rwa	失散
rwb	提供了
rwc	捴
rwd	イ
rwe	迭加
rwf	推进
rwg	捡
rwh	择优上岗
rwi	失学
rwj	投映
rwk	近代史
rwm	抢购
rwn	杀伤性
rwo	推断
rwp	失实
rwq	反倾销
rwr	所作的
rws	抓住机遇
rwt	失策
rwu	投产
rwv	失灵
rww	抢修
rwx	ぁ
rwy	携
rxa	曁
rxb	卽
rxd	㩪
rxe	白费力气
rxf	指南
rxg	指引下
rxi	指法
rxj	批量
rxl	指甲
rxn	持续发展
rxq	撧
rxr	拇指
rxt	后继乏人
rxu	批判
rxw	指使
rxx	指纹
rxy	批评
rya	按计划
ryb	摘取
ryc	㧧
ryd	抗原
rye	㧑
ryf	掠过
ryg	热衷于
ryh	白衣战士
ryi	搞活
ryj	抗旱
ryk	攘
ryl	提高思想认识
rym	3
ryn	捩
ryo	3
ryp	邀请赛
ryq	搞错
ryr	提高技术
rys	护林
ryt	敫
ryu	抗癌
ryv	摘录
ryw	皎
ryx	提高经济效益
ryy	抗议
saa	模范
sab	柜子
sad	楉
saf	模块
sag	模型
sah	栕
sai	栋梁
saj	横七竖八
sak	棫
sal	櫗
sam	横山
san	楪
sao	棋类
sap	㮠
saq	槆
sar	棋手
sas	杠杆
sat	西藏自治区
saw	模范人物
sax	枢纽
say	㯜
sbb	欇
sbd	极右
sbg	杰出青年
sbh	极点
sbk	3
sbp	3
sbq	3
sbt	槂
sbu	极美
sbw	极化
sbx	3
sca	树荫
scc	槮
scd	桳
sce	樋
scf	树干
sch	3
sci	3
scj	3
sck	枱
scm	3
scn	橘
sco	3
scp	3
scs	树枝
sct	权衡
scv	3
scw	树人
scx	3
scy	相对说来
sda	枯黄
sde	楜
sdf	顶替
sdg	㭅
sdh	槭
sdj	栢
sdl	3
sdm	柨
sdn	㮷
sdq	极大危害
sdr	配套措施
sds	可有可无
sdt	梼
sdu	顶部
sdv	3
sdw	榛
sdx	桟
sdy	枤
sea	檼
sec	3
sed	3
see	槄
seg	权力下放
sel	3
sem	3
sen	3
seo	3
ser	櫾
sey	3
sfa	村落
sfb	票子
sfc	榼
sfd	相去不远
sff	樗
sfg	标致
sfh	樾
sfi	飘
sfj	村里
sfk	标号
sfl	机动车辆
sfn	标尺
sfp	剽窃
sfq	棱角
sfr	飘扬
sfs	标本
sft	楮
sfu	标志着
sfw	票价
sfx	标引
sfy	标记
sga	酣
sgb	相互联系
sgc	本能
sgd	酞
sge	酷爱
sgf	酐
sgg	酽
sgh	醵
sgi	酿酒
sgj	桓
sgk	西口
sgl	本国
sgm	酮
sgn	醪
sgo	醭
sgp	西宁
sgq	酩
sgr	本质
sgs	相互配合
sgt	酥
sgu	本次
sgv	酔
sgw	酴
sgx	配给
sgy	酬
sha	樝
shb	相随
shc	禁止通行
shd	棑
she	相爱
shf	榜上无名
shg	椒
shh	㰋
shi	椒江
shj	槕
shk	禁止喧哗
shl	相思
shm	相见
shn	想必
shp	想家
shq	板上钉钉
shr	相撞
shs	想想
sht	相等
shu	相间
shv	3
shw	相邻
shx	相约
shy	相交
sib	3
sig	相当于
sih	3
sik	根深叶茂
sip	想当初
siq	楼堂馆所
sir	检举揭发
sit	相当长时间
siv	桜
siw	3
six	3
sja	查勘
sjb	樶
sjc	㭴
sjf	查封
sjg	柦
sjj	橸
sjk	3
sjo	3
sjr	查看
sjs	棍棒
sjt	查处
sju	机电部
sjv	3
sjw	3
sjy	查房
skb	可耻
skc	查号台
skd	可否
ske	梋
skf	歌声
skg	桯
skh	樻
skk	歌唱
skl	3
skn	歌剧
skr	㪼
sks	可口可乐
skt	可知
skw	可信
sky	可变
slb	3
slc	3
slf	㯰
slg	椢
sli	3
slj	3
slk	3
slm	3
slo	3
slr	3
slu	3
slw	㮨
sma	欁
smc	3
smf	椆
smg	可见一斑
smj	3
smk	3
sml	3
smn	檛
smo	3
smt	3
smu	棢
smv	3
smw	梤
snb	橄
snd	木已成舟
sng	可以理解为
snh	杻
sni	杨浦
snl	3
snm	3
snn	可以避免
sno	3
snr	槢
sns	杨柳
snt	梶
snw	樛
sny	札记
sod	模糊不清
soe	3
sog	欉
soh	3
soi	3
sok	3
sol	3
som	3
son	樚
soo	橯
sos	楼板
sot	榳
sou	䙳
sov	椩
sow	櫠
spa	3
spc	3
spd	櫶
spe	䙶
spf	相安无事
spg	榁
spi	3
spm	3
spn	可视性
spo	3
spp	档案室
spq	棕色
sps	棺材
spt	㭦
spw	榕
spy	榊
sqa	桝
sqb	桞
sqd	构成
sqe	⒘
sqh	3
sqi	校外活动
sqj	3
sqk	梚
sql	㭵
sqp	3
sqs	柳树
sqt	构筑
sqv	檭
sqw	哥儿们义气
sqx	3
sqy	柳州
sra	核扩散
srb	椶
srd	棉布
srf	板块
srg	栃
srh	根据具体情况
sri	楾
srk	3
srl	橅
srn	根据以上情况
srp	棉袍
srq	格杀勿论
srr	皙
srs	核技术
srt	椑
sru	橷
srv	3
srw	板凳
srx	攀比
sry	本报讯
ssa	攀枝花
ssb	林子
ssc	3
ssd	可想而知
sse	林县
ssf	林地
ssg	植根于
ssh	根本目的
ssj	机械电子工业部
ssk	检查员
ssl	㰈
ssm	槚
ssn	机构改革
sso	林业
ssp	棾
ssq	飘飘然
ssr	根本措施
sss	森林
sst	栖息
ssu	标本兼治
ssv	根本好转
ssw	机械化
ssx	梦乡
ssy	桂林市
sta	★
stb	横向联系
std	桥面
ste	㭚
stf	梏
stg	覆灭
sth	梴
sti	桥涵
stj	椱
stk	楀
stl	桖
stn	格局
sto	本季度
stp	柉
stq	橁
str	3
stt	桥牌
stu	相得益彰
stw	可靠保证
stx	横向经济联合
sty	格调
sua	标准工资
sub	树立了
sud	西部大开发
sue	橌
suf	机关干部
sug	椚
suj	标准时间
suk	林产品
sul	极端困难
sum	3
suq	栨
sus	样机
sut	槉
suu	标新立异
suw	本次会议
sux	梯级
svb	要职
svc	櫭
svf	枠
svg	要素
svh	㯸
svi	根治
svj	樔
svl	㯿
svm	3
svp	梫
svq	覅
svr	要挟
svs	概述
svt	概算
svu	相媲美
svw	要领
svy	杒
swa	机芯
swc	机能
swd	栿
swe	3
swf	检索
swg	橙
swh	检点
swi	机油
swj	松紧
swk	松口
swl	配合默契
swm	3
swn	松懈
swo	㯷
swp	检定
swr	枪杀
sws	机械
swt	机智
swu	检阅
swv	相信群众
sww	机会
swx	哥伦比亚
swy	朳
sxa	3
sxb	3
sxc	3
sxd	㯑
sxf	×
sxg	欚
sxi	3
sxj	栺
sxm	3
sxn	楷书
sxo	3
sxq	3
sxs	木结构
sxt	3
sxu	榒
sxv	3
sxw	可比价格
sxx	橼
sxy	㭹
syc	校验
syd	西方大国
syf	极为震惊
syg	梳理
syh	3
syk	椁
syl	校园
syn	可读性
syo	〣
syp	核定
syr	樆
sys	Ⅺ
syt	核算
syu	核准
syv	桹
syw	校舍
syx	槒
syy	杭州市
taa	长葛
tab	长子
tac	3
tad	箬
tae	各区县政府
taf	长远
tag	各项事业
tah	长眠
tai	升温
taj	繁荣景象
tak	长足
tam	短期内
tan	季节性
tao	重工业
tap	长安
taq	长岛
tar	各项指标
tas	长相
tat	长处
tau	季节差价
tav	特区建设
taw	私营企业
tax	长线
tay	升高
tbd	頺
tbe	3
tbf	透露
tbg	秀丽
tbi	䇰
tbk	3
tbl	3
tbp	透视
tbr	透气
tbt	种子选手
tbu	䉌
tbw	篨
tbx	3
tby	彶
tca	微观世界
tcc	犙
tcd	知难而上
tcf	长驱直入
tcg	私事
tch	3
tcj	3
tck	䈚
tcl	3
tcm	3
tcn	很难避免
tco	3
tcp	3
tcq	3
tct	敌对行动
tcu	敌对关系
tcw	私欲
tcy	私房
tda	榘
tdb	辞职
tdc	行不通
tdd	智慧
tde	筹办
tdf	辞去
tdg	䄷
tdh	适龄
tdi	适当
tdj	适时
tdk	短路
tdl	第三国
tdm	私有财产
tdn	嵇
tdo	舕
tdp	重大突破
tdq	知名
tdr	短缺
tds	稽查
tdt	矮
tdu	知道
tdv	生态建设
tdw	适合
tdx	科研经费
tdy	长春市
tea	务工
teb	舰队
tec	䈈
ted	舦
tee	筋
tef	船坞
teg	艚
teh	盘点
tei	航海
tej	䑵
tek	船只
tel	租界
tem	舳
ten	船民
tep	航空
teq	盘锦
ter	㣊
tes	航标
tet	舴
teu	航道
tev	䅑
tew	磐
tex	徯
tey	舷
tfa	各地区
tfb	第二阶段
tfc	先驱
tfd	造成
tfe	赞助
tff	等
tfg	千万
tfh	徒
tfi	先进水平
tfj	待遇
tfk	告
tfl	特困
tfm	等同
tfn	犊
tfo	千米
tfp	迕
tfq	赞
tfr	选手
tfs	特权
tft	等等
tfu	第二次
tfw	等人
tfx	造纸
tfy	造谣
tga	策划
tgb	熏陶
tgc	行骗
tgd	生存
tge	重用
tgf	生动
tgg	行列
tgh	眚
tgi	管理水平
tgj	筻
tgk	簌
tgl	策略
tgm	牛肉
tgn	第一届
tgo	重庆
tgp	行军
tgq	生猪
tgr	重返
tgs	重要
tgt	｀
tgu	重新
tgv	牛奶
tgw	管理人员
tgx	和平统一
tgy	生育
tha	重点项目
thb	自卫
thc	特此通知
thd	篡
the	自用
thf	乍
thg	版
thh	彼此
thi	自觉
thj	牌照
thk	臭味
thl	鼾
thm	算帐
thn	延迟
tho	自燃
thp	自定
thq	自负
thr	自杀
ths	怎样
tht	怎么
thu	重点问题
thv	重点建设项目
thw	自从
thx	自费
thy	处方
tia	毛泽东思想
tib	笵
tic	箈
tid	长江三峡
tie	自治县
tif	科学考察
tig	愆
tih	箥
tii	各党派
tij	簜
tik	靠水吃水
til	科学思想
tin	科学发展
tio	惩治腐败
tip	科学社会主义
tiq	知法犯法
tir	科学技术是第一生产力
tis	很清楚
tit	科学管理
tiu	生活资料
tiv	筜
tiw	科学依据
tix	生活费用
tiy	自治州
tja	长时期
tjb	微电子
tjd	物归原主
tje	微电脑
tjf	适时地
tjg	笪
tji	复兴
tjj	馧
tjk	复员
tjl	梨园
tjn	利民
tjo	香料
tjp	各显神通
tjq	鋫
tjr	得手
tjs	复查
tjt	篮
tju	得益
tjv	利好
tjw	复位
tjx	䄿
tjy	得主
tka	各式
tkb	积聚
tkd	各厂
tke	特别助理
tkf	各地
tkg	和平
tkh	篑
tki	和尚
tkj	㓢
tkk	乐呵呵
tkl	各界
tkm	篔
tkn	各局
tko	程度
tkp	管中窥豹
tkq	积怨
tkr	积攒
tks	积木
tkt	种种
tku	特别奖
tkw	委员会
tkx	各乡
tky	和谐
tla	积累基金
tlb	衈
tlc	䆉
tld	篾
tle	稩
tlf	笽
tlg	我国政府
tli	备注
tlk	备品
tln	血性
tlp	䉚
tlq	血色
tlr	先斩后奏
tls	备查
tlt	利国利民
tlu	积累总额
tlv	籔
tlw	微软公司
tlx	血统
tly	血迹
tma	秧苗
tmb	射阳
tmd	躺
tme	身受
tmf	奥运
tmg	秞
tmh	向上
tmi	牡丹江
tmj	身影
tmk	逈
tml	行贿罪
tmm	微幅
tmn	躲避
tmo	嶴
tmp	血肉之躯
tmq	向外
tmr	身手
tms	身材
tmt	向往
tmu	向北
tmw	自由化
tmy	身旁
tna	特异功能
tnb	筷子
tnd	篡改历史
tnf	行尸走肉
tng	税收政策
tnh	稰
tni	乐清
tnk	稦
tnn	秘书
tno	物以类聚
tnp	乐安
tnr	先发制人
tnt	秘书处
tnu	复习资料
tnw	自己人
tnx	秜
tny	我以为
tod	行业垄断
tof	翻越
tog	待业青年
toh	3
toi	翻滚
toj	蝵
tol	鄱
ton	簏
too	簩
toq	鍫
tor	秋播
tot	物业管理
tou	翻新
tov	穅
tow	待业保险
tox	䵸
toy	释放
tpa	簺
tpc	3
tpd	处之泰然
tpf	航空运输
tpg	千家万户
tpi	秘密活动
tpl	㹆
tpm	3
tpn	升官发财
tpr	管护
tps	筞
tpt	各家各户
tpu	利害关系
tpw	签字仪式
tpx	秘密组织
tqa	秖
tqb	称职
tqd	自然而然
tqe	自然力
tqf	敏锐地
tqg	自然环境
tqi	衡水
tqj	臭名昭著
tqk	物品
tqn	移居
tqo	物业
tqp	身外之物
tqq	特色鲜明
tqr	物质
tqs	先锋模范
tqt	自然科学
tqu	称道
tqv	籙
tqw	称作
tqy	称谓
tra	科技工作
trb	稯
trc	我能
trd	我厂
tre	物质力量
trf	稀土
trg	篁
trh	笊
tri	科技活动
trj	千年虫
trk	箉
trl	科技园
trm	科技周
trn	选择性
trp	御寒
trq	科技馆
trr	科技扶贫
trs	选择权
trt	科技知识
tru	科技咨询
trv	3
trw	科技人员
trx	鵞
try	物质文明
tsa	重要工作
tsb	重要职责
tsc	积极参加
tsd	入木三分
tsf	＿
tsg	䄽
tsh	条目
tsj	积极影响
tsl	重要思想
tsn	物极必反
tsr	积极推进
tss	和林格尔
tst	积极稳妥地
tsu	重要问题
tsv	3
tsw	重要作用
tsx	重要经验
tsy	条文
tta	筹备工作
ttb	自我陶醉
ttc	往往能够
ttd	造船厂
tte	微笑服务
ttf	筅
ttg	笙
tth	称得上
tti	各种渠道
ttj	秭归
ttk	牺牲品
ttl	自行车
ttn	笫
tto	牧业
ttp	自我实现
ttq	簃
ttr	繁重的
tts	徇私枉法
ttt	微生物
ttu	等待着
ttv	笔录
ttw	生物化学
tty	牲畜
tua	生产工具
tud	生产成本
tue	街道办事处
tuf	乎
tug	冬天
tuh	税目
tui	生产水平
tuj	等问题
tuk	科员
tul	生产国
tun	生产性
tup	税额
tuq	简单多数
tur	生产技术
tus	简朴
tut	简称
tuu	简况
tuv	稴
tuw	各单位
tux	生产线
tuy	生产方式
tvb	3
tvc	笯
tvd	衟
tve	很受
tvg	自始至终
tvi	很小
tvj	很晚
tvk	筎
tvl	䅔
tvm	3
tvn	委屈
tvp	委实
tvq	复杂多变
tvr	委托
tvs	3
tvt	很长
tvw	委任
tvy	牣
twa	剩余劳力
twb	租赁承包
twc	答对
twd	乘风破浪
twe	复合肥料
twf	科伦坡
twg	签
twh	㹋
twi	我们党
twj	移风易俗
twk	穨
twn	自信心
two	各企业
twp	签定
twq	稳坐钓鱼台
twr	稚气
tws	复合材料
twt	徐徐
twu	答卷
twv	秎
tww	每个人
twx	租赁经营
twy	签订
txa	系统工程
txc	3
txd	造纸厂
txe	身强力壮
txf	各级干部
txg	系列
txi	每当
txj	每晚
txn	系统性
txq	自费留学
txr	敏捷
txt	鳘
txu	系统总结
txv	稍纵即逝
txw	第八
txx	系统
txy	第六
tya	往昔
tyb	稿子
tyd	知识面
tyf	行为规范
tyg	往事
tyh	种族歧视
tyi	入学
tyj	入时
tyk	犒
tyl	㣶
tym	入帐
tyn	知识性
tyo	入迷
typ	翻译家
tyq	㒱
tyr	往年
tys	自主权
tyt	䄱
tyu	入门
tyv	各族群众
tyw	入侵
tyx	知识结构
tyy	种族主义
uaa	闭幕式
uab	瓶子
uad	并有
uae	立功受奖
uaf	并进
uag	疟
uah	疨
uaj	瘼
ual	奖勤罚懒
uam	立功赎罪
uan	亲切慰问
uap	冻害
uaq	㿊
uar	并报
uas	㭍
uat	并重
uau	亲切关怀
uaw	奠基人
uay	亲切交谈
ubb	3
ubc	3
ube	塑胶
ubf	兼职教师
ubq	决出名次
ubr	3
ubt	朔
ubu	疗养
ubw	塑像
ubx	3
uby	闻讯
uca	竣工
ucd	痛感
ucf	普通老百姓
uch	3
ucj	3
uck	㾂
ucl	3
ucm	3
ucn	痛惜
uco	㵗
ucp	3
uct	总预算
ucu	闯关
ucw	普通人
ucx	3
ucy	总参谋长
uda	兰花
udb	关联
udc	并不能
udd	䦒
ude	减肥
udf	准确无误
udg	䇉
udh	瘛
udi	减少
udj	决不是
udk	辨别
udl	决不罢休
udm	关内
udn	关怀
udp	减灾
udq	前不久
udr	准确的
uds	兰西
udt	关税
udu	关闭
udv	辧
udw	减人
udx	减弱
udy	辨
uea	剪切
ued	前奏
uee	前边
uef	前者
ueg	前列
ueh	前辈
uei	头脑清醒
uej	煎
uek	前哨
uem	道貌岸然
uen	癙
uep	前额
ueq	毅然
uer	前年
ues	3
uet	前程
ueu	前头
uew	前途
uex	瘦弱
uey	并驾齐驱
ufa	辛勤
ufb	并未了结
ufc	壮观
ufd	壮大
ufe	总裁办公室
uff	装载
ufg	壮丽
ufh	阗
ufi	养活
ufj	羊城晚报
ufk	闬
ufl	装甲
ufm	闻过则喜
ufn	乧
ufo	䦝
ufp	总协定
ufq	装饰
ufr	养护
ufs	首都机场
uft	养生
ufu	壮阔
ufv	半封建半殖民地
ufw	装修
ufy	壮族
uga	病菌
ugb	盖子
ugc	美观
ugd	美
uge	着力
ugf	新天地
ugg	美丽
ugh	着眼
ugi	总政治部
ugj	羯
ugk	痘
ugl	美国
ugm	羊肉
ugn	恙
ugo	痖
ugp	判定
ugq	疠
ugr	半年
ugs	美梦
ugt	判处
ugu	鄯
ugv	美好
ugw	新一代
ugx	羊绒
ugy	病房
uhd	阒
uhe	3
uhg	㾥
uhh	亲眼目睹了
uhi	3
uhj	前些时候
uhk	站
uho	3
uhp	3
uht	站稳
uhu	闭目养神
uhw	站住
uhx	㾚
uia	冰期
uic	3
uid	竭泽而渔
uif	冰雹
uig	背水一战
uih	3
uii	痧
uij	3
uik	阔别
uip	闣
uis	冰棍
uit	资源管理
uiu	冰冻
uiv	3
uix	3
uiy	门当户对
uja	音节
ujb	阐明了
ujc	3
ujd	意在
ujf	童
ujg	韴
ujh	痩
uji	章法
ujj	竟是
ujk	韵味
ujl	意图
ujm	䦸
ujn	竭尽
ujo	意料
ujq	韵
ujr	音质
ujt	章程
uju	瘟疫
ujw	间作
ujy	童话
uka	总工
ukb	总队
ukd	冲破
uke	勏
ukf	冲动
ukg	冲击
ukh	立足点
uki	问津
ukj	总是
ukk	产品品种
ukl	总署
ukm	兼听则明
ukn	部属
ukp	总之
ukq	兑
ukr	竞技
uks	总机
ukt	部委
uku	意味着
ukw	部件
ukx	总线
uky	部族
ula	单薄
ulb	单子
ulc	3
uld	曾有
ule	单边
ulf	凙
ulg	单一
ulh	3
ulj	甑
ulk	㾝
ull	曾因
ulm	3
ulp	立国之本
ulq	减轻负担
ulr	装甲兵
uls	新思想
ult	单行
ulu	闸门
ulw	曾任
ulx	单纯
uly	单调
uma	闦
umb	3
umc	3
umg	痌
umi	憋
umj	3
uml	3
umn	瘑
ump	3
umq	3
umr	3
ums	3
umt	意见箱
umv	3
umw	意见分歧
umx	3
ung	首屈一指
unh	决非
uni	剖心沥肝
unj	3
unm	3
unn	新发展
unr	闷热
uns	3
unt	决算
unu	决意
unv	关心群众生活
unw	半导体
uny	新民主主义革命
uoa	产业基地
uob	普降
uoc	䇊
uod	总数达到
uog	产业现状
uoh	3
uoi	普法
uok	3
uom	3
uon	3
uoo	㿘
uoq	3
uot	3
uou	门庭冷落
uow	首席代表
uoy	资料齐全
upa	3
upc	3
upg	3
upl	瘒
upm	3
upn	决定性的
ups	立案查处
upv	3
upw	凝神倾听
upy	3
uqa	奖项
uqd	䦦
uqe	竞争力
uqf	净增
uqg	将于
uqi	竞争激烈
uqj	次日
uqk	装饰品
uqm	资财
uqn	竞争性
uqo	次序
uqp	次之
uqq	资金外流
uqr	[
uqs	,
uqt	¤
uqu	冶金部
uqv	
uqw	盗
uqx	3
uqy	咨询
ura	善后工作
urb	3
urd	前后左右
urf	前所未闻
urg	总的形势
url	3
uro	3
urp	3
urr	总的看来
urs	新技术革命
urt	善后处理
uru	竞技状态
urw	辩护人
urx	3
ury	间接调控
usa	亲切
usb	亲子
usd	亲戚
use	新县
usf	新城
usg	奠
usi	新潮
usj	遵照
usk	疴
usl	门可罗雀
usn	新民
usp	装机容量
usq	美术馆
usr	新年
uss	凓
ust	遵循
usu	新西兰
usv	新婚
usw	新风
usx	新乡
usy	新房
uta	疾苦
utb	亲自出马
utc	疾驰
utd	头等大事
ute	颜
utf	决策者
utg	阁下
uth	瘪
uti	产油
utj	新德里
utk	道路
utm	道德败坏
utn	意向书
uto	首府
utp	羊毛衫
utq	首钢
utr	产后
uts	首相
utt	道德
utu	疾病
utv	亷
utw	音乐会
utx	痗
uty	准备就绪
uua	辛辛苦苦
uub	新闻出版署
uud	兼并破产
uuf	道道地地
uug	瘥
uuh	3
uui	北美洲
uuj	新问题
uuk	立足
uul	新闻界
uum	3
uun	判决书
uup	立宪
uuq	㾳
uur	前前后后
uus	前首相
uut	总装备部
uuu	拳头产品
uuv	新闻媒介
uuw	新闻公报
uuy	新闻记者
uvc	3
uve	㾼
uvf	新婚夫妇
uvg	冿
uvh	3
uvj	3
uvl	3
uvm	3
uvo	鹣
uvp	㓎
uvq	3
uvs	3
uvt	兼程
uvu	剪刀差
uvv	3
uvx	3
uwa	半个世纪
uwc	新华通讯社
uwd	总体布局
uwe	站住脚
uwf	总体规划
uwg	总代理
uwh	送货上门
uwi	总体水平
uwj	闪电
uwl	冷轧
uwn	总公司
uwo	冷库
uwp	新华社讯
uwq	半个多世纪
uwr	前几年
uws	㾋
uwt	益处
uwu	疫病
uww	总价值
uwx	癈
uwy	准
uxa	总结工作
uxb	总结了
uxd	北面
uxe	单细胞
uxf	冀南
uxh	剃
uxi	慈溪
uxj	背影
uxl	凝固
uxn	新颖性
uxp	慈祥
uxt	孳生
uxu	慈善
uxv	弟妹
uxw	北伐
uxx	慈
uxy	递交
uya	闹市区
uyd	北京大学
uye	竭诚服务
uyf	普遍真理
uyg	丬
uyi	辩证法
uyj	北京电信
uyk	门路
uyl	癛
uym	新高峰
uyn	闹剧
uyo	普遍应用
uyp	决议案
uyq	总方针
uyr	普遍推行
uys	ǎ
uyt	门牌
uyu	北京站
uyv	㾿
uyw	阏
uyx	辩证统一
uyy	郑州市
vac	3
vad	婼
vae	3
vag	嬅
vah	㜮
vai	3
vak	嬿
vam	嫹
vao	3
vas	3
vat	嬞
vaw	群英会
vax	3
vba	3
vbb	㚺
vbd	好不
vbf	好过
vbg	好事
vbh	好些
vbi	奶油
vbj	3
vbk	好啦
vbm	3
vbn	好心
vbq	好久
vbr	好手
vbt	奶牛
vbw	好人
vby	好说
vca	塈
vcb	堲
vcc	娺
vcd	䫀
vce	姢
vcf	3
vcg	始于
vch	3
vcj	即日
vck	㗠
vcn	妤
vct	㛌
vcw	鴑
vcx	䋈
vcy	怒放
vdb	3
vdd	3
vde	媩
vdf	群龙无首
vdg	剥夺政治权利终身
vdh	娝
vdk	3
vdl	3
vdm	頄
vdn	娍
vdr	既有的
vds	婍
vdu	嫽
vdw	媋
vdx	3
vdy	3
vea	垦荒
veb	退职
vec	3
ved	努力克服
vef	退却
veg	恳求
vei	退学
vej	3
vem	㛵
veo	3
vep	努力实现
ver	努力推进
vet	女服务员
vev	娞
vew	退货
vey	退让
vfd	好坏不分
vff	九霄云外
vfg	九十一
vfh	嫃
vfj	歗
vfk	姞
vfl	嬻
vfo	3
vfp	㛘
vfr	好运气
vfs	寻根
vft	㛈
vfu	女干部
vfv	九十九
vfw	妋
vgc	3
vgd	建有
vge	寻死觅活
vgg	九死一生
vgh	退一步讲
vgi	建湖
vgj	娻
vgk	娕
vgl	媡
vgm	嫧
vgn	3
vgo	㶳
vgp	䢖
vgq	㜜
vgr	女青年
vgs	建档
vgt	建委
vgu	婚事新办
vgv	娙
vgw	嬭
vgy	建交
vha	虓
vhb	3
vhc	3
vhe	3
vhf	3
vhg	
vhl	3
vho	3
vhp	3
vhs	3
vhu	3
vhx	3
vic	3
vif	3
vih	妙龄
vii	肃清
vij	鹔
vim	3
vin	隶书
vip	逯
vir	剥削制度
vit	肃穆
viu	肃立
vja	3
vjc	3
vjd	如临大敌
vje	3
vjf	娨
vjg	婣
vjn	3
vjo	3
vjp	3
vjr	3
vjs	婐
vjt	3
vju	3
vjw	3
vka	如若
vkb	卲
vkc	寻呼台
vkd	如故
vkg	召开
vkh	妕
vkj	刟
vkk	孍
vkm	召见
vkn	娯
vkv	3
vkw	召集
vky	䘫
vlc	3
vle	嫐
vlf	嬕
vlg	疀
vlk	3
vll	3
vln	巡回展览
vlo	3
vls	3
vlt	3
vlu	3
vly	3
vmb	3
vmc	3
vmd	媏
vme	3
vmf	婤
vmg	姛
vmk	3
vml	3
vmn	3
vmp	3
vmq	3
vmr	3
vms	3
vmt	3
vmu	3
vmw	㜠
vmx	3
vnb	㜟
vnc	3
vnd	婮
vne	3
vng	隶属于
vnh	妞
vnj	3
vnl	3
vnm	3
vnn	姄
vno	3
vnp	3
vnq	3
vnt	刀片
vnw	妜
vob	3
voe	3
vog	3
voh	3
vol	3
vos	孊
vot	群魔乱舞
vov	嫞
voy	3
vpb	3
vpc	3
vpd	3
vpg	婝
vpj	嫇
vpk	3
vpl	婉转
vpv	召之即来
vpw	㜚
vpy	婉言
vqc	3
vqd	㜬
vqe	3
vqh	3
vqk	姳
vql	3
vqm	㛟
vqs	3
vqu	㚬
vqv	婙
vqx	3
vqy	婚恋
vra	3
vrb	3
vre	3
vrf	3
vrg	娦
vrj	3
vrk	3
vrl	杂技团
vrn	3
vro	3
vrp	3
vrs	3
vrv	3
vsc	3
vsd	3
vse	3
vsi	3
vsl	3
vsm	3
vsn	3
vst	杂牌
vsu	寻根问底
vsv	婹
vsw	婡
vsy	杂谈
vta	建筑工地
vtb	婚生子女
vtc	3
vtd	建筑面积
vtf	娱乐场所
vtg	九牛一毛
vth	娫
vti	寻衅滋事
vtj	九时
vtk	郡
vtm	㛛
vtn	九届
vto	嬏
vtq	姓氏
vtr	女选手
vtt	既得利益
vtu	㚵
vtv	妊娠
vtw	九段
vtx	娒
vty	君主
vuc	3
vue	嬘
vug	即将开始
vuh	3
vui	3
vuj	嬑
vuk	㜔
vum	3
vun	3
vuo	3
vuq	3
vus	媇
vut	妇产科
vuv	奴颜婢膝
vux	嬨
vva	㜦
vvb	妇联
vvc	3
vve	3
vvf	妇女地位
vvg	始建于
vvj	3
vvl	3
vvo	3
vvq	妇女解放
vvr	女皇
vvs	3
vvt	女生
vvu	女装
vvv	女婿
vvw	婚姻登记
vwa	退休工人
vwb	3
vwd	3
vwe	3
vwf	九八规范王码助记词
vwg	九八王码
vwh	3
vwi	㚷
vwj	群众监督
vwm	3
vwn	㛋
vwo	3
vwr	群众反应强烈
vwt	姙
vwu	群众关系
vwv	鳭
vww	退休人员
vwy	寻人启事
vxa	3
vxb	3
vxd	始终不渝
vxe	3
vxf	3
vxh	3
vxi	3
vxk	3
vxl	3
vxm	3
vxo	3
vxp	3
vxs	3
vxw	妇幼保健
vxx	蠿
vyb	3
vyc	㜵
vyd	妨碍
vyg	好说歹说
vyh	3
vyi	刄
vyj	3
vyl	㜳
vyn	建设性
vyo	3
vyp	妨害
vyr	3
vys	3
vyt	嫙
vyu	建设资金
vyv	嫏
vyw	嬢
vyx	㜻
vyy	杂交育种
waa	俴
wab	供职
wad	化工厂
wae	代办
waf	贷款
wag	代理
wah	任期目标制
wai	㑈
waj	借鉴
wak	俄共中央
wal	全世界人民
wam	傋
wan	任其发展
waq	供销
war	储蓄所
wat	供稿
wau	袋装
wav	3
waw	供货
wax	代缴
way	袋
wba	保险期限
wbb	作出了重要贡献
wbc	3
wbd	创面
wbf	作出规定
wbg	依附于
wbh	保卫战
wbk	3
wbn	怹
wbo	保险业
wbq	鸧
wbr	创制
wbs	停职检查
wbt	创利
wbu	伴随着
wbv	创始
wbw	他人
wbx	他乡
wby	风险评估
wca	公墓
wcb	公职
wcc	㒍
wcd	仅有
wce	公办
wcf	供参考
wcg	公正
wci	公海
wcl	公车
wcn	公民
wcp	公寓
wcq	毤
wcr	颂扬
wcs	枀
wct	公告
wcu	公益
wcv	3
wcw	仅仅
wcx	公费
wcy	公证
wda	做工
wdd	伟大成就
wde	优胜
wdf	全面地
wdg	佦
wdh	仹
wdi	优劣
wdj	集成电路
wdk	创历史最高水平
wdl	3
wdm	偄
wdn	优异
wdp	做客
wdq	何厚铧
wdr	伟大的
wds	全面禁止
wdt	优秀
wdu	估产
wdv	倒不如
wdw	傣
wdx	合成纤维
wdy	仗
wea	使用期
wed	使用面积
wef	倍受鼓舞
weg	作用于
weh	俘虏
wel	3
weo	3
wep	僾
wer	使用报告
wet	人力物力
weu	人力资源部
wew	八月份
wey	使用说明
wfa	佳节
wfb	传出
wfc	刽
wfd	传达
wff	传真
wfg	传来
wfh	值
wfi	畲
wfj	会晤
wfk	佶
wfl	佛教界
wfm	风雨同舟
wfn	人均收入
wfp	祭祀
wfq	值钱
wfr	传授
wfs	仲裁机构
wft	值得
wfu	人才资源
wfv	八十九
wfw	促进会
wfx	会费
wfy	会谈
wga	逾期
wgb	代表了
wgc	便能
wgd	合成
wge	逾
wgf	命运
wgg	全球
wgh	佂
wgi	俅
wgj	倒是
wgk	命
wgl	代表团
wgm	俪
wgn	全局
wgo	全数
wgp	全军
wgq	夙
wgr	便捷
wgs	斜
wgt	债务
wgu	合资
wgv	倒退
wgw	全体
wgx	途经
wgy	登记
wha	修葺
whd	侦破
whe	3
whf	悠远
whg	修正
whh	䥚
whk	侦听
whn	个性
who	修炼
whp	个案
whq	候鸟
whr	侦探
whs	候机
wht	攸
whu	修剪
whv	偼
whw	个体
whx	偨
why	企望
wia	化学工业部
wid	低消耗
wie	贪污受贿
wig	合法政府
wii	依法治市
wij	分清是非
wik	3
wim	分水岭
win	合法收入
wip	化学家
wiq	3
wir	偷梁换柱
wis	依法查处
wit	全党和全国人民
wiu	传染病
wiw	全党全国
wiy	伪劣商品
wjd	似是而非
wje	3
wjg	今明两年
wjh	敒
wjj	但是
wjn	伸展
wjp	3
wjq	偶尔
wjr	全日制
wjt	风景秀丽
wjv	3
wjw	偶像
wjx	倱
wka	保苗
wkb	保卫
wkc	俋
wkd	保有
wke	促膝
wkf	仲裁
wkg	人员素质
wkh	信口雌黄
wki	风味小吃
wkj	风吹日晒
wkk	偔
wkl	全中国
wkm	坐吃山空
wko	保底
wkp	保守
wkq	保鲜
wkr	保质
wks	煲
wkt	人员往来
wku	人口普查
wkw	保修
wky	保育
wla	俄罗斯联邦
wlb	3
wlf	侵略者
wlg	偎
wlh	侵略战争
wli	3
wlj	3
wlk	3
wll	㒦
wlm	3
wlp	候车室
wls	3
wlt	全国委员会
wlw	全国人大
wlx	贫困线
wly	贪图享受
wma	＆
wmb	登山队
wmd	①
wme	傦
wmf	登山运动
wmg	俜
wmh	凧
wmj	⒐
wmk	『
wmm	3
wmn	做贼心虚
wmo	3
wmq	⑦
wms	□
wmt	侧身
wmu	3
wmw	⑸
wmx	3
wmy	◎
wna	人民警察
wnb	人民出版社
wnc	领导能力
wnd	优异成绩
wne	追肥
wnf	领导者
wng	人民政府
wnh	偦
wni	追溯
wnj	人民日报社
wnk	人情味
wnl	人民团结
wnm	人民内部矛盾
wnn	追
wnp	假定
wnq	人民解放
wnr	全民所有制
wns	领导机构
wnt	似乎
wnu	公司总裁
wnv	假如
wnw	领导集体
wnx	倔强
wny	假设
woa	㑞
woc	3
wod	含糊不清
woe	3
wog	创业环境
woi	健康水平
won	人类已经迈入
woo	儝
wop	俯视
wor	低廉的
wos	3
wot	健康长寿
wou	俯冲
wow	企业集团
woy	供应商
wpa	倾家荡产
wpb	保家卫国
wpd	代之而起
wpf	倧
wpg	追究责任
wpi	贪官污吏
wpj	3
wpn	㑻
wpo	3
wpp	全家福
wpr	传宗接代
wps	全军覆没
wpt	从宽处理
wpu	贫富差距
wpw	全家人
wpx	食宿费
wqa	仰慕
wqb	
wqd	仍然存在
wqe	3
wqf	低地
wqg	低速
wqi	佻
wqj	停留时间
wqk	人多嘴杂
wql	3
wqn	佨
wqq	尦
wqr	﹚
wqs	、
wqt	低矮
wqu	低音
wqv	依然如故
wqw	低谷
wqy	低效
wra	风范
wrb	他指出
wrc	仮
wrd	僵持不下
wre	风力
wrf	风雨
wrg	几年来
wrh	飓
wri	风光
wrj	信誓旦旦
wrk	保持中立
wrl	儛
wrm	保护网
wrn	风情
wro	风度
wrp	保护视力
wrq	飑
wrr	今后的
wrs	风机
wrt	保持稳定
wru	保持着
wrv	拿手好戏
wrw	爷爷
wrx	低年级
wry	保持高度一致
wsa	何苦
wsd	何不
wsf	体裁
wsg	体现
wsh	何止
wsi	公检法
wsk	体味
wsn	何必
wsp	候机室
wsq	僲
wsr	体质
wss	体检
wst	休息
wsu	何况
wsw	休假
wsy	合格率
wta	优秀共产党员
wtb	创造了
wtc	作对
wtd	八百
wte	信息服务
wtf	赁
wtg	几万
wth	作战
wti	几乎没有
wtj	几日
wtk	公务员
wtl	作图
wtm	几周
wtn	创造性
wto	几度
wtp	信息社会
wtq	几多
wtr	信息技术
wts	人身权
wtt	￡
wtu	俱乐部
wtw	信息化
wtx	几经
wty	信息高速公路
wua	全部落网
wub	全部承担
wud	倍感
wue	偂
wuf	倍增
wug	佯
wuh	3
wuj	傹
wuk	分门别类
wul	低产田
wuo	焦头烂额
wup	3
wur	分道扬镳
wus	僔
wut	从北向南
wuu	伴音
wuv	倒背如流
wuw	伴侣
wux	创新纪录
wuy	依次为
wva	分区
wvb	分隔
wvc	㑡
wvd	颁布
wvf	盆地
wvg	分裂
wvh	侵占
wvi	分清
wvj	盆景
wvk	侞
wvl	侵略
wvm	分贝
wvn	颁发
wvo	分数
wvp	分割
wvq	分销
wvr	分批
wvs	侵权
wvt	健身
wvu	分辨
wvw	创始人
wvx	分红
wvy	分离
wwa	合作项目
wwb	谷子
wwc	价值观念
wwd	从不
wwe	人力
wwf	傺
wwg	佩
wwh	价目
wwi	人流
wwj	份量
wwk	鹆
wwl	价值连城
wwm	伤风败俗
wwn	人民
wwo	全人类
wwp	合作社
wwq	人名
wwr	你们的
wws	坐标
wwt	人和
wwu	合作关系
wwv	作风建设
www	俗
wwx	优化组合
wwy	伶
wxa	传统工艺
wxb	低级阶段
wxc	从经验上看
wxd	华夏
wxe	㑃
wxf	货运
wxg	华表
wxi	货源
wxj	供给量
wxk	华贵
wxm	华山
wxn	传统剧目
wxp	父母官
wxq	体弱多病
wxs	仔细核对
wxt	倾向
wxu	传统美德
wxw	倾斜
wxx	化纤
wxy	传统文化
wya	会议期间
wyb	售出
wyc	邻
wyd	В
wye	信用
wyf	隼
wyg	住
wyh	焦点
wyi	б
wyj	今日
wyk	僦
wyl	领略
wym	焦炭
wyn	念
wyo	劁
wyp	领袖
wyq	体育馆
wyr	今年
wys	全文检索
wyt	信息
wyu	飠
wyv	停建
wyw	令人
wyx	会议结束
wyy	住房
xaa	红花
xab	縙
xac	3
xad	红唇
xaf	经营场所
xah	繿
xai	红河
xaj	縸
xak	彄
xal	䌩
xam	绬
xan	练习
xap	经营之道
xaq	㣅
xar	缓期执行
xas	红梅
xat	经营自主权
xaw	䌨
xay	练就
xba	3
xbd	3
xbe	3
xbf	继承者
xbg	䋙
xbi	3
xbj	3
xbl	3
xbn	䊶
xbo	3
xbp	3
xbq	3
xbr	3
xbv	3
xca	经营
xcb	3
xcc	縔
xcf	绝对真理
xcg	贯通一气
xch	3
xci	绝对温度
xcl	3
xcn	纾
xcq	绝对多数
xcr	经手
xcs	3
xct	经管
xcu	经意
xcw	绝对化
xcx	经纪
xcy	经验交流会
xda	3
xdc	绝不允许
xdd	绝不辜负
xde	絠
xdf	经历过
xdh	紑
xdj	緾
xdl	3
xdm	緛
xdn	絾
xdo	3
xdq	绝大多数人
xdr	强硬措施
xdu	绝大部分
xdw	縥
xea	䌥
xec	3
xee	綳
xeg	缓刑
xem	3
xeo	3
xeq	䋩
xet	絼
xeu	组阁
xev	缓建
xew	经受住
xex	縘
xey	3
xfa	3
xfc	乡土观念
xfd	繻
xfe	3
xff	疆场
xfh	纎
xfi	颕
xfj	结盟
xfk	线路
xfm	遦
xfn	线性
xfo	繊
xfp	结实
xfq	引起争议
xfr	引进技术
xfs	䌮
xft	结算
xfu	结亲
xfw	引进人才
xfx	细声细气
xfy	引进设备
xga	3
xgc	绖
xgd	统一大业
xge	彖
xgf	统一规划
xgg	统一于
xgh	䋊
xgi	彔
xgj	繐
xgk	㣂
xgl	繮
xgm	緉
xgn	强烈愤慨
xgo	纯粹
xgq	纯金
xgr	张万年
xgs	纯朴
xgt	纯利
xgu	经理部
xgw	统一体
xgx	縤
xgy	结束语
xhc	㢰
xhi	引渡
xhj	绝非易事
xhn	眞
xhp	3
xhr	综上所述
xht	引种
xhu	终点站
xhv	3
xhx	紪
xhy	纸上谈兵
xia	经济区
xic	3
xid	经济不景气
xie	经济力量
xif	经济规律
xig	经济一体化
xih	引水上山
xii	经济活动
xin	经常性
xio	3
xip	经济实体
xiq	经济犯罪
xir	经济指标
xis	经济核算
xit	经济利益
xiu	经济关系
xiw	经济体制改革
xix	经济纠纷
xiy	经济计划
xja	縪
xje	㔗
xjf	㔬
xjg	㔭
xjj	縄
xjl	緼
xjn	䌈
xjo	3
xjp	3
xjq	费解
xjr	3
xjt	䍀
xjx	絏
xjy	3
xkd	强盛
xke	强加
xkf	强震
xkg	强求
xkh	缱
xkj	犟
xkk	繟
xkp	3
xkq	3
xkr	强手
xkt	缉私
xkw	强健
xla	比较落后
xld	絪
xle	緭
xlf	纆
xlg	细致
xlh	3
xli	比较清楚
xln	比较发达
xlo	3
xlp	细密
xlt	比较简单
xlw	比较健全
xlx	纙
xly	3
xma	䌡
xmb	3
xmc	3
xmg	絧
xmi	3
xmj	3
xml	3
xmp	3
xmr	䋞
xmv	3
xmw	綗
xmy	3
xng	䌻
xnh	縀
xnl	3
xnm	3
xnn	乣
xnq	3
xns	母校
xnt	纪委
xnw	母体
xnx	纠缠
xny	引以为荣
xod	颎
xoe	3
xoh	3
xoi	3
xok	3
xon	䌒
xop	3
xot	缠身
xou	3
xox	继续
xoy	毕业证书
xpe	3
xpf	终审裁定
xpg	经审理后
xpi	缩水
xpm	3
xpo	3
xps	紵
xpu	縡
xpv	3
xpw	约定俗成
xpx	疑神疑鬼
xqa	绿色工程
xqb	3
xqc	絶
xqd	经久不衰
xqf	幼儿教育
xqg	绚丽
xqh	纸上
xqi	绝活
xqk	絇
xqn	3
xqp	绝密
xqr	绝技
xqt	引狼入室
xqu	经贸部
xqv	约好
xqw	绿色食品
xqx	红外线
xqy	绝望
xra	绵薄
xre	3
xrg	弘扬正气
xrj	3
xrk	3
xrr	䋂
xrs	3
xrt	维持秩序
xrx	缩手缩脚
xsa	3
xsb	3
xse	3
xsf	㢾
xsg	红极一时
xsi	3
xsj	3
xsl	3
xsm	3
xsp	3
xss	䌝
xst	3
xsx	3
xsy	纵横交错
xta	贯彻落实
xtb	贯彻了
xtd	颖
xte	乡办
xtf	缍
xtg	维生素
xth	疑虑
xtj	终日
xtk	张嘴
xtl	繌
xtn	终局
xtp	终审
xtr	张扬
xts	纪律检查委员会
xtt	乡长
xtu	疑问
xtv	㢻
xtw	纳税人
xtx	缝纫
xty	蠁
xua	絣
xuc	3
xud	绕道而行
xue	繝
xuf	㢹
xug	絴
xuk	䋨
xuo	3
xur	3
xut	弹射
xuw	弱化
xux	鶸
xva	绿茶
xvb	3
xvc	3
xvd	3
xvf	紣
xvi	绿洲
xvk	弨
xvm	3
xvp	綅
xvr	3
xvt	纪录片
xvu	3
xvv	3
xvx	3
xvy	比如说
xwa	3
xwb	纵队
xwc	総
xwd	综合研究
xwe	紾
xwf	综合考察
xwg	综合开发
xwi	纵深
xwj	结余归己
xwk	緥
xwm	纪念册
xwn	综合性
xwo	纀
xwp	纵容
xwq	纵然
xwr	绘制
xwt	综合管理
xwu	给养
xww	纪念会
xwx	综合经济效益
xwy	纵论
xxa	纺织工业
xxc	结结巴巴
xxd	纺织厂
xxf	组织起来
xxg	毙
xxh	纼
xxi	纷纷举行
xxj	比照
xxk	丝织品
xxn	毖
xxo	红绿灯
xxp	丝绸之路
xxr	继续扩大
xxs	纺织机械
xxt	组织委员
xxu	组织部门
xxv	组织建设
xxw	经纪人
xxx	丝绸
xxy	比方
xyc	䋭
xyd	编码
xyg	纹理
xyk	弴
xyn	编剧
xyp	顷刻之间
xyq	编外
xyr	强调指出
xyt	统筹
xyu	绞痛
xyv	3
xyw	统领
xyx	编织
xyy	编译
yaa	文艺工作者
yab	谨防
yad	良莠不齐
yae	试办
yaf	詌
yag	谋求
yah	衺
yaj	文艺晚会
yak	讌
yal	文艺界
yan	谨慎
yao	3
yaq	计划外
yar	试看
yat	试种
yau	试产
yaw	文艺作品
yax	计划经济与市场调节
yay	诺言
yba	3
ybd	䜏
ybf	记取教训
ybj	3
ybl	3
ybo	3
ybp	3
ybq	3
ybr	3
ybs	3
ybt	讲卫生
ybu	3
ybv	3
ybx	3
yby	訯
yca	育苗
ycc	謲
ycd	主观原因
yce	育肥
ycf	充填
ycg	交通事故
yci	充沛
yck	主观唯心主义
ycl	夣
ycn	就难以
ycp	交通安全
ycq	译名
ycr	试验报告
ycs	交通枢纽
yct	育秧
ycu	试验装置
ycv	3
ycw	誜
ycy	主观主义
ydb	ǎ
ydc	詙
ydd	议而不决
yde	䜡
ydf	记大过
ydg	就在于
ydh	放在眼里
ydj	䛳
ydl	3
ydm	䛔
ydn	放在心上
ydp	义不容辞
ydq	放大镜
ydr	变态反应
yds	毫不相干
ydt	享有特权
ydu	说三道四
ydw	这不仅仅是
ydy	蛮不讲理
yea	䛼
yeb	3
yec	3
yed	享受在后
yee	衣服
yef	䘚
yeg	谖
yel	3
yem	斖
yen	3
yeo	3
yep	衣襟
yer	謡
yes	3
yet	譌
yeu	衣着
yev	3
yew	谣传
yfa	认真落实
yfb	文教卫生
yfc	文武双全
yfd	毫无顾忌
yff	读者
yfg	六十五
yfh	斌
yfi	讲演
yfj	计时
yfk	齐声叫好
yfl	认真思考
yfn	读书
yfp	读完
yfq	认真负责
yfr	讲授
yfs	诗歌
yft	读物
yfu	市场竞争力
yfv	讨好
yfw	市场信息
yfx	认真贯彻
yfy	讨论
yga	市政工程
ygb	訰
ygd	主顾
yge	主办
ygf	高速增长
ygg	请柬
ygh	请战
ygi	语法
ygj	主题
ygk	誎
ygm	謮
ygn	这一情况
ygo	高速度
ygp	评定
ygq	主犯
ygr	高素质
ygs	主权
ygt	评委
ygu	语音
ygv	语录
ygw	主体
ygx	评比
ygy	主义
yha	諕
yhd	裵
yhe	3
yhg	让开
yhi	3
yhn	计上心来
yhq	誢
yhs	3
yht	盲目生产
yhu	盲目决策
yhw	望眼欲穿
yhy	诽谤
yia	望尘莫及
yie	旅游服务
yif	旅游者
yig	认清形势
yii	交流活动
yij	誻
yil	交流思想
yim	3
yin	讲学习讲政治讲正气
yip	譡
yiq	3
yir	文汇报
yiu	请注意
yiv	3
yiw	文学作品
yix	交学费
yiy	旅游市场
yjc	3
yjd	话里有话
yjf	齐声
yjg	齐整
yjh	齑
yji	为时尚早
yjj	剂
yjl	主题思想
yjm	3
yjn	证明书
yjo	3
yjp	文明社会
yjq	齐名
yjr	变电所
yjs	就是要
yjt	文明生产
yju	变电站
yjv	3
yjw	这时候
yjx	䛰
yjy	课文
yka	高雅
ykb	享
ykc	高台
ykd	高原
yke	享用
ykf	高考
ykg	高速
ykh	衷
yki	鹫
ykj	高明
ykk	谔
ykl	䯬
ykm	高峰
ykn	市中心
yko	毫米
ykp	豪
ykq	商品销售
ykr	享年
yks	高档
ykt	交响乐团
yku	衰竭
ykw	商品化
ykx	熟练
yky	就诊
yld	3
ylj	3
ylk	亶
ylm	3
ylo	3
yls	3
ylw	䛺
ylx	3
yma	高峰期
ymc	3
ymd	褒贬不一
ymf	调动
ymg	市政
ymh	调频
ymi	3
ymk	詗
ymm	颤巍巍
ymn	諣
ymo	调料
ymq	旗帜鲜明
ymr	调拨
ymt	调入
ymu	调养
ymv	3
ymw	调价
ymx	3
ymy	调剂
yna	启发式
ynb	房子
ync	䋜
ynd	永不
yne	肩
ynf	启动
yng	永平
ynh	盲目
yni	词汇
ynj	说心里话
ynk	扈
ynl	亡国
ynm	翩
ynn	扇
yno	刻度
ynp	永定
ynq	户外
ynr	衷心希望
yns	妄想
ynt	肇
ynu	戽
ynv	记录
ynw	诀
ynx	䋀
yny	忘记
yoa	商业区
yoc	变通
yod	为数不多
yof	变卖
yog	变更
yoi	高精尖技术
yoj	变暖
yok	谈吐
yom	弯曲
yon	商业性
yoo	高精度
yop	调度室
yoq	迹象
yor	变质
yos	亦可
yot	变迁
you	谈判
yov	变好
yow	变焦
yox	京广线
yoy	谈话
ypa	3
ypb	谱写出
ypd	高官厚禄
ype	这边
ypf	六神无主
ypg	旅客列车
ypj	这时
ypm	3
ypq	䛷
ypr	3
yps	詝
ypt	这么
ypv	3
ypw	为社会主义服务
yqa	椉
yqc	3
yqd	试金石
yqf	高尔夫
yqg	裦
yqh	3
yqi	誂
yqk	请勿吸烟
yql	3
yqn	䛌
yqr	詾
yqs	3
yqt	诡秘
yqu	课外阅读
yqw	䚿
yqy	课外读物
yra	诉苦
yrb	交换了意见
yrd	主持大会
yre	3
yrf	离境
yrg	主持正义
yrh	㫌
yri	义演
yrk	㫊
yrm	离岸
yrn	义愤
yrq	褢
yrr	诚挚的祝贺
yrs	高技术产业
yrt	諀
yru	请提意见
yrv	主持召开座谈会
yrw	离休
yry	诉说
ysa	放松警惕
ysb	订出
ysd	高楼大厦
ysf	諲
ysg	这样一来
ysh	主要目标
ysi	调查小组
ysj	调查显示
ysk	謌
ysm	主要内容如下
ysn	主要性能
ysp	3
ysr	主要指标
yss	弃权票
yst	这本身就说明了
ysu	主要问题
ysv	变相剥削
ysw	主要领导
ysx	主要经验
ysy	主要方面
yta	为期
ytb	为了
ytc	诱骗
ytd	放在
yte	施肥
ytf	诜
ytg	为副
yth	为此
yti	评选活动
ytj	放电
ytk	话务员
ytl	诱因
ytm	旗帜
ytn	旎
yto	旅店
ytp	放宽
ytq	为名
ytr	计算所
yts	计算机系统
ytt	旄
ytu	话音
ytv	帰
ytw	让我们
ytx	放纵
yty	䚺
yud	六亲不认
yue	旁边
yuf	说起
yug	斓
yuh	谈判桌
yui	说清
yuj	商量
yuk	这意味着
yul	访问团
yum	话音刚落
yun	说情
yuo	商店
yup	啻
yuq	讇
yur	高新技术企业
yus	商检
yut	高产稳产
yuw	这部分
yuy	语音识别
yva	文如其人
yvb	3
yvc	剆
yve	郞
yvm	3
yvn	良心
yvo	3
yvr	离婚后
yvt	良策
yvu	3
yvw	为群众办实事
yvx	3
yvy	朗读
ywa	文化艺术
ywb	交出
ywc	衮
ywd	B
ywe	效力
ywf	六十
ywg	交互
ywh	交战
ywi	设法
ywj	夜晚
ywk	文化遗产
ywl	文化界
ywm	褒贬
ywn	为人民服务
ywo	论断
ywp	文化宫
ywq	郊外
ywr	郊
yws	论述
ywt	为什么
ywu	效益
ywv	文化娱乐活动
yww	交付
ywx	a
ywy	谁
yxa	熟练工人
yxb	高级阶段
yxc	3
yxf	高级教师
yxg	䛹
yxi	高级法院
yxm	3
yxp	高级军官
yxq	3
yxs	3
yxt	饔
yxu	离经叛道
yxw	高级人才
yxx	卛
yya	文革
yyb	文联
yyc	商讨对策
yyd	这方面
yyf	文教
yyg	誩
yyi	语言学
yyj	设计师
yyk	议员
yyl	方略
yym	颤颤巍巍
yyn	谝
yyo	议席
yyp	议案
yyq	谅解
yyr	该打
yys	方可
yyt	文物
yyu	谪
yyv	誏
yyw	文化
yyx	詃
yyy	高效率
