hgd	丄
ghk	丅
dgt	丆
dyi	丈
gmw	丙
uxg	丠
gja	丣
ngk	丮
ehk	丯
njh	丱
vyi	丸
ytn	为
ttl	丿
nyi	乄
mnn	乢
exi	乿
qjj	亀
hhl	亅
guv	亊
fnv	亐
fff	亖
mff	亗
yyg	亠
yjj	亣
ynt	亥
yem	亹
www	人
wth	亻
wgf	亼
wyu	亽
wwy	仈
wcy	仏
wfg	仕
wmj	仚
wfh	仠
wtn	仡
way	代
nyw	以
wdg	仨
wkh	仲
wxx	仳
wgg	仼
wny	伈
wyw	伉
wdb	伌
wfc	伎
wfn	伟
wwb	伧
wyt	伪
wvc	伮
wug	伴
wlg	伵
wmg	伷
wck	佁
wvk	佋
whx	佌
wfi	佘
wqk	佝
wgn	佤
wdj	佰
wbg	佴
wuq	佽
wwe	佾
wgk	使
wkk	侃
wgc	侄
wff	侍
woy	侎
wri	侏
wct	侔
wdm	侕
waa	侙
wsg	価
wwf	侩
wle	侽
wpf	俒
wkg	俣
wlh	俥
wdt	俦
whd	俳
wec	俷
wdw	俸
wjj	倡
whj	倬
wes	倸
wgm	债
wam	偀
waj	偃
wuj	偣
wus	偤
wln	偲
wwg	偷
wrq	傀
wco	傌
wov	傏
wex	傒
wip	傥
wcw	傩
wcc	傪
wgq	傲
woo	僗
wep	僢
waq	僭
wob	儍
wpn	儜
woa	儣
wja	儤
wll	儽
aqv	兂
igq	光
wcq	兊
qkq	免
hjq	児
hnm	兕
rqn	兜
igw	兴
adw	其
uvo	兼
urv	兿
mfd	冃
jqk	冕
pyn	冖
pwb	冗
pou	冞
prx	冟
pfq	冠
pfe	冡
pge	冢
uag	冮
uah	冴
ugv	凄
ufw	凌
uqg	凎
umg	凒
hwv	凣
twv	処
wtf	凭
wrg	凰
uco	凴
hgh	凸
fjh	刌
myj	刐
xjj	刜
egj	刞
ckj	刣
ugj	判
fcj	刦
fcv	刧
qnj	刨
caj	刭
tdj	刮
gcf	到
fjv	刱
bsj	刴
mqj	刿
kmw	剐
jqr	剔
uav	剙
gkv	剚
vij	剥
tux	剩
uej	剪
oac	剫
vjs	剿
dub	劂
lqj	劅
ouv	劆
thl	劓
ite	劣
ret	劧
fce	劫
qke	劬
vke	劭
dgq	励
ceh	勇
akf	勒
eee	勰
tyc	勶
qtn	勹
qyi	勺
qge	匍
qdj	匎
qgk	匐
qvc	匓
agn	匚
aad	匞
ahd	匪
fmu	南
ffh	卦
bnh	卩
qbh	卬
abh	卭
rgb	卮
qgb	印
qyt	卵
big	卺
qtv	卿
djf	厘
daj	厝
dri	原
dim	厰
dcu	厷
ccy	厸
nhc	収
kkk	口
vkf	叴
kng	叼
kgf	吁
kta	吒
kbn	吔
koy	吙
kvt	吚
vtk	君
dhk	否
wyn	含
kqu	呁
kdy	呔
kar	呕
kyx	呟
knn	呡
kxy	呣
mfk	周
klg	呬
kgu	呯
kvc	呶
kqn	咆
kmd	咉
kty	咊
kyn	咏
kwf	咐
krs	咑
kdm	咘
ktu	咚
kxx	咝
kbg	咡
kpt	咤
kgc	咥
nyk	咫
kyw	咬
kfk	咭
kud	咲
ktd	咶
dgk	咸
kgj	咺
kwv	咿
kag	哐
krh	哖
kws	哚
kxw	哛
kct	哞
kga	哢
kdn	哤
kkd	哭
krr	哳
kyv	哴
kjf	哻
kyk	哼
eks	哿
ktb	唀
dfe	唇
klh	唓
krf	唕
gsk	唜
kam	唝
kru	唞
kqg	唫
wyk	售
kuf	唴
keb	啂
kge	啄
kss	啉
kes	啋
knb	啒
kqr	啕
hxk	啙
kfl	啚
kcc	啜
khd	啡
kgm	啧
ful	啬
klf	啭
khw	啮
kpg	啶
kjg	啺
kgk	喇
kwn	喉
kdg	喊
kan	喋
kad	喏
kuj	喑
fku	喜
kwg	喻
kqv	喼
kgx	嗉
kee	嗋
kpd	嗐
kfc	嗑
kfh	嗔
kbh	嗤
krd	嗥
kit	嗨
kdw	嗪
kaw	嗬
kjs	嗮
kld	嗯
kwl	嗰
kgq	嗷
koa	嗻
kyt	嗾
kyu	嘀
kdh	嘁
kov	嘃
kgh	嘕
kha	嘘
kih	嘙
kqe	嘝
kft	嘟
kme	嘣
klm	嘪
ksj	嘾
kaq	噆
kcn	噊
kfp	噎
ktm	噢
gkk	噩
kah	嚂
kog	嚉
kfn	嚋
kos	嚒
kka	嚚
krx	嚛
kfw	嚯
klu	嚺
kyr	囄
mng	囙
lhn	四
lft	团
mwm	囧
tlq	囱
lfn	围
lwx	囵
lwy	囹
lck	囼
lgk	圄
lcm	圎
fsh	圢
fqb	圥
ffn	圬
fnn	圮
dff	圶
fnr	场
jff	圼
fgb	坉
iff	坔
fde	坜
fqn	坞
bwf	坠
fpx	坨
faf	坩
fdh	坯
gaj	型
sff	垔
waf	垡
fyr	垴
fpv	垵
feb	垺
fmy	垻
foc	垿
fgj	埂
mif	埊
fge	埔
fkm	埙
fak	域
inx	埿
feq	堄
fwy	堆
fqk	堍
fjx	堒
bde	堕
fvt	堖
fwn	堠
wks	堡
fjg	堤
fxx	堦
faj	堰
lif	塁
ikg	塣
fon	塶
fov	墉
fyu	墒
ffu	墙
fog	墣
lfo	墨
fyk	墩
bxg	墬
fam	墴
yxt	壅
fah	壏
hpg	壑
fbx	壣
fgh	士
ttn	夂
bci	夃
edh	夓
qbn	夗
nwi	夬
diu	夵
ddy	夶
dkf	夻
dar	奁
dsk	奇
dwg	奉
dje	奛
vvg	奻
vyv	奿
vqy	妁
ynv	妄
vpq	妉
vfj	妌
vwc	妐
vcn	妑
vyn	妒
vyw	妔
vtd	妖
vfc	妘
vwv	妢
vdh	妦
vfq	妧
vyt	妫
vdg	妬
vth	妰
qbv	妴
vqk	姁
vgm	姉
vtn	姊
vmf	姌
vaf	姏
vtm	姠
vrg	姤
vrh	姩
vah	姫
vgj	姮
vde	姷
vmg	娉
vie	娋
vjf	娌
iit	娑
vnt	娓
vdq	娔
vfh	娬
vct	娭
vwn	娰
vkg	娱
vbc	娵
vad	娸
vxy	娹
vvi	娽
bsk	娿
vuk	婄
ihc	婆
ves	婇
vhd	婔
veq	婗
vud	婘
vyk	婛
vld	婟
vge	婧
vmd	婩
vgl	婳
vnk	媁
vft	媎
vdm	媔
vam	媖
vxx	媘
vnh	媚
veg	媛
tov	媝
van	媟
vjh	媢
vle	媦
vhv	媫
vwk	媬
vbh	媸
vgx	嫊
vep	嫒
vqm	嫓
vat	嫕
vjl	嫚
vov	嫝
vip	嫦
vak	嫨
vgk	嫩
voa	嫬
vha	嫭
vfu	嫱
vos	嫲
vdu	嫴
vue	嫺
vlf	嫼
vuj	嬂
vfp	嬄
vry	嬓
vou	嬚
vlg	嬛
vkk	嬠
vpn	嬣
vfn	嬦
voo	嬫
vem	嬹
vaa	嬺
vmm	孆
vmw	孈
vau	孏
bgd	孒
byi	孓
fpb	孛
ftb	孝
vcb	孥
uxx	孳
bmm	孾
pyy	宀
pxb	宆
ptk	客
pde	宥
pft	宯
puf	宰
pks	宲
pdh	害
pcu	宻
pwd	宿
pqk	寃
pnt	密
phm	寊
pnl	寍
pfh	寘
plv	寠
pnh	寤
paw	寨
pmd	寷
yfy	対
tmd	射
iyu	尐
wiu	尒
wqb	尣
atg	尧
yki	就
nng	尸
npw	屄
nld	屇
nkm	屌
ntf	屐
nmi	屓
nfi	屚
nov	屡
nto	屦
nmm	屭
gbn	屯
mvy	屻
mfh	屽
mrc	岅
mqb	岇
mqr	岉
mby	岋
mfq	岏
wvm	岔
mwj	岕
qyn	岛
mth	岝
mmd	岟
mhc	岥
meg	岨
mxj	岪
mmg	岫
mxe	岰
mkq	岲
mdf	岸
mvg	峍
mpv	峖
mtd	峤
mww	峪
mah	峫
mtj	峲
irm	峾
mgk	峿
map	崂
mqe	崅
mij	崉
mqa	崏
mld	崓
mwy	崔
myk	崞
mtv	崣
mgv	崨
mmj	崱
mdg	崴
myu	崹
myt	崺
mkk	崿
mut	嵃
mwg	嵛
mdw	嵟
mwc	嵡
mov	嵣
mjf	嵵
mxk	嵹
maq	嵽
mlr	嶃
mwv	嶋
mds	嶏
mqk	嶑
mto	嶓
mdu	嶚
mog	嶫
mkb	嶯
mlh	嶵
mfn	嶹
mue	巄
moo	巆
mak	巏
vnn	巛
bnn	巜
kth	川
ijs	巣
vlr	巤
awy	巩
cay	巯
cnh	巴
awn	巷
ymh	市
vmh	帇
mhp	帎
mhr	帙
rmh	帛
mhh	帧
dtb	帮
mhw	帷
ipk	常
mhg	帻
mhj	幌
mhe	幍
ajd	幕
mhu	幛
mht	幡
mhi	幥
mhq	幨
fgg	干
rhf	年
xnn	幻
owj	庎
ocn	序
ofy	庒
oqn	庖
ohk	店
olk	庘
owf	府
oye	庡
ogc	庢
oqi	庣
owg	庩
otf	庭
ofw	庱
oao	庶
oal	庿
oyv	廊
ouk	廍
oxd	廎
orx	廏
ojf	廛
onf	廜
oqe	廨
vpv	廵
mpd	廸
rpd	廹
lkp	廻
xxn	弜
xbh	弢
xca	弪
xah	弬
xee	弸
xkj	强
xgm	弻
xil	弾
xja	彃
xue	彅
xvf	彇
xhh	彏
vng	彐
vow	彛
vfa	彟
haw	彪
ttt	彳
tav	彻
tqa	彽
tsg	徆
tnk	徫
nyn	心
nyy	忄
fnu	忈
nnn	忋
ghn	忑
nfh	忓
ynn	忘
nby	忣
nwj	忦
npq	忱
nrb	忷
nnh	忸
wvn	忿
wwn	怂
nth	怍
nqk	怐
nvc	怓
nmg	怞
nqa	怟
nfc	怯
ngm	怲
nkq	怳
nkw	怾
nqi	恌
nws	恘
dhv	恝
ntk	恪
nwc	恱
gog	恶
ndd	恹
nie	悄
ton	悉
nfp	悖
njf	悝
nkn	悞
wht	悠
kkh	患
ynu	悥
wqi	您
fpw	悫
egc	悬
nfu	悻
nhj	悼
nqe	惂
njs	惈
nrq	惞
nwy	惟
tgh	惩
nag	惬
nul	惮
nmd	惴
nrg	惶
adk	惹
njg	惿
nlg	愄
wge	愈
nwg	愉
nat	愍
ntj	愎
npt	愘
njl	愠
nam	愥
nkh	愦
hhn	愳
nee	愶
ice	慂
npj	慏
nla	慖
lrn	慙
nip	憆
nwf	憏
noo	憦
nbt	憨
nue	憪
nva	憳
ndg	憾
nkk	懆
scn	懋
nep	懓
nea	懚
nxt	懝
nah	懢
fpg	懿
nos	戂
nhh	戄
dnx	成
akd	戓
akg	或
bcl	戤
jtg	戥
ila	戦
ynm	扁
ynh	扉
rvn	扏
rcy	払
rnr	扬
rjg	抇
reg	抈
rnw	抉
rny	抋
rrh	抙
rgu	抨
rjh	抻
rek	拁
rxj	拂
rug	拌
vcr	拏
rqk	拘
rdf	拜
ran	拣
raw	拱
rwg	拴
rff	挂
rah	挋
rye	挔
rtd	挢
rng	挧
rtf	挺
rgk	捂
rvt	捃
rjf	捍
rke	捐
rge	捕
rlh	捙
rkk	捛
rqy	捣
rtv	捼
ryw	掖
rnb	掘
rak	掝
ryk	掠
rpw	探
rwy	推
rgd	掭
ryn	掮
rhe	掯
rwv	掰
rlg	掴
rud	掷
rdw	揍
rea	揑
ruj	揞
rvc	揤
rxx	揩
rto	揪
rsj	揸
rjl	揾
rna	搌
ryx	搐
ruv	搛
reh	搜
rcc	搡
rov	搪
rbc	摄
rha	摅
rlp	摙
raj	摸
rxk	摾
rip	撑
roq	撛
rfw	撵
rfk	撷
rqg	撸
rdg	撼
rfj	擀
rlq	擉
rnk	擗
rje	擝
rth	擤
rll	攌
ros	攠
fcu	支
fty	攼
rty	敀
hkh	敁
ywr	效
txt	敏
wgi	敛
imk	敞
jsh	敤
ooh	敥
jgq	敭
ykm	敲
geh	敷
ybf	斊
yhq	斍
yyv	斏
qkr	斪
ywu	於
yup	旁
ytm	旃
ytt	旌
yvg	旔
ytd	旖
rxa	旣
jjj	日
jfh	旪
jfj	旱
jqy	旳
jyy	旼
jgb	旽
jdw	昃
jrc	昄
jyr	昘
jfc	昙
jbm	昢
jgs	昩
jvk	昭
jae	昮
jgh	是
yni	昶
jlf	昷
jab	昻
jig	晄
jgc	晊
jtm	晑
jpl	晖
jhq	晛
jma	晪
jyk	景
jeq	晲
jpq	晼
jhd	暃
jwg	暌
jam	暎
jfm	暔
jpj	暝
vca	暨
jri	暭
jwy	暹
jsj	曋
jip	曭
jkk	曮
jhk	曱
jxy	曵
qrj	曶
gma	曹
ulj	曾
ewv	朌
ebm	朏
eyv	朖
yne	望
sss	木
swy	朲
set	朸
snh	朻
sgn	朽
scy	杈
sgq	杌
sqy	杓
sdy	杕
sxn	杛
snn	杞
saf	杢
shg	杫
syw	杭
stf	杵
srh	杽
seg	枂
sxx	枇
sah	枒
sww	枞
sfc	枟
gmi	枣
smy	枬
sgu	枰
sqk	枸
san	枻
ans	枼
sgm	柄
sug	柆
sty	柇
svk	柖
sdg	柘
sjh	柛
sry	柝
smf	柟
src	柧
sxj	柫
sdc	柭
snt	柲
scf	柽
srg	栀
sqb	栁
sfi	标
shn	栌
swg	栓
see	栛
std	栝
sui	栤
sjx	栧
sqc	栬
sbg	栮
sde	栯
sft	栲
stm	栴
sig	桄
sag	框
vks	桇
sgc	桎
smg	桐
ccc	桑
svq	桚
sgo	桠
uqs	桨
sgv	桱
sgj	梗
smw	梣
hkc	梷
stj	梸
ses	棌
sld	棝
slt	棞
smu	棡
sqv	棦
seb	棴
sbc	棷
ssw	棼
seq	棿
syk	椋
sfh	植
svl	椔
spg	椗
sjj	椙
sow	椨
spe	椬
smd	椯
sad	椹
sue	椾
sdw	椿
spt	楁
smn	楇
sut	楌
spl	楎
sdh	楔
svc	楖
sqr	楤
ssl	榃
sjt	榄
sus	榇
svv	榋
snu	榌
sni	榍
spu	榟
spj	榠
ser	榣
sji	榥
spw	榨
sha	榩
slw	榲
swn	槌
suv	槏
scc	槡
spd	槣
slp	槤
sqe	槲
sjl	槾
srr	樊
smm	樱
sva	樳
sdu	橛
syq	橠
soo	橩
sae	橵
sma	檂
bea	檃
slh	檌
sog	檏
sqd	檐
sea	檓
snk	檘
slf	檡
syl	檩
sxr	檰
soa	櫎
sqo	櫯
sav	櫹
shh	欔
sll	欙
uqw	次
wwk	欲
ctd	欸
sks	歌
hff	歭
hxj	歶
gqt	歼
gqw	殄
gqe	殍
gqk	殒
gqf	殖
gqp	殡
gqh	殩
wcu	殳
eow	毇
xbn	毑
txy	毓
ykp	毫
tfn	毯
cde	毵
jnt	毾
rnt	氡
rnd	氪
rnj	氲
iii	水
iyy	氵
nii	氹
iet	氻
ifh	汁
giy	求
iwy	汃
ign	汅
tyi	汆
icy	汊
idy	汏
ibg	汓
itn	汔
inf	汛
ijg	汩
iyt	汸
icn	沀
itd	沃
pqi	沊
inh	沑
ihg	沚
ide	沥
isy	沭
idf	沯
idg	沰
idc	沷
ilg	沺
iqk	泃
iek	泇
int	泌
imd	泱
iyn	泳
ive	泿
ido	洃
ild	洇
iug	洋
itf	洗
img	洞
ivg	津
ivk	洳
iyj	浏
ivf	浔
icw	浚
ige	浦
ifo	浾
ijf	涅
iux	涕
icc	涰
ipg	淀
iad	淇
iqo	淗
ipf	淙
isw	淞
qiu	淾
ito	渊
igm	渍
ifn	渎
iqg	渔
ipj	渖
isj	渣
ijl	温
iaw	港
ird	湃
ink	湋
iwv	湓
ish	湘
irg	湟
ihd	湨
ixg	湪
isf	湮
ikh	溃
iov	溇
ibc	溋
iuv	溓
ifc	溘
iqy	溜
iss	溧
ith	溴
ipw	溶
eud	滕
iyw	滚
idh	滟
iag	满
iap	滢
iyo	滦
iwh	滫
iha	滹
ieh	漞
igk	漱
ikk	漶
iav	潇
idu	潦
iul	潧
iqt	潴
iuj	潼
ioq	潾
iwg	澄
iyc	澈
inb	澉
ifk	澎
iqe	澥
iaj	澫
iuq	澬
ikb	濈
ihh	濒
iyk	濠
iqp	濥
iog	濧
ibk	濻
ioj	瀍
ifj	瀚
inl	瀷
ijy	灏
oyy	灬
goi	灭
ovt	灱
qoi	灳
fou	灻
owc	炂
oty	炇
odh	炐
ouf	炓
onw	炔
oyw	炕
ojg	炟
osy	炢
osk	炣
otb	炧
opx	炨
oan	炬
ock	炲
ogm	炳
oyg	炷
otm	炿
otl	烅
gqj	烈
wso	烋
ote	烐
oaa	烒
off	烓
oaw	烘
opt	烢
odo	烣
oah	烥
inr	烫
rvy	热
otx	烸
oof	烾
omy	烿
oux	焍
ols	焑
okk	焒
oqh	焔
dtf	焘
ojx	焜
oyk	焞
opq	焥
oee	焩
orq	焮
ooo	焱
oyc	焴
jjo	焸
omu	焹
ojt	焺
org	煌
hho	煛
olg	煨
vgq	煭
ode	煳
ojl	煴
ofm	煵
ove	煺
oyn	煽
orn	熂
oth	熄
cex	熊
opk	熍
oer	熎
opj	熐
ykb	熟
onr	熠
olv	熡
onu	熤
xod	熲
oul	熷
ofa	燌
odu	燎
ova	燖
ojy	燝
yoo	燮
ouj	燱
ojv	燳
oma	燶
ofn	燽
oda	爄
qod	爒
ojj	爞
ofk	爧
rhy	爬
egd	爰
tet	牞
tyt	牥
ttf	牦
tay	牫
tmg	牰
tpb	牸
tjt	犁
tnh	犌
tvg	犍
tyn	犏
tvl	犣
qtd	犹
qtm	狈
qtq	狍
qtp	狩
qtg	狭
qtj	狮
qtx	狴
qtk	狷
qte	猊
qtb	猛
qtw	猞
qta	猫
qtl	猬
qtc	猱
qtu	獐
qtt	獯
gyi	玊
gnn	玌
tff	玍
gwy	玐
gkh	玔
geg	玥
gwb	玱
gte	珘
gng	珝
gqi	珧
giv	珰
gtx	珻
gmy	珼
gyg	琂
grt	琕
gph	琯
ghj	琸
gxx	瑎
gbb	瑘
gpr	瑸
gak	瑾
gyt	璇
gmm	璎
gam	璜
gha	璩
gpl	璭
gvh	璶
udr	瓣
ykk	瓤
pqg	瓭
sfg	甄
lvg	甊
alp	甍
aaf	甙
tgl	甥
qre	甮
mhn	由
tld	甶
ilf	畄
jhn	畅
lge	畏
ylw	畒
lrc	畖
ykl	畗
lmf	畘
lwe	畛
flq	畞
rlf	畠
tol	番
ljg	畼
loq	疄
ubk	疖
uqy	疚
uoi	疢
uyg	疰
uek	痂
ueh	痈
uji	痋
ugx	痍
uff	痔
udh	痞
ufn	痣
uap	痨
uhd	痱
utd	痴
ulg	痹
uyw	瘀
uge	瘃
uul	瘅
uwn	瘊
uew	瘐
urq	瘣
unw	瘳
uak	瘽
uma	癑
uuj	癔
ugk	癞
wfj	癷
rnn	癿
rqb	皃
rcn	皅
rrc	皈
rmn	皑
qvh	皱
cwt	皴
hae	皻
blf	盁
tlf	盉
qbl	盌
fxy	盏
jty	监
hyn	盳
hfi	眎
hjh	眒
hqa	眡
hnx	眤
hdx	眬
hqk	眳
hqj	眴
hag	眶
hud	眹
hug	眻
ugh	着
hkg	睈
hrd	睎
hma	睓
hpq	睕
hyw	睟
hwy	睢
hgi	督
hlg	睤
hmf	睭
hvg	睷
hwn	睺
hwg	睽
hfc	瞌
hyk	瞓
haj	瞙
hyr	瞝
hfk	瞦
hhp	瞾
htm	矀
hto	矁
hkk	矂
hrp	矈
hhw	矍
hha	矑
tdk	知
tdx	矧
tda	矩
tdw	矬
dsh	矴
djh	矵
dwy	矾
diy	砅
dhd	砉
dhg	砋
dby	砐
dfn	砖
dfc	砝
dxy	砪
vcd	砮
ddg	砳
dve	硍
dga	硎
dgu	硖
day	硭
dfo	硳
dee	硼
dlt	碅
dpg	碇
daa	碊
dms	碋
dgx	碡
dyn	碥
dnh	碬
dyu	碲
drh	磃
dug	磋
dqa	磔
dyw	磙
drv	磤
oss	磨
dam	磺
dco	礟
dux	礠
dak	礶
pyg	祆
pyh	祉
pyd	祓
pyq	祧
pyk	祸
ylk	禀
pyu	禅
wyr	禽
tuf	科
txx	秕
tdg	秙
tty	秝
tgs	秣
tck	秮
tpe	秾
tkg	程
twy	稔
tjs	稞
tmf	稠
qgt	稣
toj	稥
tdn	稽
tvc	穊
tfu	穑
tgj	穗
pwq	穸
pwa	空
pwg	窀
pwt	窄
pwx	窈
pwv	窘
pwk	窜
pww	窬
pwo	窲
pwr	窳
ufh	竍
uaj	竎
uug	竝
ukq	竞
ujf	章
ucw	竣
upe	竩
uqv	竫
ujq	竭
ter	竻
tfj	竿
tqr	笏
tmq	笕
tbm	笜
tlc	笝
tth	笮
tsk	笴
tak	笸
tep	笾
twg	答
tjg	筛
tqv	筝
trc	筢
taw	筮
tie	筲
tdt	筹
tkm	筼
tlg	箅
tra	箝
tjx	箟
tgm	箦
tag	箧
tyk	篙
tah	篚
tbi	篜
tam	篝
tij	篞
ttd	篷
tve	簋
tlm	簤
tpy	簶
tad	簸
trq	籀
tdi	籍
tsq	籕
otn	籺
omh	籼
sou	粟
omm	粣
oeb	粰
ivw	粱
hqc	粲
oqa	粼
opf	粽
own	糇
oxu	糑
ocy	糔
oug	糕
oip	糛
oov	糠
oob	糭
ofd	糯
xet	糼
yxi	紊
xdn	紌
xdy	紎
xuf	紏
xxh	紖
xcn	紦
xrw	紩
xdj	絔
xlk	絗
xgj	絙
xgh	絚
xgc	絰
xrd	絺
xkk	絽
xgk	綀
xdw	綊
xeb	綒
xon	継
xss	綝
xpq	綩
xgv	緁
xoo	緂
xam	緓
xim	緔
xyj	緕
xal	緢
xrb	緵
xsf	緸
xck	緿
xve	縁
xuk	縂
xdg	縅
xpd	縖
xwh	縧
erm	繇
xhq	繉
xvo	繍
xae	繖
xus	繜
xaq	繱
xyl	繵
xma	繷
oxi	纇
xoj	纒
xll	纝
xgf	纡
xtn	纥
xvy	纨
xfn	纬
xxx	纰
xnh	纽
xan	绁
xta	绛
xux	绨
xsh	缃
xdm	缅
xkh	缋
xwg	缏
xri	缐
xwn	缒
xeg	缓
xxg	缘
xgo	缙
xdf	缛
xtd	缝
xfk	缬
xug	缮
xul	缯
xlg	缳
xtf	缵
rma	缸
rmq	缼
rmm	罁
mmr	罂
rmx	罆
mri	罓
pwf	罕
lyg	罜
lss	罧
lfh	置
lln	罳
lfc	罴
ldo	罽
lak	羁
ugo	羔
ugq	羝
ugu	羡
ugc	羧
ugm	羰
naj	羿
nvf	翆
ugn	翔
nuv	翣
gkm	翮
nlp	翴
fte	耂
dii	耖
dit	耗
dif	耘
dia	耢
dio	耱
bwv	聁
bmf	聃
bwy	聆
bdm	聏
bbg	聑
brt	聛
bpw	聜
bua	聠
bpg	聢
bxx	聨
bwc	聬
bfl	聴
nbf	聼
enn	肊
eqy	肑
ebn	肔
evy	肕
eet	肜
ecy	肞
edn	肬
ejh	胂
mef	胄
eth	胙
esk	胢
vcm	胬
eyn	胲
emg	胴
qrb	胷
eqc	脃
edo	脄
erh	脌
epe	脓
yom	脔
epf	脘
efc	脚
eyk	脝
etx	脢
erd	脪
ekm	脶
egv	脻
eyw	腋
edj	腌
elg	腘
ewg	腧
emd	腨
ecn	腬
ekk	腭
erf	腯
evg	腱
eew	腴
edm	腼
yte	膂
ege	膊
etl	膍
eaj	膜
elv	膢
epw	膣
eyu	膪
edu	膫
eto	膰
erl	膴
eay	膵
naw	臀
eou	臁
elq	臅
efk	臌
efd	臑
eaw	臒
ead	臓
eon	臕
eak	臙
ahn	臣
thd	臭
ewi	臾
wfk	舒
qah	舛
epq	舜
tev	舠
tem	舢
tec	舥
tey	舫
tek	舯
tew	船
tes	舾
tei	艄
teb	艋
teu	艏
tej	艒
teo	艔
tee	艘
tea	艨
aer	艻
awb	芁
anb	芑
abf	芓
axx	芘
agb	芚
awc	芟
ayu	芠
ayn	芦
afq	芫
amw	芮
afc	芰
aou	苂
aav	苆
amf	苒
avk	苕
ahf	苜
axc	苰
arc	苽
axj	茀
adc	茇
adx	茏
aqy	茑
avg	茟
adh	茬
ayw	茭
ari	茱
alk	茴
ald	茵
awg	荃
agu	荚
awf	荟
ayj	荠
any	荩
abi	荪
anu	荬
agk	荳
aws	荷
agi	莍
aii	莎
atx	莓
atf	莛
apf	莞
aeb	莩
avc	莭
ale	莮
aqt	莸
abk	莻
age	菁
abc	菆
arm	菗
auf	菛
arp	菦
auv	菨
abr	菰
afw	菱
agc	菿
aqr	萄
ahq	萈
aec	萉
aig	萍
arv	萔
aeq	萖
adf	萘
amh	萜
ato	萩
apg	萱
aew	萸
auj	萻
akk	萼
ack	葈
avv	葌
aiv	葏
aff	葑
axb	葞
aue	葥
ade	葫
anh	葭
adm	蒇
akh	蒉
auq	蒋
aov	蒌
afh	蒖
aiy	蒗
ate	蒩
aee	蒯
aex	蒵
axw	蒶
axu	蒻
ayk	蒿
ayv	蓈
aft	蓍
aqg	蓟
ayr	蓠
acn	蓣
apq	蓥
atd	蓬
ahl	蓾
apw	蓿
aoj	蔊
aon	蔍
acc	蔘
aho	蔝
agh	蔫
arq	蔸
asj	蕈
alm	蕒
aia	蕖
axq	蕝
adu	蕨
ayx	蕹
akb	蕺
atm	薁
avd	薅
afk	薣
agq	薤
alf	薯
afd	薷
ahw	藈
adi	藕
all	藟
alc	藣
ait	藩
aus	藽
arl	蘀
atq	蘅
abe	蘟
are	蘤
aam	蘳
asg	蘸
aos	蘼
aem	虋
jvt	虭
jyn	虻
jyt	蚄
jga	蚈
jxx	蚍
jjg	蚎
jeg	蚏
jmy	蚒
jrh	蚚
jgg	蚟
jwv	蚡
jwr	蚥
bhg	蚩
juf	蚪
jrg	蚯
jxe	蚴
jry	蚸
jhc	蚾
jcf	蛏
jde	蛕
jug	蛘
jve	蛝
jee	蛠
jua	蛢
jgx	蛦
jmr	蛧
jat	蛲
jef	蛶
jce	蛹
jtn	蜁
jtj	蜊
jyv	蜋
jke	蜎
jtb	蜏
jth	蜒
jtf	蜓
jtd	蜘
jsw	蜙
jad	蜞
jyc	蜟
srj	蜤
jsr	蜥
jgv	蜨
jmf	蜩
jjq	蜴
jge	蜻
jhg	蝆
jpg	蝊
jiw	蝋
jnh	蝑
jdm	蝒
jcn	蝚
jqm	蝜
jgk	蝠
jdf	蝰
jyu	螃
jex	螇
jov	螗
juw	螠
jag	螨
jwh	螩
jgm	螬
jaq	螮
jon	螰
anj	螶
tuj	螽
jto	蟋
jav	蟏
juj	蟑
jhx	蟕
jwa	蟘
jia	蟝
jnn	蟤
joo	蟧
jgj	蟪
jrl	蟱
jap	蠓
jfd	蠕
jaw	蠖
xge	蠡
dwj	蠢
uwl	蠲
jmm	蠳
jhh	蠼
tln	衄
tig	衍
tgk	衙
thh	衢
puy	衤
puh	补
ykg	衰
pum	衲
put	衽
yqn	袌
ycn	袤
puw	袱
yee	裒
puv	裙
puu	裥
puc	裰
pug	裱
yjs	裹
pun	裾
puj	褐
puo	褛
pud	褥
pur	褫
yco	褭
pus	襻
sgh	西
sjf	覃
hqr	覐
qih	覜
ecm	覶
aww	觋
hao	觑
qeh	解
ypq	訦
yhg	訨
yny	訫
yit	訬
yty	訸
yhx	訿
yhk	詀
ybh	詜
wyf	詧
yve	詪
yua	誁
yqq	誃
ygc	誈
rry	誓
yxy	誸
uyd	誾
ycc	諁
yfm	諵
yak	諽
yrh	謕
ylg	譞
aqk	警
yea	譭
ybb	讘
yyn	讠
yfh	讦
yfn	讳
yan	讵
ywx	讹
ywc	讼
yth	诈
yng	词
yhc	诐
yag	诓
yff	诖
yri	诛
ywg	诠
yqv	诤
yaa	诫
ytf	诰
ytb	诱
yce	诵
yge	诼
yyk	谆
yad	谌
yyu	谛
yop	谜
ynw	谬
yug	谰
ykh	谴
yqd	谵
yww	谶
gec	豝
gev	豤
mge	豳
efh	豻
exx	豼
erg	貃
eve	貇
etk	貉
ejf	貋
enh	貑
eex	貕
aym	貣
fmn	貮
cdm	貵
mua	賆
mcw	賐
vhg	賮
mjh	賵
mcc	贂
mdy	贆
msj	贉
maj	贎
cmu	贠
mhk	贴
qyv	贸
mad	贼
mft	赌
ovw	赓
dww	赝
ynk	赢
fot	赦
fob	赧
foj	赨
foh	赪
fof	赭
foo	赯
fhn	起
fhg	越
fhu	趑
khb	趿
khp	跎
khh	跛
kht	路
khq	跳
khx	跸
rrk	踅
khn	踞
khr	踬
kho	踮
khm	踹
khv	踺
khc	蹂
khy	蹄
khe	蹈
khj	蹋
khu	蹲
khk	躁
khl	躅
lhc	軙
liu	軣
lxe	軪
lag	軭
ldg	軲
lwf	軵
ldm	輀
mdl	輋
lvt	輑
leq	輗
lbc	輙
lee	輣
lus	輶
ltj	輹
ljl	輼
lvj	轈
lto	轓
laj	轕
log	轛
ldy	轪
ltu	轷
lwg	辁
ltk	辂
lyk	辌
lcc	辍
lxx	辔
tdu	辞
udy	辩
fpk	迀
tfp	迁
gpd	迋
epd	迌
fnh	违
hkp	迠
tbp	迤
qip	迩
qjp	迿
ubt	逆
fbp	逇
tfq	选
uxh	递
wgs	途
gku	逗
gki	速
tfk	造
phn	逭
fwf	逵
gkl	逼
rfh	遁
mdm	遄
jmh	遇
jqw	遏
nhf	遐
uth	道
khg	遗
ehc	遚
usg	遵
nku	避
erq	邈
mbh	邖
ynb	邙
obh	邩
dtk	邫
ogb	邺
rdc	郄
yvc	郎
udb	郑
kgb	郢
bcb	郰
xtv	郷
hnv	郻
ftj	都
kkf	鄂
yxl	鄐
jlc	鄤
xjm	鄪
sgd	酉
isg	酒
sgf	酝
fsg	酨
sgk	酲
sgt	酶
sgg	酾
sgy	醇
sga	醛
sgw	醮
qvt	釖
qvn	釚
qet	釛
qwy	釟
qbg	釨
qdy	釱
qqy	釸
qrh	釽
qeg	鈅
qny	鈊
qfc	鈘
qay	鈛
qxh	鈟
qwc	鈠
qty	鉌
qdg	鉐
qam	鉔
qxj	鉘
qug	鉝
qwi	鉩
qjh	鉮
qaa	鉽
qmm	銏
qws	銝
qfi	銢
qoy	銤
qai	銾
qce	銿
qpf	鋎
qcw	鋑
qfn	鋕
qev	鋖
qbc	鋷
qde	鋹
qma	錪
qln	錷
qav	鍣
qwh	鎀
que	鎆
quv	鎌
qer	鎐
qcc	鎟
qsk	鎶
qpy	鎺
qvm	鎻
qjl	鎾
qxf	鏆
qoa	鏣
qoq	鏻
qmn	鐹
qfa	鐼
qoo	鑅
qog	鑆
lgv	鑋
qpn	鑏
qrr	鑕
qal	鑖
qfl	鑟
qqq	鑫
qpa	鑳
qsr	鑻
qhh	钁
qau	钄
qnn	钆
qhy	钋
qdh	钚
qkh	钟
qqu	钧
qyw	钪
quf	钭
qgh	钲
qft	铐
qmg	铜
qkm	铞
qri	铢
qqi	铫
qqc	铯
qan	铽
qtr	锇
qef	锊
qyc	锍
quj	锏
qaj	错
qjg	锝
qld	锢
qtf	锤
qud	锩
quk	锫
qvg	键
qkk	锷
qto	锹
qnh	镅
qwg	镎
qyk	镐
qpg	镓
qme	镚
qov	镛
qyu	镝
qdu	镢
qqg	镥
qpw	镩
qlq	镯
qou	镰
dcq	镹
dcr	镻
ute	閁
uwy	閄
usk	閅
ufk	閈
umk	閊
ulk	閳
umi	閴
uud	闁
uri	闎
uip	闛
ugd	闩
ucg	闯
udp	闼
ukk	闾
uep	阌
ugl	阑
uwg	阕
bnf	阠
btf	阡
biy	阥
boy	阦
brc	阪
bfc	阹
bhk	阽
bqd	陒
byn	陔
bqh	陥
bwg	险
buk	陪
bad	陿
blg	隈
buv	隒
bgq	隞
but	隡
bkh	隤
btm	隩
bfa	隫
bda	隳
wyg	隹
aht	雅
tkw	雒
mya	雘
wyy	雠
fuf	雴
fdf	雼
fyj	霁
ftx	霉
fia	霟
fer	霢
fie	霪
fkh	露
fll	靁
gep	靛
hdh	非
nka	韍
fjf	韩
hdm	頉
cfd	頚
pvd	頞
xfi	頴
lnd	顋
fdm	顸
rdm	颀
hnd	颅
wyc	领
gud	颊
bcc	颞
agm	颟
fhw	颠
hhd	颦
cow	颿
uwr	飒
kgn	饕
qnr	饩
qnq	饱
qnb	饵
qnf	饽
qnt	饿
qnw	馀
qnc	馂
qne	馊
qna	馍
qnu	馐
vut	馗
tjh	馡
tjj	馤
fnw	馨
cof	馯
cop	馾
coy	馿
cod	駄
con	駅
coa	駆
cot	駇
cor	駈
cog	駍
com	駎
coq	駠
coi	駫
cob	駬
cov	駸
coj	駻
cok	駽
cou	騂
coc	騃
coh	騑
cos	騕
col	騦
coe	騱
coo	驎
cgk	驯
cgb	驰
cgl	驷
cgw	驸
cgy	驻
cga	骁
cgt	骆
cgu	骈
cgc	骏
cgd	骑
cgv	骕
bhh	骘
cgq	骝
mev	骫
mea	骮
mew	骱
meh	骴
meq	骶
med	骷
mey	骹
meu	骿
mer	髀
mep	髂
mej	髃
meo	髍
dce	髯
xox	鬻
rqc	魁
rrq	魄
qow	魜
qot	魞
qoc	魣
qob	魥
qof	魭
qol	鮂
qox	鮄
qor	鮊
qom	鮋
qoh	鮎
qos	鯂
qoj	鯣
qoe	鰀
qok	鱓
qgy	鲂
qgd	鲅
qgg	鲆
ipq	鲎
qgl	鲢
qgj	鲤
qgf	鲮
qgw	鲶
qgn	鲺
qgv	鲻
qga	鲽
qgc	鳋
qgo	鳙
qgu	鳝
qgm	鳢
uwv	鴗
caw	鴘
lwv	鴫
ebc	鵩
qwv	鵭
nbm	鶌
jpv	鷃
lmw	鷶
nqy	鸤
dqy	鸪
tdq	鸹
yoq	鸾
trx	鹅
ajq	鹊
alq	鹋
djn	鹌
mmv	鹦
nwe	鹨
wyo	鹪
oww	鹰
hlo	鹷
hlr	鹾
sso	麓
onj	麟
twi	黍
tqt	黧
ogu	黻
ffx	鼃
rix	鼄
enu	鼹
hbt	齚
hba	齛
hob	齢
hbr	齭
hbe	齯
hbj	齵
hbk	齶
hbu	齸
hbs	齽
hwb	齿
ahk	㐄
snb	㐉
fnb	㐋
tbb	㐌
mnb	㐕
wdy	㐲
wnn	㐶
wrh	㐿
wbm	㑁
wpl	㑮
wlq	㒔
wxr	㒙
wrf	㒶
ueu	㒸
pwu	㓁
udg	㓈
ajh	㓚
avt	㓛
xvt	㓜
rmj	㓡
dlk	㕅
ddd	㕆
dye	㕈
dqd	㕋
ccu	㕛
nmh	㕞
kwy	㕥
kdu	㕦
knt	㕧
kpq	㕪
krb	㕳
kgg	㕶
kug	㕸
kdc	㕹
tkf	㕿
kwh	㖉
kkv	㖐
kux	㖒
kep	㖟
kuk	㖣
kqa	㖧
kvi	㖨
kbc	㖩
ksf	㖶
kaf	㖼
kqb	㗙
kbq	㗦
qko	㗮
kvf	㗲
koo	㗵
kpa	㗷
kxt	㘈
ktv	㘉
kfy	㘊
lci	㘝
lnt	㘠
lig	㘢
lke	㘣
fet	㘦
qfh	㚈
bqq	㚉
rdu	㚖
wvg	㚢
vgf	㚥
vnf	㚨
vpw	㚮
vhk	㚲
vek	㚳
vqt	㚹
vkq	㚾
vye	㛄
vbg	㛅
vbs	㛆
vof	㛇
vws	㛊
vga	㛞
vpf	㛡
vuf	㛨
vyc	㛩
vaj	㛭
vpo	㛽
vsh	㜀
vyx	㜅
vop	㜆
vvk	㜉
vuw	㜋
vex	㜎
vqd	㜣
vsj	㜤
vni	㜨
val	㜴
xbg	㝀
brr	㝂
bfk	㝆
pgf	㝉
pqy	㝌
pyr	㝑
pdf	㝒
pyf	㝘
pbc	㝡
pam	㝤
pov	㝩
pbm	㝮
pth	㝰
vav	㝷
nud	㞐
nqq	㞔
maf	㞬
dmj	㞭
nmj	㞯
msk	㞹
tmj	㟀
meb	㟊
myv	㟍
mvt	㟒
mxq	㟜
msw	㟣
mpl	㟦
mpj	㟰
mss	㟳
lrm	㟻
mnr	㠄
muj	㠉
msf	㠒
mtq	㠟
myc	㠡
mos	㠧
msr	㠨
hnn	㠯
qbm	㠾
mhx	㡉
tom	㡑
mhl	㡞
oud	㡴
okw	㡶
ods	㢊
omn	㢐
oha	㢒
mkp	㢠
xgd	㢧
xfh	㢨
xhc	㢭
xuv	㢺
xbx	㢽
xyc	㣃
aet	㣉
cke	㣍
tsh	㣔
nyu	㣺
rnu	㣻
nny	㤈
nps	㤖
nyc	㤝
njr	㤤
nfo	㤸
fln	㥁
nug	㥃
nvi	㥆
nqo	㥌
nma	㥏
njm	㥥
neh	㥰
nrh	㥴
owv	㥹
dtx	㥻
nly	㦒
nog	㦠
nbe	㦩
ria	㦵
nra	㦻
rbh	㧄
ryt	㧍
ryc	㧤
rhv	㨗
rce	㨢
rot	㨩
rml	㩄
rja	㩧
xjt	㪄
eqh	㪒
you	㪰
yqm	㪱
lvu	㪹
ywy	㫃
jaj	㫒
hjf	㫖
jou	㫧
jgo	㫫
jfo	㫱
jck	㬃
jqv	㬠
sxy	㭃
sre	㭛
sef	㭩
sbn	㭯
hxg	㭰
say	㭶
soq	㭽
sjq	㭿
sbi	㮀
hds	㮂
hlw	㮚
seu	㮳
sor	㯅
seh	㯒
slq	㯮
sob	㯶
sdd	㰁
srm	㰃
skq	㰤
liq	㱎
fhf	㱏
hqu	㱑
hjx	㲃
eft	㲕
abt	㲨
inn	㲸
ian	㲺
wiy	㲻
iry	㲼
ieg	㳉
ity	㳊
ikr	㳏
iye	㳖
ibn	㳧
ief	㳫
iks	㳭
ibj	㳱
ibd	㴍
iou	㴑
iqv	㴔
ibp	㴷
iun	㵍
ien	㶀
ibe	㶏
ico	㶠
oqy	㶤
ofh	㶥
ogs	㶬
oeh	㶲
ope	㶶
okm	㶽
oce	㷁
ojs	㷄
bco	㷅
ojq	㷎
ojm	㷒
ooq	㷠
boo	㷦
ufo	㸉
tfh	㸩
tkh	㸪
trh	㸫
gjh	㺫
gbg	㺭
gsy	㺷
ghg	㺺
gmk	㺾
gce	㻆
gvi	㻖
gjl	㻴
drc	㼋
jlr	㼔
pxg	㼠
mcb	㽕
lqk	㽛
lqo	㽤
lux	㽧
uii	㽷
upq	㽸
udd	㽽
urc	㽿
upx	㾃
umd	㾄
umf	㾆
uhn	㾎
uyv	㾗
uqd	㾣
ujs	㾧
ume	㾶
uaq	㿃
uha	㿖
rrg	㿟
hcc	㿬
hcv	㿳
hcj	㿸
hcf	㿹
flf	㿻
psl	㿾
hvy	䀔
hav	䀙
hqb	䀚
huf	䀞
hhg	䀠
hhk	䀡
hnt	䀣
htn	䀥
htd	䀨
hgk	䀳
hgv	䀴
dch	䀾
hbl	䁅
heg	䁔
huv	䁠
hyt	䁢
hgj	䁣
had	䁰
hvl	䁽
hyx	䂅
dsu	䂞
dyg	䂴
djx	䃂
dlp	䃛
dyl	䃪
dvl	䃳
dyc	䃵
dos	䃺
tnn	䄫
tbn	䄬
thg	䄳
teg	䄴
trg	䄸
tal	䅦
tqx	䆋
uhk	䇂
uie	䇌
txh	䇙
thf	䇛
tbf	䇯
txm	䈫
tsi	䈾
tpj	䈿
toa	䉀
tsp	䉘
ttm	䉠
tll	䉪
oag	䉺
orh	䉼
uxo	䉾
odg	䊀
osj	䊤
ofp	䊦
oxj	䊧
olh	䊫
xmr	䋄
xsk	䋍
xvg	䋖
xdi	䋘
xng	䋚
xiv	䋝
xbs	䋪
xsw	䋱
xrf	䋸
xbc	䋼
xov	䌅
xer	䌊
xaw	䌋
xnr	䌌
xpn	䌏
xeh	䌐
xos	䌕
xrl	䌗
xso	䌚
xog	䌜
xuq	䌪
xni	䌵
xmk	䌹
lah	䍓
ldc	䍔
lqn	䍖
lyv	䍚
lij	䍝
lon	䍡
lrl	䍢
njx	䎈
beg	䎳
bjh	䎶
bpu	䏁
beh	䏂
bpj	䏃
bsf	䏇
bjx	䏉
enf	䏔
eit	䏚
eby	䏜
egs	䏞
eug	䏠
emf	䏥
ect	䏬
ehq	䏹
eaa	䏼
evi	䐂
ees	䐆
ewc	䐋
ejg	䐎
ean	䐑
edq	䐒
eno	䐖
edb	䐛
eam	䐟
eqb	䐢
eaq	䐭
etm	䐿
emm	䑍
awu	䒔
aiu	䒕
axh	䒡
ajf	䒤
atu	䒩
ajx	䒶
aye	䒾
aoq	䓎
agx	䓯
ahx	䓱
apy	䔃
axd	䔛
abm	䔜
avo	䔥
abd	䔺
afo	䕋
ajg	䕎
ame	䕧
arh	䕫
aoy	䕲
aog	䕺
bha	䖎
bmh	䖓
jfy	䖞
jit	䖢
jdg	䖨
jlh	䖬
jre	䖰
jaa	䗃
jph	䗆
jtv	䗻
jww	䘋
ajm	䘍
hqf	䙸
fih	䙿
kmh	䚋
yjh	䚯
yeg	䚴
ydx	䛋
yxj	䛍
yjx	䛖
yde	䛫
yvj	䜈
yda	䜔
yli	䜚
ear	䝙
enx	䝚
ecw	䝜
eds	䝝
edr	䝠
jcm	䝨
ewm	䝿
mud	䞉
mln	䞏
foa	䞑
fom	䞒
lnh	䡂
let	䡃
lkh	䡅
lrr	䡈
lxc	䡏
llg	䡒
lrq	䡚
hwl	䡞
lhm	䡠
laf	䡷
lug	䢂
cks	䢄
ype	䢍
egp	䢐
vpm	䢜
sbh	䢶
myb	䢷
bmb	䢺
nbh	䣁
kck	䣈
tob	䣋
imb	䣔
lvb	䣚
qhg	䤠
qxg	䤸
qda	䤻
qso	䥔
qjx	䥪
qsa	䥮
qng	䦀
ufd	䦌
utl	䦗
uph	䦡
ucc	䦤
bfh	䦹
bsh	䦺
bnw	䦼
bdc	䧀
bhq	䧋
bev	䧌
byk	䧐
bsw	䧒
bak	䧕
bov	䧡
bog	䧤
bug	䧧
bod	䧪
bqo	䧰
pqw	䧵
flk	䨓
lvd	䫫
men	䯆
mes	䯊
mei	䯑
mex	䯗
xwv	䳇
ebw	䳕
pjm	䴁
hbb	䶔
hbc	䶕
hbw	䶖
hbd	䶝
hbq	䶟
hbm	䶣
hbg	䶦
hby	䶩
