ggll	一
dggg	三
gngd	与
ghnv	丐
nhfd	丑
vygf	丒
fnyi	专
dhgf	丕
gmwi	丙
wwgf	丛
xxgf	丝
bigf	丞
uxgf	丠
gmmk	両
tfcu	丢
gjan	丣
gmww	两
godr	严
fueu	丧
hhll	丨
uygh	丬
njhg	丱
kkhk	串
kkjk	丳
jtyg	临
yyll	丶
ytny	为
fjyi	丼
gmyy	丽
igwg	举
ttll	丿
pppp	之
qngd	乌
thff	乍
tufk	乎
tnii	乐
rgtr	乒
rgyu	乓
tdjj	乔
tfux	乖
tgai	乗
tuxv	乘
nnll	乙
bnhn	也
ghnb	乤
tunb	乥
nnhy	书
ufnb	乧
cknn	乨
hknn	乩
eknb	乫
annb	乬
tufn	乯
nudu	买
tdnn	乱
ebnn	乳
rrnb	乴
ufnn	乵
gehn	乶
iitn	乷
ywun	乻
iygn	乼
fjfn	乾
exin	乿
qjjn	亀
oqan	亃
cnhj	予
qvhj	争
guvh	亊
gkvh	事
gxgd	互
gghg	五
gjgf	亘
gogd	亚
hxff	些
bkcg	亟
ywru	交
yntw	亥
ykbj	亨
yoyu	亪
ykbf	享
ykiu	京
ykps	亭
ykpw	亮
ykjf	亯
yjiu	亰
ykpa	亳
yrve	亵
ylkg	亶
utvo	亷
ykbl	亸
yemg	亹
wwww	人
wynb	今
wtan	仛
wvyy	仞
wtfh	仟
wtnn	仡
wayy	代
wycu	令
nywy	以
hgwu	仧
wyry	仪
wtcy	仫
wrcy	仮
wqbh	仰
wkhh	仲
wxxn	仳
wtgh	件
wwjh	价
wdhh	仹
wtfg	任
wwvt	份
wgxg	仾
wcnh	伃
wxhh	伄
wywn	伉
wvtt	伊
wdbn	伌
wfcy	伎
wdyy	伏
wdhy	伓
wpwn	伔
wdcy	伖
wwwu	众
wdny	优
wfcu	会
wary	伛
wufj	伞
wfnh	伟
wfny	传
waht	伢
wmqn	伣
wtet	伤
wtay	伥
wwxn	伦
wwbn	伧
wqug	伨
wyty	伪
wpgg	伫
wvcy	伮
wnxn	伲
wugh	伴
wwyc	伶
wjhh	伸
wegg	伹
wngk	伺
wnyw	似
wekg	伽
wdhg	伾
whnn	佀
wckg	佁
wghg	佂
wafg	佄
wfiy	佅
wjgg	但
whcy	佊
wvkg	佋
whxn	佌
wqay	低
wygg	住
wdag	佐
wdkg	佑
wsgg	体
wskg	何
wntt	佖
wpxn	佗
wgsu	余
wrwy	佚
wxjh	佛
wthf	作
wqkg	佝
wfvg	佞
wtuy	佟
wqiy	你
wwmh	佡
wang	佢
wehh	佣
wgny	佤
wgig	佥
whgh	佧
wqnn	佨
wwgh	佩
wftx	佬
wdjg	佰
wfhf	佱
wffg	佳
wfkg	佶
wvey	佷
wqdb	佹
wywr	佼
wuqw	佽
wgkr	使
wgaj	侀
wtfq	侁
wkkn	侃
wgcf	侄
wynw	侅
wgxw	侇
wqqy	侈
wdfn	侉
wgqj	例
wync	侌
wffy	侍
wriy	侏
wdeg	侑
wpvg	侒
wvgh	侓
wctg	侔
wdmj	侕
wmgk	侗
wpta	侘
waay	侙
wawy	供
wtey	侜
wyey	依
wdhb	侟
wgud	侠
wkkg	侣
watq	侥
whmy	侦
wmjh	侧
wtdj	侨
wwfc	侩
wyjh	侪
wynv	侫
wpey	侬
wtxy	侮
wntd	侯
wvtk	侰
wdfe	侲
wvpc	侵
wmwn	侺
wukq	侻
wfpb	侼
wlet	侽
wftb	侾
wgjr	便
wevg	俀
wkhy	促
wtry	俄
wgiy	俅
wwgs	俆
wqtg	俇
wtfk	俈
wcwt	俊
wkcn	俋
wweg	俎
wieg	俏
wtjh	俐
wceh	俑
wpfq	俒
wpsy	俕
wwwk	俗
webg	俘
wrdh	俙
wjfg	俚
wqkq	俛
wmgn	俜
wksy	保
wgej	俞
wctd	俟
wkgd	俣
wuxt	俤
wdtf	俦
wgod	俨
wgmw	俩
wwgg	俭
whte	修
wowf	俯
whwy	俱
wywe	俲
whdd	俳
whgc	俶
wecn	俷
wdwg	俸
wdjn	俺
wyce	俼
wrqw	俽
wrtf	俾
wtdk	倁
wrde	倄
wpqb	倇
wwcn	倊
wphn	倌
wukg	倍
wmaw	倎
wgcj	倒
wooy	倓
wnbm	倔
weeg	倗
wimk	倘
whnd	候
wdsk	倚
wmfk	倜
fjfw	倝
wyki	倞
wajg	借
wjjg	倡
wgvh	倢
wfhn	値
wpwa	倥
wudb	倦
wpfi	倧
wndg	倨
wgeg	倩
weqn	倪
whjf	倬
wtvg	倭
wjsy	倮
wswc	倯
wjxx	倱
wgji	倲
wdfa	倴
wfhy	倵
whgw	倶
wdfi	倷
wesy	倸
wgmy	债
wbbh	倻
wfhg	值
wwfk	倽
wxdm	倾
wuvg	倿
wamd	偀
wemf	偁
wuej	偂
wajv	偃
wdmd	偄
wdwj	偆
wnhc	假
wjqn	偈
wtky	偊
wnua	偋
wadk	偌
wjgh	偍
wlge	偎
wyna	偏
wute	偐
wwtj	偑
wxxr	偕
with	偗
wkkk	偘
wyuh	偙
wdty	做
wtfe	偛
wyks	停
wuxe	偝
wans	偞
wsvg	偠
wadn	偡
wujg	偣
wusg	偤
wvgp	健
wnhe	偦
wdqq	偧
whxs	偨
wqmy	偩
wqrn	偬
wyke	偯
wdhd	偰
wlny	偲
wmdj	偳
wjmy	偶
wwgj	偷
wwgb	偸
whtl	偹
wovg	偻
whvh	偼
wfam	偾
wipc	偿
wrqc	傀
wehc	傁
wgxi	傃
wduh	傄
wgef	傅
wabg	傇
wssy	傈
wdff	傉
wamf	傋
wyuy	傍
wfhw	傎
wovk	傏
wexd	傒
wuvo	傔
wpwy	傕
wyxl	傗
wjng	傝
wuga	傞
wyfy	傠
wdwi	傣
wfly	傤
wipq	傥
wmeg	傦
wprw	傧
wyfj	储
wcwy	傩
wcce	傪
wlxi	傫
wmwy	催
wgmj	傮
wmee	傰
wgqt	傲
wdrr	傸
wujq	傹
wwfi	傺
wtlt	傻
wakw	傼
wgho	傿
waqh	僀
wsfi	僄
wlpy	僆
wjlc	僈
wsdn	僊
wwym	僋
wlty	僌
wtge	働
wnnw	僎
wqke	像
wkhm	僓
wusf	僔
wfkk	僖
wooe	僗
wimt	僘
wamw	僙
wdui	僚
wwgu	僜
wnbb	僝
weto	僞
wxxy	僟
wtol	僠
wgjn	僡
weph	僢
wfwj	僣
wkkl	僤
wyky	僦
wulj	僧
wueg	僩
wcnk	僪
wwyo	僬
waqj	僭
wujf	僮
woqh	僯
gmiw	僰
wsoy	僳
wglg	僵
waas	僷
wssi	僸
wkks	僺
wnkf	僻
wmau	僼
wept	僾
wpaf	僿
waqt	儆
wqdy	儋
wryt	儌
wobt	儍
whqo	儏
wjxo	儑
wfdj	儒
wahl	儖
wxth	儗
wkhp	儙
walq	儚
wrlh	儛
wpns	儜
woos	儝
wvln	儠
wlll	儡
whan	儢
woaw	儣
wjai	儤
wflm	儥
wono	儦
wrrm	儨
wmjr	儩
wusq	儭
wudo	儯
waeo	儰
wued	儱
wqky	儳
wlli	儽
wgke	儾
ycqb	充
tfqb	先
igqb	光
wcqb	兊
qkqb	免
tkqy	兎
hjqb	児
qkqy	兔
hnmq	兕
ywcq	兖
fqck	兘
dqfk	兙
ipkq	党
dqtf	兛
rqnq	兜
dqwv	兝
dqtn	兞
ruxq	兠
dqdj	兡
dqdq	兢
dqdf	兣
tynv	兦
wgeb	兪
wgnb	兮
igwu	兴
rgwu	兵
adwu	其
mawu	典
uxxu	兹
wvkx	兺
ufwj	养
uvou	兼
ulgk	兽
urvc	兿
uxlw	冀
ulne	冁
mmgd	册
gmfd	再
mnmb	冎
mwkd	冏
jkgf	冔
pgng	写
prxb	冟
pfqf	冠
pfeu	冡
pgey	冢
pbcu	冣
pqky	冤
pjyw	冥
peqo	冩
ucgg	冯
ugxg	冱
ukhh	冲
unwy	决
uaht	冴
ukqn	况
uckg	冶
uwyc	冷
uugh	冸
udcy	冹
uaiy	冻
utfq	冼
ugqj	冽
uvgh	冿
uqvh	净
uwgs	凃
ugvv	凄
uldg	凅
uwyg	准
uswc	凇
uyki	凉
umfk	凋
ufwt	凌
udgy	减
udwd	凑
umgu	凒
ussy	凓
upjw	凕
uwyf	凖
umwy	凗
uadr	凘
ulff	凙
ussi	凚
uyli	凛
uxth	凝
utao	凞
uflm	凟
wmhk	凧
wfci	凨
qynw	凫
wgjd	凬
wtfw	凭
wdjd	凮
mnwn	凯
wrgd	凰
wgkw	凳
ucow	凴
hghg	凸
hnmg	凹
bibk	函
bkcb	凾
ogub	凿
tnjh	刉
qrjh	刎
rnjh	刏
myjh	刐
gajh	刑
fqjh	刓
nwjh	刔
vvvr	刕
gqjh	列
mrjh	刚
wbjh	创
xjjh	刜
puvt	初
egjh	刞
vkjh	刟
mmgj	删
nnaj	刡
wycj	刢
ckjh	刣
ugjh	判
fcjh	刦
fcvt	刧
qnjh	刨
kejh	别
fxyj	刬
cajh	刭
tdjh	刮
gjgj	刯
gcfj	到
fjvw	刱
ffjh	刲
dfnj	刳
bsjh	刴
rmhj	制
nmhj	刷
udvr	券
rsjh	刹
gmij	刺
yntj	刻
fcvy	刼
wfcj	刽
gudj	刾
mqjh	刿
mnjh	剀
wsjh	剁
yjjh	剂
uxhj	剃
gkuj	剅
yvcj	剆
wwfj	剉
iejh	削
gkij	剌
uejj	前
uavy	剏
kmwj	剐
wgij	剑
ajjh	剒
tqtv	剓
jqrj	剔
ukjh	剖
adwj	剘
uavw	剙
gkvj	剚
pqbj	剜
dskj	剞
cccj	剟
oojh	剡
geyj	剢
vijh	剥
djnj	剦
ndjh	剧
tuxj	剩
uejv	剪
oacj	剫
mdmj	剬
ngcj	剭
gklj	副
pdhj	割
awgj	剳
gjhj	剸
nwej	剹
meej	剻
sfij	剽
akkj	剾
vjsj	剿
wyoj	劁
dubj	劂
twgj	劄
lqjj	劅
ouvj	劆
nkuv	劈
kkkj	劋
wgkv	劎
rrmj	劕
tfqj	劗
ossj	劘
nilj	劚
gqet	劢
iter	劣
eeer	劦
fcet	动
eget	助
vcer	努
qket	劬
vket	劭
dgqe	励
caet	劲
aper	劳
iper	労
uder	劵
uget	劷
ffet	劸
ywre	効
ctge	劺
fket	劼
ynte	劾
rvye	势
dqet	勀
fpbe	勃
txet	勄
gkie	勅
cehe	勇
qkqe	勉
dqee	勊
kmet	勋
udbe	勌
ykie	勍
fwfe	勎
uket	勏
blet	勐
swwe	勑
akfe	勒
xxre	勓
dmje	勔
jhet	勖
anme	勚
wcne	勜
ajde	募
nwee	勠
akge	勤
xkje	勥
rwye	勧
qkee	勨
tdke	勪
tole	勫
hage	勮
ylke	勯
eeen	勰
tgjo	勲
hale	勴
tyce	勶
qwnv	匃
qynv	匄
qryi	匆
qrbk	匈
qrmk	匋
qdjn	匎
dfnn	匏
qgkl	匐
qtmx	匑
qawk	匒
qvcc	匓
xvtr	匘
jghx	匙
aqyi	匛
amhk	匝
aywv	匟
aqre	匢
agyi	匤
alvv	匦
anhf	匨
abhg	匩
aqrj	匫
akhm	匮
akkl	匰
awgw	匳
aflm	匵
aawe	匶
ahhy	匷
atdi	医
ajvd	匽
ayna	匾
aadk	匿
nhgh	卍
wxfj	华
fewy	协
rtfj	卑
ywwf	卒
hjfj	卓
fnud	卖
fmuf	南
fgef	博
yxxf	卛
hghu	卡
hmng	卣
hlru	卤
hlry	卥
ffhy	卦
hmnk	卨
rgbv	卮
qtbh	卯
qgbh	印
qdbb	危
vcbh	即
fcbh	却
qyty	卵
qqbh	卶
udbb	卷
rhbh	卸
bigb	卺
gqqb	卼
rxbh	卽
qtvb	卿
swib	厀
wgsb	厁
dtav	厇
dfyi	压
ddyi	厌
ddxy	厐
drmk	厒
dgcf	厔
dmjk	厕
djfd	厘
djbd	厚
dkrk	厛
dajd	厝
drii	原
dshd	厢
ddyl	厣
dtti	厤
dubw	厥
ddht	厦
dfhw	厧
dgkf	厨
dvcq	厩
dakg	厪
djtk	厬
dadr	厮
dssy	厯
dimt	厰
cccu	厽
egcu	县
gmcu	叀
cddf	叁
cder	参
cccd	叄
cccn	叅
fcec	叆
fcvp	叇
cccc	又
nhcy	収
nhcu	叏
tdci	叐
ntcy	发
gkhc	叓
hgic	叔
epcu	受
yocu	变
wgsc	叙
ugrc	叛
pocu	叜
nfic	叞
ehcu	叟
cccg	叠
hpgc	叡
kkkk	口
dghg	古
knhh	叫
kgnb	号
ngkd	司
kngg	叼
kgfh	吁
ynkf	吂
ktnn	吃
wgkf	合
kmhj	吊
mgkd	同
rgkd	后
gkri	吏
tmkd	向
ktan	吒
kghy	吓
kuhh	吖
kcgg	吗
kvtt	吚
vtkd	君
knhf	吜
gdkf	吞
kwyn	吟
kdyy	吠
kxxn	吡
kwjh	吤
dhkf	否
kgbn	吨
kwvt	吩
kwxn	吪
wynk	含
kywn	吭
kcqn	吮
ynkd	启
kdcy	吰
kfcy	吱
kxhh	吲
kgdu	吴
kitt	吵
knwy	吷
kbyy	吸
kqwy	吹
kwcy	吺
kqrt	吻
kbnn	吼
ktgh	吽
tgkf	吿
kaht	呀
kqug	呁
kdbn	呃
kngw	呉
tfkf	告
kfwy	呋
kufh	呌
ktah	呏
kmwy	呐
kfqn	呒
kann	呓
kdet	呖
kmwu	呙
kwbn	呛
kqng	呜
kynn	呝
kngk	呞
kyxy	呟
ksgg	呠
knna	呡
knxn	呢
kmfg	呥
kxet	呦
kqay	呧
mfkd	周
kkqn	呪
khkg	呫
kguf	呯
hxkf	呰
krcy	呱
khxn	呲
kfiy	味
kqkg	呴
kskg	呵
kvcy	呶
kdhg	呸
kkgn	呺
kjhh	呻
ktuf	呼
wgkb	命
kjgg	呾
kegg	咀
kafg	咁
kamh	咂
kbmh	咄
kqnn	咆
kntt	咇
kxjh	咈
kmdy	咉
kthf	咋
kckg	咍
thkf	咎
kyni	咏
kwfy	咐
krsh	咑
kkwb	咒
kgny	咓
khgh	咔
kekg	咖
kdag	咗
kdmh	咘
kdxy	咙
ktuy	咚
kpsh	咛
kpxn	咜
kxxg	咝
kgah	咞
kdjg	咟
kigq	咣
kpta	咤
kgcf	咥
kgxw	咦
kgqj	咧
uqwk	咨
kugh	咩
nykw	咫
kywr	咬
kfkg	咭
kriy	咮
ktkg	咯
kqjg	咰
kthg	咱
kudy	咲
kynw	咳
kdoy	咴
ktdg	咶
dgky	咸
kpvg	咹
kgjg	咺
kwsy	咻
kldy	咽
kftx	咾
ykeu	哀
kkkf	品
kawy	哄
kqrb	哅
kqqy	哆
kffg	哇
kwgk	哈
fkxy	哉
kdeg	哊
kfbn	哋
krey	哌
ktmk	响
kary	哎
kvey	哏
kagg	哐
kgog	哑
kdpy	哒
katq	哓
kxxf	哔
kmqy	哕
krhf	哖
kwxf	哗
ktgs	哘
kwfc	哙
kxwv	哛
kyjh	哜
kpey	哝
kctg	哞
kxqy	哟
ktfk	哠
kgku	哣
sksk	哥
ktry	哦
kfoy	哧
kieg	哨
kjfg	哩
kngb	哪
kkhy	哫
kwsk	哬
kkdy	哭
kptg	哰
kfpb	哱
rrkf	哲
krrh	哳
kyve	哴
kkej	哵
kefy	哷
kevg	哸
kebg	哹
kgey	哺
kjfh	哻
kykb	哼
kgjr	哽
kukq	哾
eksk	哿
ktbt	唀
kwwk	唂
kqeh	唃
kwyk	唅
kcwt	唆
dfek	唇
kkcn	唈
kctd	唉
kwgs	唋
kthp	唌
kpfq	唍
ktjh	唎
krdh	唏
ovhk	唐
kwwf	唑
kgkg	唔
krfh	唕
kfhy	唗
dckf	唘
kvpc	唚
kgty	唛
gskx	唜
kamy	唝
kruf	唞
fckx	唟
kape	唠
kimy	唢
kran	唣
kqmd	唤
kuwc	唥
kvcb	唧
kbeg	唨
ktvg	唩
kdwg	唪
khaw	唬
kadw	唭
wykf	售
kwyg	唯
knmj	唰
kjjg	唱
keqn	唲
kyny	唳
kufq	唴
kdjn	唵
kajg	唶
kyce	唷
kywu	唹
kmaw	唺
ksww	唻
kuvg	唼
ksrh	唽
ktfg	唾
kqrn	唿
kmfk	啁
kebn	啂
kheg	啃
yumk	商
yumd	啇
kfuf	啈
kssy	啉
kbsk	啊
kesy	啋
kpwa	啌
tfgk	啎
kywf	啐
kgvh	啑
knbm	啒
ynak	啔
kqrm	啕
kooy	啖
kpqb	啘
hxkk	啙
kflk	啚
kgvv	啛
kccc	啜
khdd	啡
krtf	啤
kwfk	啥
krug	啦
kgmy	啧
kffh	啩
krrg	啪
fulk	啬
klfy	啭
khwb	啮
klgy	啯
klqy	啰
kmdg	啱
krqy	啲
kudb	啳
kulh	啴
kihc	啵
kpgh	啶
kyvb	啷
kvij	啸
kndg	啹
kjgr	啺
yupk	啻
kyuh	啼
kwga	啽
ktoy	啾
kadn	啿
kptk	喀
kjmy	喁
klge	喂
kfmf	喃
uguk	善
kjug	喅
fkfk	喆
kgkj	喇
kxxr	喈
kwnd	喉
kdgy	喊
kans	喋
kkyh	喌
khxs	喍
kmnk	喎
kadk	喏
kdeb	喐
kujg	喑
kthj	喒
ksvg	喓
kngf	喔
kdmd	喕
ksdg	喖
kplh	喗
kmdj	喘
kxge	喙
fkuk	喜
kjqn	喝
krxb	喞
kleg	喟
knkh	喡
ktfe	喢
kqko	喣
krgg	喤
koac	喥
kkkm	喦
kpgg	喧
kykw	喨
kwgb	喩
kdfa	喯
kwye	喰
kdjf	喱
ksjg	喳
kalg	喵
ipkk	営
kfam	喷
gehx	喸
kdff	喹
kwti	喺
kwgj	喻
kqvn	喼
kovg	喽
iptk	喾
krhw	嗁
kerm	嗂
kdht	嗄
kthy	嗅
kvkc	嗈
kgxi	嗉
keee	嗋
kuwl	嗌
kube	嗍
kaws	嗏
kpdk	嗐
kfcl	嗑
kccs	嗓
kfhw	嗔
kehc	嗖
kmeg	嗗
kexd	嗘
kyuy	嗙
kuvo	嗛
kftj	嗜
kgkh	嗝
kuxx	嗞
kuga	嗟
ebtk	嗠
kwcn	嗡
kjlg	嗢
kmak	嗣
kbhj	嗤
krdf	嗥
kfpi	嗦
ekwa	嗧
kitx	嗨
kdwt	嗪
kbcc	嗫
kawk	嗬
fhkx	嗭
kjsg	嗮
kldn	嗯
kwgr	嗱
kwrq	嗲
kepc	嗳
kufc	嗴
kcep	嗵
kgqt	嗷
gqtk	嗸
klpy	嗹
koao	嗻
kajd	嗼
kgkw	嗽
kytd	嗾
kwym	嗿
kyud	嘀
kdhy	嘁
kknk	嘂
kovh	嘃
kwvs	嘄
kvcq	嘅
kcce	嘇
kgmj	嘈
kmdf	嘊
ksfi	嘌
kdha	嘎
dnhc	嘏
knwe	嘐
khaf	嘑
klag	嘓
kgho	嘕
khag	嘘
kihv	嘙
ktjf	嘚
koss	嘛
kqef	嘝
kake	嘞
kftb	嘟
kdea	嘠
kipf	嘡
kmee	嘣
kmmv	嘤
kpnm	嘧
kvoj	嘨
klmy	嘪
kqdo	嘫
kjbc	嘬
kfke	嘭
knty	嘱
kfje	嘲
kkhm	嘳
khxh	嘴
kadr	嘶
kdui	嘹
ktdk	嘺
kfkk	嘻
kklk	嘼
kkkl	嘽
ksjf	嘾
klfo	嘿
knnw	噀
ktol	噃
kdhi	噄
keto	噅
kaqj	噆
kujf	噇
kyky	噈
knbt	噉
kcnk	噊
kykt	噋
kulj	噌
kwyo	噍
kfpu	噎
kwgn	噏
kkak	噐
krif	噑
koqh	噒
kwgu	噔
etnk	噕
kggn	噖
kogw	噗
kduw	噘
kwyc	噙
kvaf	噚
khob	噛
kqgj	噜
kxxi	噝
kwgw	噞
owwk	噟
kqdy	噡
ktmd	噢
klqj	噣
kssi	噤
kajy	噧
kkdk	器
gkkk	噩
kkks	噪
kujn	噫
ktaw	噬
khae	噱
kajn	噶
kujw	噷
kusr	噺
kpaf	噻
knkf	噼
kpwj	噾
kahl	嚂
klip	嚃
kawc	嚄
kfdj	嚅
kayk	嚆
kdjy	嚈
kogf	嚉
kfnf	嚋
kvhl	嚍
kfph	嚏
ktgo	嚑
kosx	嚒
kpwi	嚓
kdhn	嚖
kjai	嚗
krxs	嚛
klff	嚜
koaw	嚝
ktqi	嚟
kqyj	嚠
kosr	嚤
khal	嚧
kxgf	嚩
kuqe	嚪
kusq	嚫
kosd	嚰
kqky	嚵
kyke	嚷
klfk	嚸
krmf	嚹
klup	嚺
kelf	嚼
kgqm	嚽
kawe	嚿
kywy	囃
kyry	囄
kajj	囆
kgmx	囇
gkhe	囊
ktfm	囋
akfk	囏
kaui	囒
kdhb	囓
kgke	囔
kahq	囕
ktly	囖
mngd	囙
lhng	四
tlri	囟
lfte	团
lgbn	囤
lywv	囥
mwmg	囧
ldhi	囨
lfci	囩
lqre	囫
mjdd	囬
lfqv	园
tlqi	囱
lfjk	囲
luri	図
lfnh	围
lwxv	囵
lwfd	囶
lghd	囸
lwyc	囹
lnna	囻
lckd	囼
lgyi	国
ltui	图
lded	囿
lwye	圀
lgei	圂
lgkd	圄
cluf	圅
lkmi	圆
ludb	圈
lfuf	圉
lged	圊
lmdj	圌
lcmi	圎
ludn	圏
lgef	圑
lfcl	圔
lvfj	圕
lcfd	圗
lwdd	圙
lkhm	圚
llff	圛
llge	圜
lyxx	圝
lyxs	圞
ffff	土
dhfd	在
fgfh	圩
ftnn	圪
ftan	圫
ffnn	圬
tdfg	圱
ftfh	圲
fhgg	圵
fnrt	场
fqrt	圽
fbyy	圾
fqan	坁
frcy	坂
ffqn	坃
fwcy	坄
fqug	均
wvff	坌
fmyg	坍
fqwy	坎
fdhy	坏
wwfd	坐
fywn	坑
xxff	坒
rhyf	坕
fnwy	块
fgxg	坘
gvff	坙
jcff	坚
ffcy	坛
fdet	坜
fqng	坞
bwff	坠
fhcy	坡
fugh	坢
ipff	坣
fjhh	坤
fegg	坥
fjgg	坦
fpxn	坨
fafg	坩
fguf	坪
fhkg	坫
fnxn	坭
fckg	坮
fdhg	坯
fmdy	坱
fxjh	坲
fxet	坳
fwff	坴
fskg	坷
fqkg	坸
fpwy	坹
fdcy	坺
fqay	坻
fryy	坼
fpsh	坾
fwfy	坿
ftdy	垁
tfag	垂
dxyf	垄
fdxy	垅
fhnt	垆
wayf	垈
fnna	垊
gajf	型
fmgk	垌
ftkg	垎
fvgh	垏
fqqy	垑
cccf	垒
fynw	垓
rgkf	垕
fwnn	垖
fqiy	垗
figq	垙
fwsy	垛
fbsy	垜
fvey	垠
waff	垡
frgk	垢
fgjg	垣
fgcf	垤
fwgk	垥
veff	垦
ftmk	垧
gogf	垩
fuah	垪
rvyf	垫
fawy	垬
fgog	垭
fdfn	垮
fdpy	垯
fivg	垱
fmnn	垲
ftgs	垳
fyrb	垴
fpvg	垵
fufh	垶
fhqn	垷
fpfq	垸
fdtb	垹
febg	垺
irff	垽
foch	垿
tfuf	埀
fmwn	埁
fgjr	埂
fctd	埃
ftdh	埄
byff	埅
miff	埊
fjfg	埋
fyve	埌
fkeg	埍
fdny	城
fthp	埏
fvpc	埐
fefy	埒
fgey	埔
fkgg	埕
fhht	埗
fjfy	埘
fkmy	埙
fkmw	埚
fmwk	埛
fwyn	埝
fpgh	埞
fakg	域
fwnf	埠
fudb	埢
frtf	埤
fgeg	埥
fpqb	埦
fwga	埨
fqvh	埩
fpwa	埪
fimk	埫
fgji	埬
fviy	埭
fooy	埮
fdjn	埯
fesy	埰
fdwg	埲
fqeg	埳
ffhg	埴
fjqr	埸
fukg	培
adwf	基
fykb	埻
fvph	埽
inxf	埿
fnbm	堀
fjsy	堁
ipkf	堂
feqn	堄
fwyg	堆
akgf	堇
fmum	堈
fyce	堉
feeg	堋
fldg	堌
fqky	堍
syff	堏
lrff	堑
fjxx	堒
fmdf	堓
bdef	堕
fvtr	堖
fsfg	堙
fplh	堚
fgkl	堛
fgli	堜
fans	堞
fxge	堟
fwnd	堠
wksf	堡
fwks	堢
fjmy	堣
fjgh	堤
cnhf	堥
fxxr	堦
fdmd	堧
fjqn	堨
fadn	堪
frbt	堫
fwgj	堬
fkkn	堮
fajv	堰
fnhg	堳
fftj	堵
fdae	堶
ftgf	堹
flwj	堺
ivgf	堻
flgh	堽
fdwj	堾
fnua	塀
fawn	塂
fayk	塃
flyt	塄
fwdc	塅
fyox	塆
fpgg	塇
vcaf	塈
fiwe	塉
fjng	塌
eudf	塍
fpwk	塎
fgxi	塐
ubtf	塑
fpjw	塓
fawk	塔
fwcn	塕
ftux	塖
fovk	塘
fssy	塛
fpfe	塜
fyuy	塝
pawf	塞
agqf	塟
fwnp	塠
fxhw	塡
fgkh	塥
blff	塦
fuwl	塧
ftkl	塩
ffhw	填
fdri	塬
ftmf	塮
fqyl	塯
yvcf	塱
ftjr	塲
fmee	塴
fonx	塶
fhlo	塷
fakk	塸
ossf	塺
fajd	塻
fdrr	塽
flvg	塿
fnig	墀
fjlc	墁
fsfi	墂
fujq	境
jfcf	墅
faqh	墆
fujf	墇
fade	墈
fovh	墉
foao	墌
rxaf	墍
nhdf	墏
fyuk	墒
ajdf	墓
fmwy	墔
fgho	墕
fwgl	墖
ffjn	墘
ffuk	墙
fivs	墚
fffq	墝
fulj	增
fhag	墟
fkkl	墠
fwxc	墢
fogw	墣
fkhm	墤
ftol	墦
ftdk	墧
lfof	墨
fykt	墩
bxgf	墬
fdnl	墭
ndaf	墯
fsjf	墰
fwgu	墱
frlo	墲
famw	墴
fffc	墵
ffup	墶
fagf	墷
fafj	墸
ftmd	墺
ffwk	墻
lbwf	墼
flff	墿
nkuf	壁
nawf	壂
fglg	壃
yxtf	壅
errf	壆
fylt	壈
ffle	壊
fipl	壋
fywe	壌
ilrf	壍
fahl	壏
hpgf	壑
fafl	壒
fvhl	壗
fuqe	壛
fkhp	壝
fued	壠
fbxg	壣
fyke	壤
fdlf	壥
faky	壦
fkkt	壧
fghg	士
fpwb	壳
fpog	壶
fpgu	壹
fkun	壾
flld	夁
ttny	夂
tahj	夅
tdhj	夆
yotu	変
cwtu	夋
tjtu	复
dhtu	夏
yoot	夑
dhht	夒
edht	夓
utht	夔
qtny	夕
wgqi	夙
ywty	夜
qhkx	夞
qkqq	够
qqfk	夡
yclq	夣
qpgw	夤
jsqq	夥
adwq	夦
dddd	大
gnyi	夨
gxwi	夷
dfnb	夸
gudi	夹
dfcu	夽
dhdu	奀
daru	奁
qmdu	奂
djnb	奄
dqtb	奅
danf	奆
dskf	奇
dfiu	奈
dwgj	奉
hkdu	奌
udjj	奍
dfff	奎
dwgd	奏
dhvd	契
dynw	奒
dqqu	奓
dfaj	奔
yodu	奕
uqdu	奖
ddcu	套
nhdd	奘
cdjn	奙
exdu	奚
djef	奛
deef	奟
usgd	奠
dftj	奢
ddmd	奤
tmod	奥
cnhd	奦
uefd	奨
dijg	奫
ddjj	奭
llld	奰
yxxd	奱
dftl	奲
vvvv	女
vtan	奼
vyvd	奿
vqyy	妁
ynvf	妄
vcgg	妈
vpqn	妉
vtfg	妊
vfwy	妋
vfjh	妌
vgah	妍
vwcy	妐
vynt	妒
vfcy	妓
vywn	妔
vkhh	妕
vtdy	妖
vwyn	妗
vitt	妙
vdhy	妚
bhgv	妛
vnwy	妜
vnhf	妞
vmwy	妠
vwvt	妢
vxxn	妣
vcnh	妤
vdhh	妦
vfqn	妩
vary	妪
vyty	妫
vdcy	妭
vnxn	妮
vthf	妰
vvkg	妱
vjgg	妲
qbvf	妴
vygg	妵
vyxy	妶
vrwy	妷
vskg	妸
vfiy	妹
vgsy	妺
gvhv	妻
vntt	妼
vjhh	妽
ekvf	妿
vqkg	姁
vtpy	姂
vghg	姃
vnna	姄
vugh	姅
wfvf	姇
vwyc	姈
vgmh	姉
vtnt	姊
vckg	始
vmfg	姌
vmdy	姎
vafg	姏
vegg	姐
vnyw	姒
vtgg	姓
hxvf	姕
vang	姖
vmmg	姗
vuah	姘
vwtf	姙
vqiy	姚
vmgk	姛
ugvf	姜
vriy	姝
vfkg	姞
vynw	姟
vtmk	姠
vtdg	姡
vceg	姢
vywr	姣
vrgk	姤
vftx	姥
vvfh	姧
vgxw	姨
vrhf	姩
vahh	姬
eeev	姭
vgjg	姮
vigq	姯
vqjg	姰
vdfn	姱
gqjv	姴
vwgh	姵
vgdf	姸
vpta	姹
vtfq	姺
vldy	姻
vqqy	姼
vqdb	姽
vwgg	姾
uqwv	姿
vadt	娀
dgvy	威
vawy	娂
vffg	娃
vgog	娅
vatq	娆
vtdj	娇
yovf	娈
vmgn	娉
vhqn	娊
vieg	娋
vjfg	娌
rrvf	娎
vebg	娐
iitv	娑
vtxy	娒
vntn	娓
vdqn	娔
vgki	娕
vkhy	娖
vtfp	娗
vyve	娘
vgva	娙
vlet	娚
vngb	娜
vdhk	娝
vevg	娞
vkeg	娟
vdfe	娠
vfny	娡
vwyk	娢
vuxt	娣
nhdv	娤
vtry	娥
vrgw	娦
vukq	娧
vjfh	娨
vqkq	娩
vgkg	娪
vthp	娫
vfhy	娬
vctd	娭
vwnw	娰
vkgd	娱
vkmw	娲
vtjh	娳
vusy	娴
vbcy	娵
bcvf	娶
vadw	娸
vxyx	娹
vccc	娺
vgji	娻
vjjg	娼
vviy	娽
vdff	娾
bskv	娿
vbsk	婀
vrmh	婂
vpfi	婃
vukg	婄
vqoy	婅
ihcv	婆
vesy	婇
vpqb	婉
vgey	婊
vhaw	婋
vhgc	婌
vdsk	婍
vqky	婏
vjsy	婐
vooy	婒
hdhv	婓
vhdd	婔
vgvh	婕
veqn	婗
vudb	婘
vqaj	婚
vyki	婛
ahnv	婜
vpgh	婝
vfuf	婞
vldg	婟
vphn	婠
vsww	婡
vrtf	婢
vmfk	婤
vhjf	婥
vgeg	婧
vwga	婨
vmdf	婩
ssvf	婪
vjxx	婫
vetf	婬
vndg	婮
gmyv	婯
vmaw	婰
xyxv	婱
vawx	婲
vglb	婳
mmvf	婴
vulh	婵
vpjh	婶
vyks	婷
vjgr	婸
vsvg	婹
cnhv	婺
vfmf	婻
vadk	婼
vnhc	婽
vwgb	婾
vnhe	婿
vjmy	媀
vnkh	媁
vyuh	媂
vcns	媃
vugd	媄
vadn	媅
vdmd	媆
vplh	媈
vuej	媊
vdwj	媋
valg	媌
vqmy	媍
vftj	媎
vmdj	媏
ahkv	媐
vtgf	媑
vafs	媒
vrgg	媓
vamd	媖
vpgg	媗
vxxr	媘
vdgy	媙
vnhg	媚
vegc	媛
vhmy	媜
vjgh	媞
vans	媟
vdae	媠
vgli	媡
vjhg	媢
vivs	媣
vlny	媤
vyna	媥
vleg	媦
vusg	媨
vjlg	媪
vhvh	媫
vwks	媬
edmv	媭
vwgj	媮
vqbt	媰
verm	媱
vtlx	媲
vthn	媳
vfke	媴
eudv	媵
vabg	媶
vbhj	媸
vqyl	媹
vmgt	媺
tewv	媻
vamf	媾
vrqc	媿
vdwt	嫀
vpge	嫁
vehc	嫂
vfhw	嫃
vdri	嫄
vuga	嫅
vpwk	嫆
vpjw	嫇
oopv	嫈
vutd	嫉
vgxi	嫊
vxuu	嫋
vuvo	嫌
veeg	嫍
vyuy	嫎
vyvb	嫏
vlev	嫐
vepc	嫒
vqmx	嫓
vprw	嫔
vatn	嫕
vsfi	嫖
vlxi	嫘
vyth	嫙
vjlc	嫚
atdv	嫛
vujf	嫜
vovi	嫝
vovh	嫞
vaak	嫟
fitv	嫠
vyud	嫡
fwhv	嫢
vgho	嫣
vakg	嫤
vgjf	嫥
viph	嫦
vgmy	嫧
vakw	嫨
vgkt	嫩
vnwe	嫪
vajd	嫫
voao	嫬
vhaf	嫭
vffn	嫮
gqtv	嫯
vgkw	嫰
vfuk	嫱
voss	嫲
umiv	嫳
vduf	嫴
vwyo	嫶
vbde	嫷
vamw	嫹
vueg	嫺
vlfo	嫼
vdui	嫽
voqh	嫾
veto	嬀
vwgu	嬁
vujy	嬂
vfpu	嬄
vagf	嬅
vwgn	嬆
vkhm	嬇
vfkk	嬉
akuv	嬊
vtol	嬏
vujn	嬑
vlff	嬕
vylg	嬗
vuep	嬘
vouo	嬚
vlge	嬛
ujqv	嬜
vatf	嬞
vugy	嬟
vkks	嬠
vywe	嬢
vpns	嬣
vfnf	嬦
vvhl	嬧
vuxn	嬨
vegw	嬩
voos	嬫
vfdj	嬬
vgwr	嬭
djev	嬮
vfkf	嬯
ilrv	嬱
leve	嬲
vawc	嬳
vxrh	嬵
vthj	嬶
vosc	嬷
vemw	嬹
vaan	嬺
vflm	嬻
vqyj	嬼
vlhd	嬽
vgkm	嬾
vako	嬿
vfsh	孀
fkkv	孁
vtvl	孂
vugi	孄
vmmv	孆
vmwk	孈
vaky	孉
vosd	孊
vgmx	孋
vkkt	孍
vnij	孎
vaui	孏
bbbb	子
bnhg	孑
dhbd	存
fpbf	孛
ftbf	孝
ngkb	孠
bckg	孡
bqnn	孢
brcy	孤
vcbf	孥
ipbf	学
xebf	孧
bbbf	孨
bynw	孩
yobf	孪
dhvb	孬
bpfi	孮
ahnb	孯
ykby	孰
nbbb	孱
uxxb	孳
bbbj	孴
qytb	孵
yxyb	孶
fitb	孷
nkub	孹
bfdj	孺
bvhl	孻
btwb	孼
bmmv	孾
pyyn	宀
ptab	宅
pgfj	宇
pdyu	宊
pfqb	完
pywu	宍
pdcu	宏
pfjj	宑
ptfn	宒
pntr	宓
pygf	宔
pxcu	宖
pfiu	宗
phnn	官
pghu	定
pqbb	宛
pegf	宜
pgyu	宝
pudu	实
pdwu	実
pdxy	宠
pjhj	审
ptkf	客
pgjg	宣
pgcf	室
pdef	宥
pahh	宦
pqiu	宨
ptfq	宪
pkkf	宫
pdny	宬
pvtk	宭
pftb	宯
pufj	宰
pdhk	害
pjvf	宴
pief	宵
pgeu	家
ptou	宷
pdfe	宸
pwwk	容
pkgk	宺
pcum	宻
pfqv	宼
pamq	宽
prgw	宾
pwdj	宿
pesu	寀
pgvh	寁
phgc	寂
pdsk	寄
pgmw	寅
pntm	密
pfqc	寇
pgef	寈
pwyf	寉
phmu	寊
pawb	寋
pgkl	富
pnlf	寍
pnhw	寎
pqmd	寏
pnhi	寐
pwvc	寑
pawu	寒
pjmy	寓
pjgh	寔
pdls	寕
pivc	寖
pfhw	寘
prcy	寙
pgrm	寚
pahq	寛
pnlh	寜
puvc	寝
pajd	寞
pwfi	察
plvf	寠
pdev	寡
pnhy	寣
pnhk	寤
pnwe	寥
paws	寨
peto	寪
pdui	寮
plge	寰
pnhs	寱
pxth	寲
pusq	寴
pmdu	寷
dtfu	寿
fffy	封
gmfu	専
gehf	尃
tmdf	射
dqfi	尅
uqfy	将
nfif	尉
usgf	尊
ihty	小
imkf	尚
idiu	尜
ipfc	尝
duji	尞
igqx	尡
dnyi	尤
dnqy	尥
atgq	尧
dney	尨
wqgd	尩
gqgd	尫
dnwj	尬
faqb	尭
dnbs	尮
dnqb	尯
ykiy	就
dnuo	尲
dnme	尳
dnjl	尴
gqal	尶
nngt	尸
nyuu	尽
ntfn	尾
nnkd	局
nxxv	屁
nfci	层
npwi	屄
nbmk	屈
nanv	屉
ngcf	屋
nkmh	屌
nuak	屏
ntfc	屐
nied	屑
ndfe	屒
rgnx	屔
naei	展
nufk	屖
ntfb	屘
nbsk	屙
ntky	属
nans	屟
nftj	屠
novd	屡
nthh	屣
nttt	履
ntov	屦
ntas	屧
nttk	屩
npdi	屪
nmmm	屭
gbnv	屯
ubtr	屰
mmmm	山
tymj	屳
mtnn	屹
mvyy	屻
mgqn	屼
mgng	屿
mvyu	岃
mtdy	岆
mqbj	岇
maht	岈
mqrt	岉
mbyy	岋
mbyu	岌
mgah	岍
mwvt	岎
mfqn	岏
mfcy	岐
mwyn	岑
wvmj	岔
mwjj	岕
mary	岖
mmru	岗
mmqn	岘
tdmj	岙
mwru	岚
qynm	岛
mthf	岝
mmdy	岟
mang	岠
mskf	岢
mqkg	岣
mpwy	岤
mhcy	岥
megg	岨
mxjj	岪
mwyc	岭
mpxn	岮
mxet	岰
rgmj	岳
mnan	岷
mdfj	岸
mvkg	岹
mqay	岻
mguf	岼
maiu	岽
mjvf	岿
mqtb	峁
mtuy	峂
ipmj	峃
mcgh	峄
mcah	峅
mwgk	峆
mtkf	峉
wnnm	峊
mqjg	峋
mgcf	峌
mvgh	峍
mveu	峎
mwgf	峑
mmgk	峒
mgxw	峓
mftx	峔
myjf	峕
mqdb	峗
mgjg	峘
mffy	峙
mgqj	峛
mwhf	峜
mdef	峟
mhgh	峠
mgud	峡
matq	峣
mtdj	峤
mqvh	峥
yomj	峦
mywr	峧
mtry	峨
mwwk	峪
mahb	峫
mgey	峬
mieg	峭
mvtk	峮
mtdh	峰
qtnm	峱
mtjj	峲
mwht	峳
mpdc	峵
mufj	峷
mdny	峸
wgsm	峹
mgjr	峺
mcwt	峻
mgkg	峿
myve	崀
mfqw	崁
mape	崂
mgoy	崃
mwgg	崄
mqeh	崅
mpwa	崆
mpfi	崇
pfim	崈
mijg	崉
mssy	崊
mgaf	崋
mdsk	崎
mqaj	崏
mjxx	崐
mywf	崒
mldg	崓
mwyf	崔
mdff	崖
mwga	崘
mfwt	崚
mnbm	崛
mtfg	崜
mgeg	崝
mykb	崞
mbib	崡
mtvf	崣
mrde	崤
mrtf	崥
mdjn	崦
mswc	崧
mgvh	崨
meef	崩
mgji	崬
mlrj	崭
mldf	崮
mvlg	崰
mmjj	崱
mdgy	崴
mjgr	崵
mfff	崶
mdmy	崸
myuh	崹
mytb	崺
mtff	崻
mjgh	崼
mlnu	崽
msvg	崾
mkkn	崿
msyg	嵀
madn	嵁
mtvg	嵂
mute	嵃
mugd	嵄
tdnm	嵇
megc	嵈
myks	嵉
mtux	嵊
mnhg	嵋
mafw	嵌
mjmy	嵎
mrbt	嵏
mjqn	嵑
mkkk	嵓
mlge	嵔
msjg	嵖
maps	嵘
mtuf	嵙
mqqw	嵚
mwgj	嵛
mukh	嵜
movg	嵝
mdwy	嵟
mexd	嵠
mwcn	嵡
mwyk	嵢
movk	嵣
oopm	嵤
mqas	嵥
mmgu	嵦
mwno	嵨
mykk	嵩
muxx	嵫
mrqc	嵬
myuy	嵭
mfhw	嵮
muga	嵯
mpwk	嵱
mths	嵲
miwe	嵴
mjff	嵵
mtwh	嵷
mxkj	嵹
mnwe	嵺
movi	嵻
mutg	嵼
maqh	嵽
mcce	嵾
msdm	嵿
mujf	嶂
mlrh	嶃
mgmj	嶆
mnhf	嶈
mkwy	嶉
mrwy	嶊
mwvo	嶋
mnrg	嶍
mnff	嶎
mdsn	嶏
mbtg	嶐
mqke	嶑
mtol	嶓
mwyo	嶕
mwgn	嶖
msaa	嶘
moqh	嶙
mdui	嶚
maqj	嶜
mwgu	嶝
bdam	嶞
musf	嶟
mduw	嶡
mffq	嶢
errm	嶨
mmae	嶩
mogi	嶪
mugy	嶬
mwnf	嶭
mwgw	嶮
mkby	嶯
mqeg	嶰
majn	嶱
mwym	嶲
tmom	嶴
mlhd	嶵
mxth	嶷
mfnf	嶹
mfwy	嶻
mean	嶾
mfdj	嶿
miwa	巀
mday	巁
mued	巃
mfhm	巅
mook	巆
mhaa	巇
mako	巈
mqky	巉
mmmv	巊
midt	巌
mtvc	巍
mdht	巎
maky	巏
myka	巐
mxhm	巓
muwv	巕
mkkt	巗
mhay	巘
mutt	巙
vnnn	巛
kthh	川
ytyh	州
ynkb	巟
gvaf	巠
vjsu	巢
ijsu	巣
vlrn	巤
aaaa	工
agnn	巧
awyy	巩
awwi	巫
awfw	巬
ugaf	差
cayk	巯
nngn	己
nnnn	已
cnhn	巴
rgcv	巵
vknn	巶
awnb	巷
ahkn	巸
nngw	巺
udnb	巻
ckxb	巼
nnaw	巽
gmhk	巿
tmhk	币
ymhj	市
dmhj	布
mhsh	帄
jmhh	帅
mhwy	帆
vmhk	帇
jgmh	师
mhwv	帉
mhcn	帊
qamh	帋
rdmh	希
mhpq	帎
mhfh	帏
mhty	帐
vcmh	帑
wayh	帒
mhgs	帓
mhhc	帔
mhrg	帕
mhhk	帖
mhdy	帗
pwmh	帘
mhrw	帙
vpmh	帚
mhkw	帜
yuph	帝
mhdj	帞
yomh	帟
emhj	帠
mhua	帡
mhwk	帢
udmh	帣
vkmh	帤
gkph	带
mhhm	帧
mhuq	帨
mhie	帩
mhde	帪
vtkh	帬
oamh	席
dtbh	帮
gkgh	帯
ytvh	帰
mhdf	帱
mhtf	帲
mhpb	帵
ipkh	常
mhuv	帹
mhaw	帺
mhgm	帻
mhly	帼
mhjh	帽
mhfj	帾
mhwd	帿
pjdh	幂
mhnf	幄
mhgl	幅
mhjn	幆
mhna	幈
mhas	幉
mham	幊
tewh	幋
mhjq	幌
mhee	幍
mhpw	幎
mhpe	幏
eudh	幐
mhtn	幒
mhce	幓
mhjc	幔
ajdh	幕
mhsi	幖
mhad	幙
mhji	幜
mhkl	幝
mhow	幞
mhro	幠
mhtl	幡
mhuf	幢
mhir	幥
nkuh	幦
mhks	幧
mhqy	幨
mhfm	幩
mhae	幪
mhof	幮
mhtb	幯
mhpn	幰
mhui	幱
fggh	干
gufk	平
rhfk	年
fufj	幸
xxxx	幺
mxxi	幽
oygt	广
otci	庅
oxxv	庇
owyn	庈
ofci	庋
oaht	庌
owjk	庎
ocnh	序
oyne	庐
ofqv	庑
ofyi	庒
oigd	应
oqay	底
oqnv	庖
ohkd	店
ovwi	庚
ohxv	庛
owfi	府
otui	庝
odxy	庞
onty	废
ougk	庠
oyei	庡
ogcf	庢
oqii	庣
offi	庤
owsi	庥
oaci	度
owwf	座
oftb	庨
orfc	庪
otfp	庭
osgd	庮
ogey	庯
ouak	庰
ofwt	庱
osww	庲
ortf	庳
oajd	庴
odjn	庵
oaoi	庶
ovii	康
oveh	庸
oany	庹
owcs	庺
oaww	庻
oxdm	庼
ojmy	庽
oewi	庾
oald	庿
opoc	廀
owfq	廃
ofcl	廅
orqc	廆
ouvo	廉
oyvb	廊
oehc	廋
oukb	廍
orxc	廏
orxq	廐
oakg	廑
ogqt	廒
oykb	廓
olvd	廔
obwc	廕
onwe	廖
oaqh	廗
oonx	廘
ojff	廛
onfj	廜
oqqw	廞
olkx	廤
owgj	廥
onkf	廦
ofwk	廧
oyli	廪
oene	廫
otgm	廭
ommv	廮
oqog	廯
obfn	廰
ogmx	廲
thpd	延
tfpd	廷
vgpk	建
lkpd	廻
mjdp	廽
agth	廾
aghg	廿
ycaj	弃
wvaj	弅
fcaj	弆
yoaj	弈
umia	弊
afyi	弍
adyi	弎
aayi	式
ffny	弐
rsay	弑
xngn	弓
uxht	弟
xtay	张
xang	弡
xbhc	弢
xwfy	弣
xqay	弤
xqiy	弥
xyxy	弦
xrcy	弧
vcxb	弩
xahh	弫
udxb	弮
yoxb	弯
xuxu	弱
xykb	弴
xyki	弶
xulh	弹
xkjy	强
xgmx	弻
xdjx	弼
xans	弽
xilh	弾
pawx	弿
fpgc	彀
xskk	彁
ogxd	彂
xjaf	彃
xakk	彄
xuev	彅
xvfj	彇
xamw	彉
xoaw	彍
xhhc	彏
vngg	彐
xgiu	彔
xgeu	彖
dhdv	彗
xgtx	彘
vpjs	彚
vowa	彛
xgoa	彝
voxa	彞
vfac	彟
vakc	彠
ettt	彡
gaet	形
myet	彤
utee	彦
gkgy	彧
gmye	彨
eset	彩
hawe	彪
sset	彬
fkue	彭
ujfe	彰
jyke	影
ttth	彳
tqyy	彴
tbyy	彶
twcy	役
tavt	彻
thcy	彼
tqay	彽
twyc	彾
tygg	往
tghg	征
tcag	径
tqjg	徇
tvey	很
tugh	徉
tlkg	徊
tvgh	律
tffg	徍
thht	徏
twgs	徐
tfhy	徒
tuhy	従
tapy	徔
tgoy	徕
tpfi	徖
tjgf	得
thdd	徘
thhy	徙
tgli	徚
timk	徜
trhb	御
tgvh	徢
tajg	徣
tnhc	徦
trgg	徨
trfh	循
tnkh	徫
term	徭
tmgt	微
texd	徯
tsfi	徱
tumt	徶
tfln	德
tryt	徼
tued	徿
nyny	心
nyyh	忄
vynu	忍
tfnu	忎
ntfh	忏
hgnu	忐
ghnu	忑
anyi	忒
ntnn	忔
ynnu	忘
nynn	忙
nwyy	忛
gdnu	忝
khnu	忠
nkhh	忡
nbyy	忣
rnnu	忥
ndny	忧
wcnu	忩
nwcy	忪
nnwy	快
ncnh	忬
nyhy	忭
nqan	忯
nvfh	忰
npqn	忱
nwyn	忴
wynn	念
nrbh	忷
nnhf	忸
nqwy	忺
nywn	忼
qrnu	忽
nrnn	忾
wvnu	忿
ndhy	怀
dynu	态
wwnu	怂
nfqn	怃
nary	怄
ntay	怅
nwbn	怆
nann	怈
nvkg	怊
ndhg	怌
nthf	怍
thfn	怎
nmdy	怏
nqkg	怐
vcnu	怒
nvcy	怓
nghg	怔
ndmh	怖
nhkg	怗
negg	怚
njgg	怛
nwyc	怜
nqay	怟
cknu	怠
nckg	怡
nrwy	怢
rwnu	怣
wfnu	怤
qvnu	急
nguf	怦
ntgg	性
qbnu	怨
nnxn	怩
ncfg	怪
nxjh	怫
nxet	怮
nfcy	怯
qryn	怱
ngmw	怲
nkqn	怳
ngny	怴
nsyy	怵
synu	怸
wbnu	怹
nyni	怺
uknu	总
cfnu	怼
nkwy	怾
ncgh	怿
nqqy	恀
wtfn	恁
nqjg	恂
nffy	恃
nfkg	恄
nftx	恅
nxjg	恉
neee	恊
yonu	恋
nqiy	恌
nigq	恍
vbnu	恏
awyn	恐
nqdb	恑
ngjg	恒
vknu	恕
tlrn	恖
nwsy	恘
ugnu	恙
ffnu	恚
nlkg	恛
naay	恜
dhvn	恝
ngxw	恞
nqrb	恟
ndhf	恠
nrdc	恡
ndoy	恢
uqwn	恣
ntlg	恤
ntmk	恦
dmjn	恧
nvey	恨
ldnu	恩
ntkg	恪
nmgk	恫
ntdg	恬
awnu	恭
nwgg	恮
thnu	息
nwgk	恰
nwcq	恱
nuah	恲
venu	恳
yjnu	恴
gmnu	恵
gogn	恶
wsnu	恷
nfce	恸
nddy	恹
nmnn	恺
nmjh	恻
nyrb	恼
nplh	恽
cehn	恿
nceh	悀
nkeg	悁
nxxf	悂
nlsy	悃
nieg	悄
wgsn	悆
nwgs	悇
naah	悈
tonu	悉
rrnu	悊
nuxt	悌
njfh	悍
ntfk	悎
ndww	悏
qton	悐
ngey	悑
nkcn	悒
nhqn	悓
ntxy	悔
nrdh	悕
nfpb	悖
nqkq	悗
nykb	悙
ngki	悚
ncwt	悛
nkgg	悜
njfg	悝
nknd	悞
ngkg	悟
whtn	悠
nyve	悢
kkhn	患
tlqn	悤
nukq	悦
ntjh	悧
wqin	您
nirb	悩
fpwn	悫
egcn	悬
njcf	悭
nkgd	悮
nuyy	悯
npfi	悰
hdhn	悲
ntbg	悸
nphn	悺
nfuf	悻
nhjf	悼
npwa	悾
ngdn	悿
nwga	惀
njxx	惃
hgin	惄
ngeg	情
nmfk	惆
njsy	惈
ihkn	惉
nyki	惊
npqb	惋
pqbn	惌
nssy	惏
nakg	惐
akgn	惑
tknu	惒
nudb	惓
nooy	惔
njqr	惕
nmun	惘
nccc	惙
nqrn	惚
nqaj	惛
najg	惜
nimk	惝
nrqw	惞
nwyg	惟
gjhn	惠
tqrn	惣
nxyx	惤
ewnu	惥
nohk	惦
nhwy	惧
ncde	惨
tghn	惩
tlnu	惫
nagd	惬
nlrh	惭
nulh	惮
nxfm	惯
ndae	惰
shnu	想
nmdj	惴
nrgg	惶
dwjn	惷
nqjb	惸
adkn	惹
njtg	惺
nrbt	惾
njgh	惿
ntoy	愀
npgg	愃
nlge	愄
tign	愆
wgen	愈
nwgj	愉
ngkl	愊
negc	愋
nqmd	愌
natn	愍
ntjt	愎
ujnu	意
ndmd	愐
ncee	愑
njgr	愓
nkkn	愕
nadn	愖
nptk	愘
ptkn	愙
jmhn	愚
najv	愝
dgkn	感
njlg	愠
nlyt	愣
nfam	愤
namd	愥
nkhm	愦
nrqc	愧
namy	愩
nkmy	愪
ngxi	愫
ubtn	愬
nerm	愮
njiq	愰
nutd	愱
nmeg	愲
hhnu	愳
nxuu	愵
swwn	愸
npwk	愹
najf	愺
btxn	愻
nxhw	愼
ngef	愽
drin	愿
nexd	慀
icen	慂
nwcn	慃
neeg	慆
uxxn	慈
nyxl	慉
nuvo	慊
nayk	慌
nfhw	慎
npjw	慏
amnu	慐
nbcc	慑
ngmj	慒
nsfi	慓
najd	慔
ajdn	慕
nlag	慖
gkin	慗
lrnu	慙
nmwy	慛
ndrr	慡
njlc	慢
dhdn	慧
nvcq	慨
nlpy	慩
gusn	慭
ntjr	慯
nfin	慰
novh	慵
novi	慷
aqpn	慸
nlvg	慺
ucan	慿
nnwe	憀
ntln	憁
dwen	憃
tfhn	憄
nipf	憆
nhag	憈
nfke	憉
umin	憋
qqun	憌
ntdk	憍
nulj	憎
nwfi	憏
ngjn	憓
nwyo	憔
nwgu	憕
nsjf	憛
nbde	憜
ykbn	憝
nsoy	憟
nffq	憢
ntol	憣
oopn	憥
nooe	憦
nujf	憧
nbtn	憨
tdtn	憩
nueg	憪
njyi	憬
ndui	憭
naqj	憯
ncnk	憰
nyky	憱
nvaf	憳
nkun	憵
nssh	憷
nwgw	憸
nmae	憹
nqdy	憺
nylg	憻
ndgn	憾
natf	懂
nake	懄
nkks	懆
nqeg	懈
ntmd	懊
scnn	懋
nfwk	懎
nwym	懏
nyle	懐
iagn	懑
ngkm	懒
nept	懓
nyli	懔
djen	懕
qtdn	懖
nfoo	懗
iaqn	懘
negw	懙
nean	懚
nfkf	懛
nalq	懜
nosc	懡
nahl	懢
nfph	懥
nfdj	懦
npns	懧
nufe	懩
njai	懪
nrrm	懫
oamn	懬
noaw	懭
ndet	懮
nqyj	懰
naly	懱
ndhn	懳
nalh	懵
nyke	懹
nuxw	懻
naky	懽
fpgn	懿
nosd	戂
nipo	戃
nhhc	戄
ujfn	戆
agny	戈
fxyi	戋
dgxy	戌
dyxy	戍
dnxy	成
trxy	我
nhda	戕
akgd	或
wbay	戗
hkay	战
mgka	戙
dhgy	戚
dhau	戛
depa	戞
fjfa	戟
ujxy	戠
adwa	戡
kbxy	戢
wgda	戣
bcla	戤
jtga	戥
ilay	戦
sksa	戨
fwyy	截
deag	戫
goga	戬
nwea	戮
haoa	戯
haja	戱
nwya	戳
flay	戴
ynnv	戹
yndi	戻
nagn	戼
ynuf	戽
yndy	戾
ynye	房
rnrh	所
ynma	扁
ynhk	扂
ynmk	扃
ynqq	扅
ynnd	扇
ynkc	扈
ynhd	扉
ynoo	扊
rtgh	手
rghg	扌
rtan	托
rfnn	扝
rtfh	扦
rvyy	执
rnrt	扬
rnhf	扭
rwvt	扮
rdny	扰
rbyy	扱
rrcy	扳
rwjh	扴
rwuy	扵
rfwy	扶
rtdy	扷
rthn	扸
rxxn	批
rdbn	扼
bdii	承
rfcy	技
ritt	抄
rnwy	抉
rtah	抍
rqbh	抑
rcnh	抒
rrhy	抓
rdhy	抔
rwcy	投
rufh	抖
rywn	抗
rfqn	抚
rvet	抛
rfny	抟
rary	抠
rwxn	抡
rwbn	抢
rynt	护
rbcy	报
rgmw	抦
rkwy	抧
rguf	抨
rmfg	抩
rhcy	披
rckg	抬
regg	抯
rmdy	抰
rqnn	抱
rskg	抲
rnxn	抳
rqay	抵
rdhg	抷
rgsy	抹
rfiy	抺
rjhh	抻
rnan	抿
rkqn	拀
rekg	拁
rxjh	拂
rthf	拃
rygg	拄
rjgg	担
rryy	拆
rhkg	拈
rwfy	拊
rugh	拌
vcrj	拏
rket	拐
rang	拒
rdcy	拔
rpxn	拕
rtbn	拖
rxet	拗
rqkg	拘
rbmh	拙
rcah	拚
rvkg	招
rdfh	拜
rnyw	拟
rtwn	拠
rocy	拡
rdxy	拢
ranw	拣
rehh	拥
rudg	拦
rpsh	拧
rnty	拨
rcgh	择
rvey	拫
rtdg	括
raay	拭
rfkg	拮
rbig	拯
rawy	拱
awrj	拲
udrj	拳
rwgg	拴
rdhb	拵
rvqy	拶
rftn	拷
reee	拹
rdoy	拻
ruah	拼
rjxt	拽
rwgk	拾
rrey	挀
rffy	持
rffg	挂
rgcf	挃
rigq	挄
rbsy	挅
rwsy	挆
rxjg	指
dhvr	挈
rpvg	按
rtkg	挌
rdfn	挎
rmgk	挏
vkrj	挐
rqiy	挑
rgqj	挒
rpta	挓
ryey	挔
rpwn	挖
rgxw	挗
rite	挘
rvyr	挚
yorj	挛
rgog	挜
rfpy	挝
rdpy	挞
rgud	挟
ratq	挠
rivg	挡
rtdj	挢
rqvh	挣
ryjh	挤
rplh	挥
rvfy	挦
rctd	挨
rwkq	挩
rngb	挪
rwwf	挫
rfpb	挬
rgjr	挭
ruxt	挮
rdfe	振
rkgg	挰
riit	挱
iitr	挲
rgva	挳
rgah	挵
rdtb	挷
rhqn	挸
rkcn	挹
rtfp	挺
rthp	挻
rqkq	挽
rtdh	捀
rgkg	捂
rvtk	捃
rgiy	捄
rceh	捅
rlsy	捆
rfoy	捇
rwgs	捈
rkhy	捉
rebg	捊
refy	捋
rkej	捌
rjfh	捍
rieg	捎
rjfg	捏
rkeg	捐
rjgy	捑
rgki	捒
rahb	捓
rqeh	捔
rgey	捕
rhht	捗
rcwt	捘
rkkg	捛
rjhc	捜
rape	捞
rkmy	损
rqmd	换
rqym	捣
rpqb	捥
rdwg	捧
ryny	捩
rqaj	捪
rowf	捬
rrtf	捭
rndg	据
rgcj	捯
rjsy	捰
rdff	捱
rrgm	捳
rwcn	捴
rmaw	捵
rtfg	捶
rgvh	捷
rdfa	捹
rdfi	捺
rwyn	捻
rtvg	捼
rywf	捽
rphn	捾
rgvv	捿
rrqw	掀
rdey	掁
rohk	掂
rgeg	掅
rmum	掆
rccc	掇
repc	授
rhjf	掉
rukg	掊
roqy	掋
ipkr	掌
rjxx	掍
rdsk	掎
rqrm	掏
rqeg	掐
radw	掑
rhdd	排
ahnr	掔
rfwt	掕
rywy	掖
rgfg	掗
rnbm	掘
rgmy	掚
rakg	掝
rooy	掞
ryki	掠
rpws	探
rmhr	掣
ruvg	接
rjqr	掦
rpwa	控
rwyg	推
rdjn	掩
rajg	措
rqoy	掬
rgdn	掭
ryne	掮
rheg	掯
rwvr	掰
rrrj	掱
rjqx	掲
rhae	掳
rlgy	掴
rwgb	掵
rovw	掶
rudb	掷
rulh	掸
rcde	掺
rcjy	掻
rxfm	掼
ruog	掽
rxge	掾
radk	掿
rhmy	揁
ruej	揃
rwgj	揄
rwgd	揆
rfmf	揇
rqyg	揈
rcns	揉
rgkl	揊
rlny	揌
rdwd	揍
rpgg	揎
ralg	描
rjgh	提
reag	揑
rtfe	插
rytb	揓
radn	揕
rkbg	揖
ryna	揙
rujg	揞
rnhe	揟
rajv	揠
rngf	握
rptk	揢
rmdj	揣
rvcb	揤
ryuh	揥
rgkj	揦
gkir	揧
ryks	揨
rxxr	揩
rtoy	揪
torj	揫
rjqn	揭
iejr	揱
rans	揲
rdhd	揳
regc	援
rvgp	揵
rbbh	揶
rsjg	揸
refb	揺
rdiy	揼
rjtq	揽
rjlg	揾
rqqw	揿
rqku	搀
rutk	搁
rovg	搂
rukn	搃
ripq	搅
rpwk	搈
rrhw	搋
rnae	搌
rbti	搎
rgef	搏
ryxl	搐
rabg	搑
ryuy	搒
ruga	搓
rcyj	搔
rfcl	搕
rftj	搘
ruvo	搛
rehc	搜
rthy	搝
rykk	搞
rube	搠
rccs	搡
rgoj	搢
ruwl	搤
rwnp	搥
rxuu	搦
rjng	搨
rqas	搩
rovk	搪
tewr	搫
rtec	搬
rawk	搭
rssy	搮
rmeg	搰
rnuf	搱
rpdk	搳
pawr	搴
rlwl	搵
rfhw	搷
rwyb	携
rudr	搼
raws	搽
rwgr	搿
rwno	摀
rldn	摁
rbiy	摂
ramy	摃
rbcc	摄
rhan	摅
rlfc	摆
rerm	摇
rprw	摈
rpwq	摉
rcwy	摊
rpwj	摍
rdwe	摏
rtwh	摐
rnua	摒
ryxf	摔
raqh	摕
rwfi	摖
rgkw	摗
ryud	摘
rlpy	摙
ripf	摚
ryrc	摛
ronx	摝
rlxi	摞
rtln	摠
rvcq	摡
rhaf	摢
rhag	摣
rdrr	摤
rtjr	摥
rdfy	摦
rmwy	摧
rnig	摨
ossr	摩
rfwq	摫
rujq	摬
roao	摭
fwfr	摰
rjlc	摱
rlrh	摲
rffn	摴
rvjs	摷
rajd	摸
ajdr	摹
rnrg	摺
rahf	摼
rsfi	摽
rxkj	摾
fnwr	撀
ryxg	撁
rltk	撂
lwcr	撃
rmmv	撄
rduw	撅
umir	撆
rumt	撇
ykbr	撉
rueg	撊
rugg	撋
rkhm	撌
raqj	撍
rfpu	撎
rvaf	撏
ripr	撑
raet	撒
rjyi	撔
radr	撕
rnbt	撖
rtwk	撘
rusf	撙
roqh	撛
rwgu	撜
reto	撝
rujf	撞
rfja	撠
rccn	撡
ryct	撤
rxqc	撧
rdui	撩
rcdl	撪
rtfn	撬
rtol	播
rjbc	撮
rnnw	撰
rbde	撱
rykt	撴
rfwl	撵
ragf	撶
rfkm	撷
rqgj	撸
rpwh	撺
rdgn	撼
rfjf	擀
rflg	擂
rmae	擃
rylg	擅
rafj	擆
rogi	擈
rlqj	擉
rtdw	擌
rkks	操
aqkr	擎
raqt	擏
rlge	擐
rkby	擑
rwyc	擒
raiy	擓
rajn	擖
rnkf	擗
nkur	擘
rtmd	擙
raas	擛
rfmy	擜
rjel	擝
rovt	擞
rfkf	擡
rthj	擤
rpwi	擦
egnr	擧
rfdj	擩
djer	擪
rdjy	擫
rawc	擭
rosr	擵
rvln	擸
rakw	擹
rrxs	擽
ryup	擿
srrr	攀
rufe	攁
rlll	攂
rawi	攃
rfwm	攅
rpdn	攇
ront	攈
rlle	攌
rhal	攎
rpae	攐
rtfm	攒
rpah	攓
rono	攗
ryke	攘
rook	攚
rlxy	攞
rosd	攠
ryry	攡
rthi	攥
rgmx	攦
rfhm	攧
ripo	攩
rhhc	攫
rxgj	攭
rgke	攮
fcee	攰
ufcy	攱
dskc	攲
fcvf	攳
ttgy	攵
nhty	收
whty	攸
ghty	政
hkhc	敁
qkty	敂
wgkc	敆
gmit	敇
ywrt	效
tkty	敋
tdty	敌
txty	敏
dfet	敐
giyt	救
wjht	敒
wkqt	敓
gkit	敕
gqty	敖
ftbt	教
wgit	敛
umit	敝
imkt	敞
mawt	敟
jqrc	敡
nbty	敢
aety	散
jshc	敤
oohc	敥
ykbt	敦
ukty	敨
ccct	敪
ryty	敫
aqkt	敬
jgqt	敭
tfec	敮
nnac	敯
ovty	数
mgkc	敱
ykmc	敲
mgkt	敳
gkih	整
geht	敷
hptt	敹
akkc	敺
tdkc	敽
ugut	敾
tdkt	敿
lqjc	斀
fitw	斄
errc	斅
errt	斆
yygy	文
ydmj	斋
yfhy	斌
yhqb	斍
yjfi	斎
yyve	斏
hdhy	斐
gygg	斑
yjew	斔
oufh	料
ccpf	斚
qehf	斛
wgsf	斜
kkpf	斝
ewuf	斞
fjff	斡
lqjf	斣
rtth	斤
wrrj	斧
nhdr	斨
qkrh	斪
onrh	断
ajrh	斮
adwr	斯
usrh	新
nngr	斲
akgr	斳
oqar	斴
qyvr	斵
nilr	斸
yygt	方
ywjh	斺
ywuy	於
ytbn	施
ytbg	斿
yciy	旀
yupy	旁
ytmy	旃
yttn	旄
ytey	旅
yrmh	旆
ythc	旇
yyck	旈
ytnh	旋
yttg	旌
ytnx	旎
yttd	族
ytqi	旐
ydsk	旑
ytyk	旒
ytie	旓
yvgp	旔
ywux	旕
ytdk	旖
ytaw	旗
yujy	旘
ytol	旙
ytsi	旚
yttl	旛
ytwj	旝
ytup	旞
ytew	旟
vcaq	既
rxaq	旣
jjjj	日
jqyy	旳
jgfh	旴
jnrt	旸
jgbn	旽
gbnj	旾
jqug	昀
jqbj	昂
jdwu	昃
jrcy	昄
jbyy	昅
jxxb	昆
jgdu	昊
qajf	昏
jwvt	昐
jqrt	昒
jqrr	易
jywu	昗
jfcu	昙
dujf	昚
jang	昛
jgqr	昜
thjf	昝
jgmw	昞
jtgf	星
jmdy	映
jyxy	昡
jbmh	昢
jwet	昣
dwjf	春
jdjj	昦
jfiy	昧
jthf	昨
jgsy	昩
jcaj	昪
jqkg	昫
jvkg	昭
jaer	昮
jghu	是
jghf	昰
jqtb	昴
jnxn	昵
ynij	昶
jyni	昹
jabj	昻
nyjg	昼
jdxy	昽
jogf	显
jocy	昿
jqiy	晀
jqiu	晁
jigq	晃
jgjg	晅
jdfn	晇
gogj	晋
jtmk	晌
jawy	晎
jpvf	晏
jynw	晐
jatq	晓
jwxf	晔
jplj	晕
jplh	晖
jwyk	晗
jcwt	晙
jqkq	晚
jhqn	晛
jdny	晟
jgey	晡
rrjf	晢
jrrh	晣
jgkg	晤
jpfq	晥
jtxy	晦
jtfk	晧
jdfe	晨
jmaw	晪
jywf	晬
uogj	普
jyki	景
jsrh	晰
jooy	晱
jeqn	晲
srjf	晳
jgeg	晴
jjjf	晶
jthk	晷
tdkj	智
jdjn	晻
jssy	晽
jjjg	晿
jfaq	暁
lrjf	暂
jhdd	暃
jpgg	暄
jngg	暅
jnhc	暇
jdmy	暊
jwgd	暌
jamd	暎
jftj	暑
jjtg	暒
jgli	暕
jegc	暖
jujg	暗
jerm	暚
juga	暛
jths	暞
jmgu	暟
jykk	暠
jwcn	暡
jrno	暣
jjpv	暥
jepc	暧
vcag	暨
jamy	暪
jrif	暭
ajdj	暮
jtwh	暰
jdhv	暳
jawi	暴
jakw	暵
jwyp	暹
jkkl	暺
jjyi	暻
umij	暼
joqh	暽
jykt	暾
jfpu	曀
rxag	曁
jxjm	曊
jsjf	曋
jepa	曌
jlff	曎
jxtb	曏
jjje	曑
jryt	曒
jbmf	曓
jaqt	曔
jogi	曗
jlfj	曙
jtgo	曛
jnwy	曜
jjai	曝
jday	曞
jako	曣
jhal	曥
jugy	曦
jgkj	曧
jued	曨
jlxy	曪
jipo	曭
jkkt	曮
jnij	曯
jhng	曰
gjri	更
jxyi	曵
qrjf	曶
jqwn	曷
gmaj	曹
jqah	曻
jlcu	曼
uljf	曾
fwfj	替
jbcu	最
aqaj	朁
jber	朂
jhgi	朄
fcjn	朅
uljr	朆
eeee	月
efqn	朊
ewvt	朌
ebcy	服
ewyc	朎
ebmh	朏
eqkg	朐
muan	朑
emww	朒
eqiy	朓
ubte	朔
eudy	朕
eyve	朖
yvce	朗
ecwt	朘
mwme	朙
ynje	朚
yneg	望
eykb	朜
fjfe	朝
adwe	期
eamd	朠
erbt	朡
ahng	朢
eujf	朣
muoe	朥
eape	朦
ssss	木
sghy	朩
snhh	朻
scyy	杈
sgqn	杌
sftt	材
svyy	杒
sqyy	杓
stan	杔
sdyy	杖
ynsu	杗
sayy	杙
gkii	束
sgqt	杤
synn	杧
snrt	杨
scgg	杩
sitt	杪
sfqn	杬
sywn	杭
sgmh	杮
sdhy	杯
sqwy	杴
stfh	杵
swxn	杹
snhf	杻
scnh	杼
swcy	松
srcy	板
wcsu	枀
sbyy	极
squg	枃
sqcy	构
sxxn	枇
xxsu	枈
sqbh	枊
swgn	枍
sfwy	枎
smfg	枏
sgxg	枑
saht	枒
spqn	枕
stdy	枖
smwy	枘
srhy	枛
sfcy	枝
swwy	枞
svfh	枠
stah	枡
sary	枢
gmiu	枣
sdet	枥
smqn	枧
stay	枨
swcu	枩
swbn	枪
swry	枫
smyg	枬
qyns	枭
shkg	枮
sguf	枰
sckg	枱
cksu	枲
skwy	枳
skgn	枵
eksu	架
sekg	枷
sqkg	枸
sqnn	枹
sann	枻
ansu	枼
fasu	枽
sfah	枿
shcy	柀
spxn	柁
stbn	柂
swyc	柃
sgmw	柄
snxn	柅
stpy	柉
stuy	柊
ways	柋
sngk	柌
smdy	柍
swfy	柎
afsu	某
safg	柑
iasu	柒
ivsu	染
cnhs	柔
svkg	柖
swkg	柗
sjhh	柛
sang	柜
sryy	柝
sthf	柞
spsh	柠
sqay	柢
srwy	柣
segg	柤
sjgf	查
sjgg	柦
sdmh	柨
saqy	柩
sxet	柪
sxjh	柫
glii	柬
sdcy	柭
sbmh	柮
sskg	柯
sygg	柱
sntt	柲
sqtb	柳
hxsu	柴
skqn	柷
sdhg	柸
sket	柺
segf	査
scfg	柽
symh	柿
srgb	栀
srgq	栃
ipsu	栄
smmg	栅
gkhu	栆
sfiy	标
sfxy	栈
sabh	栉
sdxy	栊
saiy	栋
shnt	栌
stgg	栍
stni	栎
sudg	栏
syni	栐
scfy	树
dhvs	栔
sahh	栕
sqqy	栘
sudy	栚
seee	栛
sgmi	栜
stdg	栝
gdfs	栞
suah	栟
wtfs	栠
sywr	校
swtf	栣
suiy	栤
uqws	栥
sjxt	栧
suqw	栨
sriy	株
sdhb	栫
sqcn	栬
sdmj	栭
sdeg	栯
sway	栰
sftn	栲
sftx	栳
stmy	栴
sgqj	栵
sldy	栶
sugh	样
synw	核
svey	根
sxjg	栺
saay	栻
stkg	格
fsxy	栽
yosu	栾
swdy	栿
qahs	桀
stgs	桁
sffg	桂
sqiy	桃
sigq	桄
sqdb	桅
sagg	框
vksu	桇
pvsu	案
spvg	桉
udsu	桊
hjsu	桌
sdfn	桍
sgcf	桎
smgk	桐
cccs	桑
sfkg	桔
stlg	桖
sbsy	桗
swnn	桘
sctg	桙
svqy	桚
shgh	桛
sqah	桝
sgog	桠
satq	桡
shmy	桢
sivg	档
smnn	桤
stdj	桥
swxf	桦
swfc	桧
uqsu	桨
sofg	桩
svfy	桪
siit	桫
iits	桬
sdfe	桭
skgg	桯
sqak	桰
sgva	桱
sfpb	桲
scdf	桳
sebg	桴
sevg	桵
sceh	桶
sqeh	桷
srdh	桸
syve	桹
stdh	桻
svtk	桾
sgki	梀
ivws	梁
sgiy	梂
stfp	梃
ssgg	梄
stxy	梅
sdtb	梆
rrsu	梊
skeg	梋
swgs	梌
stfk	梏
sxxf	梐
sqto	梑
swyk	梒
sufh	梓
svyn	梕
sgjr	梗
shqn	梘
sqkq	梚
sngb	梛
sdww	梜
snny	梞
skkg	梠
spfq	梡
sieg	梢
smwn	梣
smwv	梤
pwcs	梥
ssqu	梦
sgkg	梧
tjsu	梨
sjfg	梩
sgku	梪
svpc	梫
smgn	梬
scwt	梭
snnk	梮
suxt	梯
saah	械
swkq	梲
syck	梳
sthp	梴
sswy	梵
sntn	梶
hkcs	梷
stjh	梸
srgw	梹
ssgh	梺
swxj	梻
sdtf	梼
sgus	梾
slpy	梿
swgg	检
sukq	棁
svoy	棂
tqts	棃
stgi	棅
swcn	棇
srmh	棉
adws	棊
sadw	棋
sesy	棌
sjxx	棍
spws	棎
hdhs	棐
shdd	棑
sdwg	棒
sukg	棓
sqaj	棔
spfi	棕
gmii	棘
seeg	棚
sywu	棜
sldg	棝
slty	棞
ipks	棠
smum	棡
smun	棢
sviy	棣
sajg	棤
srrs	棥
sqvh	棦
ynts	棨
sooy	棪
sudb	棬
sywy	棭
sssu	森
stfg	棰
sfwt	棱
sccc	棳
sebc	棴
sjsy	棵
ssww	棶
sbcy	棷
shjf	棹
sphn	棺
awvs	棻
sswv	棼
sswn	棽
sspw	棾
seqn	棿
spqb	椀
sykb	椁
shaw	椃
suvg	椄
sdsk	椅
smfk	椆
sqoy	椈
yqas	椉
syki	椋
spwa	椌
sfhg	植
swyg	椎
sndg	椐
srtf	椑
shgc	椒
sgey	椓
svlg	椔
swvs	椕
spgh	椗
sspu	椘
sjjg	椙
sawx	椛
swgw	検
fwms	椝
srsu	椞
sfnd	椟
lrsu	椠
sgcj	椡
slgy	椢
smaw	椣
slqy	椤
stdk	椥
sude	椦
sowf	椨
sovw	椩
suog	椪
sulh	椫
speg	椬
sbde	椭
scde	椮
smdj	椯
sbbh	椰
stjt	椱
snkh	椲
slge	椳
swdc	椴
snhc	椵
srbt	椶
sdgy	椷
sytb	椸
sadn	椹
swks	椺
sajv	椻
stis	椼
sxge	椽
suej	椾
sdwj	椿
stky	楀
sptk	楁
ssjg	楂
sngf	楃
syna	楄
sgkl	楅
ssvg	楆
smnk	楇
snhe	楈
sadk	楉
sgkj	楋
sute	楌
splh	楎
sdff	楏
slwj	楐
swgd	楑
slny	楒
sdhd	楔
sdae	楕
svcb	楖
svgp	楗
scns	楙
ssnh	楚
sadg	楛
sgli	楝
slyt	楞
syks	楟
sfmf	楠
snhg	楣
sqrn	楤
segc	楥
spgg	楦
samd	楧
sans	楪
skbg	楫
sjqn	楬
sftj	楮
srfh	楯
sewy	楰
sdwd	楱
safs	楳
syuh	楴
sxxr	楷
stoy	楸
sbcl	楹
srgg	楻
sovg	楼
stjg	楿
skkk	榀
spgf	榁
svcq	概
sjtq	榄
sjlg	榅
swgj	榆
susy	榇
sukk	榈
sigg	榉
spyh	榊
svvv	榋
snuh	榌
snie	榍
sdht	榎
suwl	榏
snae	榐
sxuu	榒
sntl	榓
syvb	榔
spwk	榕
sgoj	榗
tdas	榘
sawk	榙
sugo	榚
sdwt	榛
syuy	榜
sdri	榞
spuf	榟
spjw	榠
sgxi	榡
spge	榢
serm	榣
sqas	榤
sjiq	榥
sahd	榧
spwf	榨
shay	榩
swyf	榫
stmf	榭
syke	榱
slwl	榲
sotp	榳
sqyl	榴
sabg	榵
sovk	榶
spwy	榷
srhw	榹
euds	榺
sjng	榻
sfcl	榼
sexd	榽
smeg	榾
ykms	槀
sykk	槁
sbti	槂
sgkh	槅
saqj	槆
sxhw	槇
sutd	槉
ubts	槊
swnp	槌
suga	槎
suvo	槏
srqc	槐
kkss	槑
syxl	槒
srdf	槔
shjs	槕
fpds	槖
sdkk	槗
sugi	様
ssmy	槚
sjtl	槛
swyb	槜
swvm	槝
sujn	槞
sprw	槟
syfj	槠
sccs	槡
snrg	槢
spdk	槣
sdhv	槥
sovh	槦
rxas	槩
srxq	槪
sdfy	槬
scce	槮
stdp	槰
sqef	槲
sync	槴
skkn	槵
slag	槶
fwfs	槷
srif	槹
sovi	槺
sfwq	槻
fwhs	槼
sgmj	槽
sjlc	槾
sakg	槿
sbgi	樄
swhe	樇
sujq	樈
sdrr	樉
srrd	樊
scep	樋
sxfm	樌
sgmy	樍
spwj	樎
slxi	樏
shlo	樐
spnm	樒
svjs	樔
sgkw	樕
wgkk	樖
sffn	樗
sipf	樘
sonx	樚
soao	樜
shag	樝
sujf	樟
samy	樠
sajd	模
swhs	樤
sath	樥
styg	樦
snig	樨
samw	横
sahf	樫
stln	樬
sadf	樭
ssoy	樮
sfuk	樯
sfvg	樰
smmv	樱
safy	樲
svaf	樳
sujy	樴
swyo	樵
sjbc	樶
ssbc	樷
skhm	樻
snbb	樼
susf	樽
sfhy	樾
skkl	樿
sycl	橀
stqj	橁
susd	橂
swxc	橃
snbt	橄
srlo	橅
rlgs	橆
stfn	橇
soqh	橉
sgjl	橊
stol	橎
sugk	橏
gkhs	橐
sdui	橑
seph	橓
sykt	橔
sipt	橕
saje	橗
scnk	橘
swgu	橙
svfj	橚
sduw	橛
ssjf	橝
syqe	橠
sqke	橡
spnh	橣
nnns	橤
qtfs	橥
sulj	橧
sfam	橨
soof	橩
sqdo	橪
sduf	橭
sqym	橮
sooe	橯
sdgf	橱
seue	橳
shxi	橴
saet	橵
sfja	橶
sruq	橷
sjjj	橸
sqgj	橹
sujg	橺
sxxe	橼
sfup	橽
skks	橾
sylg	檀
smae	檂
beas	檃
sryt	檄
shdy	檅
sook	檆
swym	檇
sawl	檋
slhd	檌
sogi	檏
sqdy	檐
sflg	檑
seac	檓
lbws	檕
suep	檖
nkus	檗
snkf	檘
shnn	檙
smnp	檛
skby	檝
sqeg	檞
aqks	檠
slff	檡
sutp	檤
sugy	檥
ssfj	檦
saqn	檧
sugw	檨
syli	檩
sris	檪
spwi	檫
sape	檬
sqve	檭
sfnf	檮
sxrh	檰
slgf	檲
sawc	檴
sdak	檶
sytk	檹
sean	檼
sfdj	檽
oops	檾
djes	檿
sadi	櫀
spnj	櫁
syuj	櫅
srqf	櫆
shcm	櫇
sutk	櫊
sthy	櫋
srrm	櫍
soaw	櫎
llls	櫐
slll	櫑
sawi	櫒
sday	櫔
sfwm	櫕
shan	櫖
saly	櫗
sdhn	櫘
saak	櫙
sowc	櫠
stfj	櫡
slvt	櫢
stuj	櫤
svcg	櫭
sqot	櫯
syle	櫰
btws	櫱
scne	櫲
sgkm	櫴
sawo	櫵
spdn	櫶
stxg	櫷
savj	櫹
swwg	櫼
seri	櫾
smas	欁
saif	欂
sqky	欃
segr	欅
sbbb	欇
smwk	欈
sogc	欉
shhy	欋
sady	欌
stfm	欑
sipo	欓
shhc	欔
skkt	欕
saui	欗
snij	欘
slli	欙
sxgj	欚
sgke	欜
sakq	欟
uqwy	次
cqwy	欢
rqwy	欣
gngw	欤
arqw	欧
qkqw	欨
vkqw	欩
bmqw	欪
rhqw	欫
ldqw	欭
ubtw	欮
fkqw	欯
tlqw	欰
wwkw	欲
hmaw	欳
yvcw	欴
xtdw	欵
rdmw	欷
ctdw	欸
dskw	欹
adww	欺
ooqw	欻
ffiw	款
qeqw	欿
sfiw	歀
mdmw	歂
tfew	歃
mnmw	歄
sfqw	歅
ujqw	歆
jqww	歇
uvow	歉
ykmw	歊
rhaw	歋
sksw	歌
akgw	歏
hatw	歑
yumw	歒
haow	歔
fkuw	歖
vfjw	歗
ooow	歘
lqjw	歜
lfuw	歝
jxxw	歞
hhgg	止
fhny	武
hfcy	歧
hitr	歩
dhgh	歪
hang	歫
hteu	歬
hffy	歭
hobj	歯
vyvh	歰
htgf	歱
hdgy	歳
dssh	歴
hgmy	歵
hxjy	歶
gqxv	死
gqtf	歼
gqqr	歾
gqwc	殁
gqeg	殂
gqmd	殃
gqwe	殄
gqck	殆
gqtr	殇
gqtl	殈
gqqj	殉
gqri	殊
gqfy	残
gqeb	殍
gqgy	殏
gqgi	殐
gqdq	殑
gqkm	殒
gqwg	殓
gqvi	殔
gquk	殕
gqfh	殖
gqdn	殗
gqul	殚
gqbg	殛
gqas	殜
gqdt	殝
gqjl	殟
gqpw	殡
gqah	殢
gqwo	殦
gqho	殩
gqfu	殪
gqlf	殬
gqfm	殰
arwc	殴
wdwc	段
ygwc	殶
rvnc	殷
fnwc	殸
atdc	殹
fpwc	殻
rdec	殽
ftjc	殾
nawc	殿
eawc	毁
fplc	毂
lkwc	毄
uewc	毅
eowc	毇
qytc	毈
atdw	毉
fnwk	毊
xnny	母
txfj	毎
fxdf	毐
txyk	毓
xxfj	毕
xxnt	毖
lxxn	毗
lxxb	毘
xxgx	毙
qkxy	毚
tfnv	毛
tfni	毜
tfne	毝
xxtn	毞
ektn	毠
tfnk	毡
tfns	毢
wcqn	毤
btfn	毦
tfnq	毨
tfng	毪
ykpn	毫
gkun	毭
ritn	毮
tfno	毯
tfnn	毳
cden	毵
jhtn	毷
daen	毻
tfnp	毽
jntn	毾
lvtn	氀
fitn	氂
imkn	氅
tfnj	氆
apfn	氋
hhwn	氍
llln	氎
qayi	氐
qafj	氒
ynna	氓
rntr	氕
rnbr	氖
rnri	気
rnjj	氘
rnmj	氙
rnkj	氚
rnwv	氛
rnjd	氜
rnmw	氝
rngw	氞
rnxj	氟
rntu	氡
rnca	氢
rnld	氤
rnsf	氥
rnug	氧
rnpv	氨
rngg	氩
rndq	氪
rngi	氭
rnoo	氮
rnvi	氯
rnge	氰
rnjr	氱
rnjl	氲
iiii	水
iyyg	氵
ynii	永
ihyy	氺
giyi	求
ignn	汅
tyiu	汆
ingg	汈
icyy	汊
iqyy	汋
iynn	汒
itnn	汔
infh	汛
ifnn	污
inrt	汤
iqan	汦
igah	汧
ifjh	汫
fjiu	汬
iqug	汮
idcy	汯
idyy	汰
ibyy	汲
ircy	汳
iyhy	汴
iwyn	汵
irbh	汹
itgh	汼
irnn	汽
iwvt	汾
icnh	汿
itdy	沃
ifqn	沅
iywn	沆
icqn	沇
ipqn	沈
ipwn	沉
pqii	沊
idny	沋
igbn	沌
iavt	沏
inhf	沑
ighn	沔
iqrt	沕
gdiu	沗
ixxn	沘
iitt	沙
igmh	沛
ithn	沜
iqcy	沟
irhy	沠
iwcy	没
inyy	沢
idhh	沣
iary	沤
idet	沥
iwxn	沦
iwbn	沧
iwry	沨
iyty	沩
iynt	沪
igsy	沫
isyy	沭
iegg	沮
ipxn	沱
itbn	沲
iskg	河
iwet	沴
ixjh	沸
ickg	治
ivkg	沼
ihkg	沾
iwkg	沿
ingk	泀
imkg	泂
iqkg	泃
iann	泄
ilwy	泅
iekg	泇
ifah	泋
intt	泌
ibmh	泏
ibet	泐
ixet	泑
ixcy	泓
iafg	泔
ifcy	法
iqtb	泖
iguf	泙
ihxn	泚
itpy	泛
iqay	泜
iryy	泝
ipsh	泞
ighg	泟
iwyc	泠
iqnn	泡
ihcy	波
inyw	泤
inxn	泥
invn	泦
igny	泧
iygg	注
iyxy	泫
iwfy	泭
inan	泯
dwiu	泰
imdy	泱
iyni	泳
ipiu	泶
idxy	泷
ihnt	泸
ijgg	泹
itni	泺
ipgg	泻
inty	泼
icgh	泽
icag	泾
ivey	泿
itey	洀
ifkg	洁
iyoy	洂
idoy	洃
ilkg	洄
igmf	洅
ibig	洆
ildy	洇
iqdb	洈
irgk	洉
idhb	洊
iugh	洋
igqj	洌
ithg	洎
idmj	洏
itgs	洐
igmi	洓
iweg	洕
ikgd	洖
itfq	洗
iftn	洘
iriy	洙
itah	洚
itkg	洛
ipvg	洝
imgk	洞
igxw	洟
ictg	洠
iwgg	洤
ivgh	津
iywr	洨
iawy	洪
itlg	洫
iqiy	洮
iang	洰
iyth	洲
iuah	洴
iqjg	洵
igcf	洷
iigq	洸
igjg	洹
itdg	活
iffg	洼
iwgk	洽
irey	派
idfn	洿
imag	浀
iyck	流
iudy	浂
igud	浃
iqvh	浄
ifxy	浅
uqiu	浆
iatq	浇
ihmy	浈
ijgh	浉
imjh	测
iway	浌
iwfc	浍
iyjh	济
iutt	浐
iplh	浑
iytf	浒
ipey	浓
ivfy	浔
inyu	浕
iefy	浖
intn	浘
irrh	浙
icwt	浚
iwyk	浛
irgw	浜
ikhy	浞
iwht	浟
irdh	浠
ifpb	浡
igku	浢
ipfq	浣
ipdc	浤
ikcn	浥
igey	浦
ikgg	浧
itfk	浩
iyve	浪
igjr	浭
iebg	浮
igkg	浯
itjh	浰
idfe	浱
iaye	浳
iwwk	浴
imye	浵
itxy	海
ivpc	浸
inkh	浺
imwk	浻
iqkq	浼
ievg	浽
ifoy	浾
ihqn	涀
iset	涁
iwgs	涂
ilsy	涃
imgn	涄
ijfg	涅
ijfh	涆
iieg	消
ihht	涉
ivyn	涊
iceh	涌
iftb	涍
ithp	涎
itfp	涏
itry	涐
igki	涑
ikeg	涓
imwn	涔
iuxt	涕
iwkq	涗
ictd	涘
iynd	涙
iukq	涚
idtf	涛
ifpq	涜
iape	涝
igoy	涞
ilpy	涟
ilfh	涠
ikmw	涡
ikmy	涢
iqmd	涣
itsy	涤
iugg	润
iujg	涧
ixty	涨
ivyh	涩
iukg	涪
iphn	涫
ifuf	涬
inmj	涮
idff	涯
iccc	涰
idey	涱
iywy	液
ipwa	涳
ipqb	涴
ibib	涵
igji	涷
ildg	涸
itvg	涹
indg	涺
iwfk	涻
iqaj	涽
ipgh	淀
iuvg	淁
ijgf	淂
iudb	淃
ivlg	淄
isrh	淅
irde	淆
iadw	淇
inbm	淈
ijsy	淉
iqeg	淊
issy	淋
iimk	淌
imfk	淍
ijjg	淐
ihgc	淑
ifhg	淔
ihjf	淖
iqoy	淗
iqrm	淘
ipfi	淙
iecn	淝
iswc	淞
imaw	淟
ilgj	淠
iooy	淡
iakg	淢
ieqn	淣
iywu	淤
ietf	淫
iywf	淬
iyns	淭
iwyg	淮
ipws	深
iykb	淳
ijxx	混
igmg	淸
idjn	淹
igdn	添
iiiu	淼
irmh	淿
idfa	渀
ijyy	渂
ihdd	渄
igeg	清
iuaj	渆
ijqx	渇
itoh	渊
iviy	渌
igmy	渍
ifnd	渎
idsk	渏
ilrh	渐
ikjn	渑
irtf	渒
iefw	渓
iqgg	渔
iudj	渕
ipjh	渖
icde	渗
icns	渘
iftj	渚
iwgj	渝
iuth	渞
iyks	渟
ians	渠
ioac	渡
iwtj	渢
isjg	渣
ifpe	渤
ingf	渥
ijlg	温
itky	渪
ileg	渭
iask	渮
iawn	港
ijag	渱
ixbg	渳
ijqn	渴
ialg	渵
iywq	渷
iytb	游
iqyg	渹
ihit	渺
ifky	渽
irwk	湁
irdf	湃
inhg	湄
igli	湅
iafs	湈
intd	湉
iwye	湌
imdj	湍
idmd	湎
idmy	湏
inhe	湑
ikbg	湒
iwvl	湓
iuej	湔
ivgp	湕
ideg	湖
ishg	湘
iyod	湙
iadn	湛
ixxr	湝
irgg	湟
imdo	湠
ijmy	湡
igkl	湢
innj	湣
ijtg	湦
ihdy	湨
ixge	湪
itoy	湫
toiu	湬
iusg	湭
isfg	湮
idhd	湱
iegc	湲
ifmf	湳
iugy	湵
idwj	湷
iykw	湸
idjf	湹
iwks	湺
iykj	湻
ieag	湼
igvl	湽
iyox	湾
ijog	湿
igkj	溂
ikhm	溃
imfy	溅
iwgc	溆
iovg	溇
ivcq	溉
inhc	溊
ibcl	溋
iwfq	溌
igoj	溍
iovk	溏
idri	源
iimy	溑
iuvo	溓
iugo	溔
ipfe	溕
ifcl	溘
idwi	溙
iawk	溚
iqyl	溜
icyj	溞
ipjw	溟
ijff	溡
iuwl	溢
iwwa	溣
icoy	溤
igef	溥
imgt	溦
ifsy	溨
iwno	溩
iexd	溪
ilwt	溭
iube	溯
imgu	溰
idwt	溱
iehc	溲
ithy	溴
irvc	溵
ipwk	溶
ilge	溷
igxi	溸
ifpi	溹
ixuu	溺
ijng	溻
irqc	溾
ilug	溿
iyxl	滀
ibws	滁
iyuy	滂
iwcn	滃
ifhw	滇
irno	滊
iuxx	滋
ibhj	滍
iwru	滏
iqas	滐
imeg	滑
ipuf	滓
ieeg	滔
eudi	滕
ittn	滗
iywe	滚
ierm	滛
iujn	滝
igkh	滞
idhc	滟
ibcc	滠
iagw	满
iapy	滢
idfk	滣
ihan	滤
ijtl	滥
iyos	滦
iprw	滨
icwy	滩
icnm	滪
iwhe	滫
ijaf	滭
ihae	滮
iujq	滰
iyuk	滳
iyud	滴
ipnm	滵
igqt	滶
ihaf	滹
iwhn	滺
iovh	滽
fnwi	漀
isfi	漂
iphc	漃
imdf	漄
ivjs	漅
iswi	漆
ithh	漇
iwfi	漈
ionx	漉
ilvg	漊
ibtg	漋
ilag	漍
itwh	漎
infy	漏
fufi	漐
irxq	漑
ixkj	漒
iyrc	漓
ipgw	演
igmj	漕
iftt	漖
itln	漗
issf	漜
inrg	漝
iehq	漞
iipf	漟
iajd	漠
itjr	漡
issv	漤
iqtk	漪
ijlc	漫
iada	漭
iovi	漮
ilxi	漯
imee	漰
igkw	漱
impi	漴
ikkn	漶
igho	漹
idrr	漺
inwe	漻
inig	漽
itte	潃
igkt	潄
iapi	潆
iavj	潇
itle	潈
imjx	潉
iwgt	潋
ixwy	潍
iumt	潎
icnk	潏
iqke	潒
irlo	潕
iwys	潗
itol	潘
ieto	潙
ivfj	潚
ifwj	潜
iwgn	潝
ikhk	潞
innw	潠
iamw	潢
iuyy	潣
isoy	潥
idui	潦
iulj	潧
itli	潨
ilaw	潩
itdj	潪
ikkl	潬
isjf	潭
ifje	潮
ifpu	潱
itie	潲
infj	潳
iqtj	潴
iaet	潵
ilfo	潶
isse	潸
isss	潹
inbb	潺
itwi	潻
iujf	潼
iuoj	潽
ioqh	潾
ihhh	澁
edmi	澃
iwgu	澄
iyct	澈
inbt	澉
iusf	澊
ijyi	澋
iadr	澌
ifkf	澍
ifke	澎
ikkm	澏
igjl	澑
irtk	澔
iagf	澕
iusy	澖
issj	澘
iego	澙
itmn	澚
iqgj	澛
iugi	澜
ipnh	澝
iylt	澟
ikks	澡
iipl	澢
ifjf	澣
imau	澧
ifwc	澪
iajy	澫
iuqm	澬
ihqo	澯
iwgw	澰
iogi	澲
itmd	澳
iusr	澵
iylg	澶
ijly	澷
idgn	澸
iqdy	澹
iuep	澻
inkf	澼
ifup	澾
issi	澿
iryt	激
iouo	濂
imnp	濄
ipvc	濅
ifam	濆
ikby	濈
ihwy	濉
issh	濋
ihnn	濎
iggt	濏
ijfj	濐
igkm	濑
ihhm	濒
iajh	濗
ioos	濚
ivhl	濜
iadi	濝
ithj	濞
iyke	濠
ifdj	濡
inyf	濢
iqpw	濥
iean	濦
iogf	濧
iuxn	濨
iawc	濩
igec	濪
iwow	濮
inwy	濯
ifpc	濲
iooi	濴
iutd	濶
ibkm	濻
ifwm	濽
iday	濿
iufe	瀁
iqoj	瀂
imjr	瀃
itvb	瀄
ioaw	瀇
inpl	瀈
itel	瀊
iono	瀌
iojf	瀍
ialy	瀎
ifhy	瀐
ijai	瀑
iswk	瀒
itmt	瀓
ipdn	瀗
iusq	瀙
ifjn	瀚
iyny	瀛
igeh	瀞
ibdp	瀡
ikhp	瀢
ihqg	瀣
iyle	瀤
inyk	瀥
itwm	瀩
ifss	瀮
iook	瀯
ildj	瀱
iaoo	瀳
immv	瀴
iolw	瀵
iahk	瀶
inlw	瀷
iwga	瀹
iqky	瀺
ifly	瀻
ipah	瀽
itxi	瀿
ifsh	灀
iuri	灁
ielf	灂
illf	灅
iaal	灆
iogc	灇
ihhy	灈
ivky	灉
iaqh	灊
ionc	灋
iaky	灌
iuuw	灍
imal	灎
ijym	灏
iooq	灐
yxxi	灓
imac	灔
iosd	灖
ijyg	灗
iukl	灛
ifae	灞
inij	灟
iahq	灠
iaui	灡
igke	灢
ijxm	灦
imdc	灧
iujm	灨
isre	灪
oooo	火
oyyy	灬
qyou	灸
oqyy	灼
onrt	炀
owcy	炂
wvou	炃
onhf	炄
oynt	炉
oqwy	炊
odhy	炋
owjh	炌
orcy	炍
odhh	炐
oitt	炒
onwy	炔
oywn	炕
ogbn	炖
owxb	炛
ofnh	炜
owbn	炝
oyhy	炞
ojgg	炟
oghg	炡
osyy	炢
oskg	炣
ovkg	炤
oxjh	炥
odcy	炦
otbn	炧
opxn	炨
owyc	炩
obmh	炪
oyxy	炫
oang	炬
mdou	炭
oqnn	炮
omkg	炯
ckou	炱
ogmw	炳
omdy	炴
otuy	炵
oygg	炷
othf	炸
hkou	点
oanw	炼
okwy	炽
okqn	炾
otmy	炿
otuf	烀
otni	烁
oudg	烂
ocag	烃
oywr	烄
otlg	烅
otgs	烆
owgg	烇
gqjo	烈
qmwo	烉
ough	烊
wsou	烋
owsy	烌
otfq	烍
gaou	烎
otey	烐
oqiy	烑
oaay	烒
offg	烓
omgk	烔
dgoy	烕
foxy	烖
oynw	烗
oawy	烘
otkg	烙
owgk	烚
ogjg	烜
bigo	烝
oshy	烞
oldy	烟
opta	烢
odoy	烣
oftn	烤
oahh	烥
odmy	烦
oatq	烧
owxf	烨
owfc	烩
oudy	烪
inro	烫
onyu	烬
rvyo	热
ordh	烯
oebg	烰
omwk	烱
rrou	烲
oaqy	烵
opfq	烷
otxy	烸
othp	烻
otdh	烽
ooff	烾
omye	烿
ofoy	焃
vtko	焄
otfk	焅
okeg	焆
oieg	焇
ynno	焈
ghgo	焉
ojfh	焊
nhdo	焋
ocwt	焌
ouxt	焍
bkco	焏
ogkg	焐
olsy	焑
okkg	焒
owyk	焓
oqhj	焔
oqmd	焕
ouny	焖
onnk	焗
dtfo	焘
oukg	焙
ssou	焚
ojxx	焜
oqaj	焝
opwa	焢
bcou	焣
owfo	焤
opqb	焥
wyou	焦
owcn	焧
ojeg	焨
oeeg	焩
oamw	焫
ojqr	焬
oopw	焭
orqw	焮
ohjf	焯
oqeg	焰
ooou	焱
owyg	焳
omum	焵
qdyo	然
jjou	焸
omun	焹
ojta	焺
ojjg	焻
ofaq	焼
jeou	焽
oovw	焿
onbm	煀
oadn	煁
odff	煃
otgf	煄
owdc	煅
onhc	煆
oplh	煇
owtj	煈
opgg	煊
ojtg	煋
orgg	煌
otoy	煍
uejo	煎
ogkl	煏
omdj	煓
oohk	煔
ahho	煕
odmd	煗
odgy	煘
jano	煚
hhou	煛
ojug	煜
onhg	煝
qvto	煞
oleg	煟
oans	煠
ovgp	煡
oafs	煤
jqko	煦
jvko	照
olge	煨
ouey	煫
ftjo	煮
oxxr	煯
okkk	煰
omnk	煱
wkso	煲
ojlg	煴
ofmf	煵
ojgh	煶
oykw	煷
oyna	煸
oamf	煹
ovep	煺
oqbt	煼
oynn	煽
oldn	煾
ogef	煿
ojiq	熀
oeee	熁
orno	熂
cnho	熃
othn	熄
olwl	熅
oykk	熇
taho	熈
okmy	熉
cexo	熊
ouwy	熌
opkk	熍
oerm	熎
tglo	熏
opjw	熐
owno	熓
opwk	熔
oamy	熕
oqyl	熘
ahko	熙
ojaf	熚
osfi	熛
otln	熜
oahf	熞
ykbo	熟
onrg	熠
olvg	熡
otdp	熢
omwy	熣
onug	熤
ocep	熥
oiwy	熦
nfio	熨
oync	熩
otqq	熪
ooao	熫
gqto	熬
dhdo	熭
oakw	熯
oakk	熰
ojlc	熳
omjx	熴
oyuk	熵
ojbc	熶
oulj	熷
oaqj	熸
fkuo	熹
ofkk	熺
owgn	熻
ovfj	熽
okkl	燀
osjf	燂
oqdo	燃
fwfo	燅
otdk	燆
ousf	燇
ooos	燊
ofam	燌
oadr	燍
odui	燎
ocnk	燏
oujf	燑
srro	燓
otol	燔
akuo	燕
ovaf	燖
oueg	燗
ouyy	燘
nhao	燛
ojyi	燝
wyqo	燞
otmd	燠
olff	燡
erro	燢
oylt	燣
oajy	燤
okks	燥
ouep	燧
ougy	燨
oaqn	燪
oouo	燫
yooc	燮
ofwc	燯
oept	燰
oujn	燱
oeem	燲
ojvo	燳
ofup	燵
omae	燶
gego	燹
oyks	燺
ofnf	燽
ofoo	爀
oahl	爁
oday	爄
ojai	爆
ohan	爈
ovln	爉
oono	爊
opdi	爎
odth	爏
oawo	爑
qodi	爒
ouqe	爓
yooo	爕
oued	爖
ohqe	爘
oyke	爙
owga	爚
oogc	爜
oelf	爝
ojjj	爞
oaky	爟
ohhy	爠
oipo	爣
oaui	爤
onij	爥
oahq	爦
ofkw	爧
emgo	爨
osre	爩
rhyi	爪
rhyc	爬
emff	爯
egdc	爰
epdc	爱
etnb	爳
laky	爴
elvf	爵
wrbj	爷
wrcb	爸
wrqq	爹
rreg	爼
drrr	爽
nhde	爿
nhds	牀
nhdk	牁
nhdg	牂
nhdh	牅
thgn	片
thgc	版
thgg	牉
thga	牋
thgf	牌
thgd	牍
thge	牐
thgs	牒
thgy	牖
thgh	牗
ahte	牙
ipkt	牚
ctgj	牟
ptgj	牢
tvyy	牣
tynn	牤
tqrt	物
wayg	牮
tskg	牱
ttgg	牲
dptg	牵
tpbg	牸
tffy	特
tgva	牼
tgkg	牾
ttfk	牿
nitg	犀
tjtg	犁
tukg	犃
tdsk	犄
tmum	犅
tudb	犈
tykb	犉
tfnd	犊
thwy	犋
tvgp	犍
ttuf	犐
tqbt	犓
trno	犔
tpdk	犗
tcce	犙
nfig	犚
tykt	犜
ttdk	犞
xkjg	犟
tugy	犠
tday	犡
tvln	犣
tlcx	犤
tono	犥
tvrg	犩
tutt	犪
qttt	犭
dcyi	犮
qtbn	犯
qtvn	犰
qtvy	犱
qtft	犲
qtqy	犳
qttn	犵
udyy	状
qtot	犷
qtcg	犸
qtdy	犹
qtyw	犺
qtyh	犿
qtcq	狁
qtgg	狂
qtnf	狃
qtoy	狄
qtkh	狆
qtsy	狇
qtmy	狈
qtdg	狉
hdyu	狊
qtfi	狋
qttg	狌
qtqn	狍
qtlh	狎
qttb	狏
qtry	狐
qtxj	狒
qthc	狓
qtnx	狔
qtxe	狕
qtqk	狗
qtgy	狘
qteg	狙
qtrg	狛
qtps	狞
qtve	狠
qtyr	狡
qttk	狢
qtqj	狥
qtmf	狦
qttd	狧
qtad	狨
qtpf	狩
qtfx	狫
qtjy	独
qtgd	狭
qtjh	狮
qtwc	狯
qtqh	狰
qtyy	狱
qtbi	狲
qtws	狳
qtxf	狴
qtrh	狶
qtke	狷
qtjf	狸
qtyg	狺
qtct	狻
qtye	狼
qttp	狿
qttj	猁
qtwg	猃
qtyi	猄
qthd	猅
qtrf	猈
qtaw	猉
qteq	猊
qtaj	猎
qtjx	猑
qtjs	猓
qtpi	猔
qtxi	猕
qtjj	猖
qtdk	猗
qtwy	猚
qtbl	猛
qtge	猜
qtyf	猝
qtwk	猞
qtig	猟
qtlq	猡
qtde	猢
qtrt	猣
qtle	猥
qtwj	猦
qtec	猨
qtjg	猩
qtfj	猪
qtal	猫
fmuy	献
qtmj	猯
qtdd	猰
qtcs	猱
qtjn	猲
qtnc	猳
qtwd	猴
qtya	猵
usgy	猷
qtnh	猸
qtsg	猹
qtem	猺
qtme	猾
qtfe	猿
qtco	獁
mgky	獃
qtuc	獇
qtdt	獉
qtjc	獌
qtuq	獍
qtuf	獐
qtlr	獑
qtfm	獖
qtdw	獗
umiy	獘
qtut	獙
qtow	獛
qtoh	獜
qtck	獝
qtdi	獠
qteo	獡
ilgy	獣
qtyt	獤
qtan	獦
qthy	獩
qtqg	獬
qtgm	獭
qtto	獯
qtpm	獱
qtae	獴
qthl	獹
qtay	獾
qtkt	玁
yxit	玅
yxif	率
gggg	王
gqyy	玖
ggng	玙
gnrt	玚
gcgg	玛
gwcy	玜
gtfh	玝
gwjh	玠
gaht	玡
gwvt	玢
gyhy	玣
gnwy	玦
gcqn	玧
gfqn	玩
gxxn	玭
gfnh	玮
gdhy	环
gmqn	现
gwyc	玲
gway	玳
gafg	玵
ghkg	玷
gyxy	玹
qigy	玺
ghcy	玻
gqkg	玽
gvkg	玿
gskg	珂
gjhh	珅
gckg	珆
gekg	珈
gnan	珉
gmmg	珊
gntt	珌
gwet	珍
ggyy	珏
gfcy	珐
gdxy	珑
gvgh	珒
gdhb	珔
gtey	珘
gawy	珙
gldy	珚
gugh	珜
gtkg	珞
gwgq	珟
griy	珠
gvey	珢
gqjg	珣
grmh	珤
gtmk	珦
gqiy	珧
gtgs	珩
gycq	珫
gytg	班
gftx	珯
givg	珰
gplh	珲
gyet	珳
gkgg	珵
gfhy	珷
gdny	珹
gvtk	珺
gtxy	珻
gkhy	珿
gwyk	琀
ggiy	球
gkeg	琄
gyve	琅
gjfg	理
gebg	琈
gyck	琉
gahb	琊
gmwn	琌
gtjh	琍
gfjp	琎
glpy	琏
gimy	琐
gtdh	琒
gpgh	琔
grtf	琕
gywf	琗
gqaj	琘
gndg	琚
gpws	琛
gjyy	琝
jegy	琞
gwyg	琟
ggey	琢
gukg	琣
gqvh	琤
ghaw	琥
gdsk	琦
gfgy	琧
gjxx	琨
gadw	琪
gpqb	琬
gviy	琭
gpfi	琮
gphn	琯
gooy	琰
gmfk	琱
gssy	琳
ggwn	琴
ggxx	琵
ggcb	琶
ghjf	琸
gyki	琼
gftj	琽
glwj	琾
gtky	瑀
gjhg	瑁
gnhg	瑂
gdwj	瑃
gcns	瑈
gnnj	瑉
gdmd	瑌
gxxr	瑎
guej	瑐
gxge	瑑
gjgr	瑒
ggli	瑓
gnhc	瑕
gwdc	瑖
gegc	瑗
gbbh	瑘
gvtr	瑙
gdeg	瑚
gamd	瑛
gwgj	瑜
grgg	瑝
gmdj	瑞
ggnt	瑟
gqyl	瑠
gwnh	瑡
gpwk	瑢
gjlg	瑥
gwno	瑦
ggoj	瑨
iycy	瑬
govk	瑭
grqc	瑰
guga	瑳
gcyj	瑵
germ	瑶
gepc	瑷
gprw	瑸
giph	瑺
gxfm	瑻
gtwh	瑽
gakg	瑾
atdy	瑿
gmwy	璀
gtln	璁
gadf	璂
gyrc	璃
gujq	璄
gvjs	璅
gnwe	璆
gyth	璇
ggqt	璈
gamy	璊
gujf	璋
gpgw	璌
gagf	璍
gmmv	璎
gkhk	璐
grlo	璑
gwgu	璒
gulj	璔
ijgy	璗
goqh	璘
gdui	璙
gcnk	璚
gvfj	璛
gamw	璜
gkhm	璝
gogw	璞
gjyi	璟
gtol	璠
gwyp	璡
ggjl	璢
ggjn	璤
gaqt	璥
ghqo	璨
ghae	璩
gkks	璪
gipl	璫
gryt	璬
gplp	璭
guep	璲
grim	璳
gvhl	璶
gget	璷
gpgm	璸
gfnf	璹
emgy	璺
gnyf	璻
gahl	璼
gfdj	瓀
gawc	瓁
gafl	瓂
glll	瓃
gflm	瓄
grxs	瓅
grrm	瓆
gdet	瓇
gtqi	瓈
gfwm	瓉
gyup	瓋
gbdp	瓍
ghal	瓐
gtfm	瓒
gugi	瓓
xgwy	瓕
gaky	瓘
ghay	瓛
rcyi	瓜
rcyy	瓝
rcyw	瓞
rcyn	瓟
udrf	瓣
ykky	瓤
gnny	瓦
gnnf	瓧
gnnc	瓪
wvgy	瓫
ygny	瓬
wcgy	瓮
argy	瓯
gnnv	瓰
gnnn	瓱
dgny	瓳
wycy	瓴
ckgy	瓵
uagy	瓶
kegy	瓹
dcgy	瓺
ipky	瓽
tvgy	瓾
ukgy	瓿
tfay	甀
ynmy	甂
togy	甃
sfgy	甄
uxxy	甆
oopy	甇
uvoy	甉
lvgy	甊
yumy	甋
alpy	甍
gjhy	甎
fkuy	甏
uljy	甑
mmgy	甖
hagy	甗
aafy	甙
adwn	甚
tdaf	甜
hawf	甝
getg	甤
tgle	甥
gehy	甫
cehj	甬
dheh	甭
qreh	甮
pneh	甯
llll	田
mhng	由
lhnh	甲
mhfd	甴
mgnb	甹
glbj	画
lgjj	畀
lqyy	畂
jhqy	畃
jhnr	畅
ylcy	畆
lqug	畇
lrcy	畈
lfjh	畊
lwjj	界
lwjh	畍
ldyy	畎
lgeu	畏
gklf	畐
ylwy	畒
lugh	畔
yklf	畗
lmfg	畘
qyvl	留
cdlf	畚
yxlf	畜
flqy	畞
lwtu	畟
lynw	畡
lffy	畤
ltkg	略
lffg	畦
ltkf	畧
lyey	畩
tolf	番
lwgs	畭
ltxy	畮
gjal	畱
wfil	畲
lpeg	畳
ldtf	畴
vflb	畵
ldsk	畸
lpqb	畹
glgg	畺
ludf	畻
ljgr	畼
xxal	畿
vlgh	疀
lnwe	疁
lipg	疂
lujf	疃
xfgg	疆
gkll	疈
lllg	疉
gvhi	疌
nhjg	疍
nhgi	疎
nhyk	疏
xtdh	疑
uygg	疒
utnv	疙
uqyi	疚
ughi	疜
ufnv	疞
uagd	疟
ugqe	疠
unre	疡
udny	疣
uwjk	疥
unwi	疦
uqav	疧
uvfk	疩
uxxv	疪
uwci	疫
udee	疬
uwwi	疭
uwbv	疮
uwri	疯
uygd	疰
uqnv	疱
uhci	疲
uafd	疳
uskd	疴
uhxv	疵
uanv	疶
uqay	疷
ujgd	疸
uwee	疹
utpi	疺
ukwi	疻
utui	疼
uegd	疽
utdi	疾
uqkd	痀
uhkd	痁
uekd	痂
uyxi	痃
ugmw	病
unxv	痆
ughd	症
uehk	痈
ucad	痉
uwgd	痊
umgk	痌
ugxw	痍
uded	痏
ulkd	痐
uugk	痒
ugcf	痓
uffi	痔
uvei	痕
ugog	痖
utxi	痗
ugku	痘
uftb	痚
uceh	痛
udhk	痞
uied	痟
utjk	痢
ufni	痣
uwwf	痤
ugkd	痦
uiit	痧
uape	痨
ujhc	痩
uqmd	痪
uusi	痫
ujqr	痬
ueed	痭
udei	痮
uphn	痯
uooi	痰
uhdd	痱
utdk	痴
utbd	痵
umaw	痶
urmj	痸
ulgj	痹
uldd	痼
uwyd	痽
ubsk	痾
utvd	痿
uywu	瘀
uywf	瘁
ugey	瘃
ucde	瘆
udhd	瘈
uwnd	瘊
ugkj	瘌
uadn	瘎
uftj	瘏
uewi	瘐
umnk	瘑
uplk	瘒
uadd	瘔
unhc	瘕
uujd	瘖
uguf	瘗
uovd	瘘
ucyj	瘙
udhn	瘛
uthn	瘜
ulii	瘝
ujld	瘟
uiwe	瘠
utec	瘢
urqc	瘣
uqyl	瘤
uuga	瘥
uehc	瘦
uawk	瘩
uthx	瘪
ucwy	瘫
uxde	瘬
usfi	瘭
ucce	瘮
uytd	瘯
ulxi	瘰
udwn	瘱
utwh	瘲
unwe	瘳
uujf	瘴
uwfi	瘵
ugkw	瘶
ugkt	瘷
uekw	瘸
uqqy	瘹
ulvd	瘻
uajd	瘼
ubqn	瘾
ummv	瘿
uamw	癀
uttt	癁
ubtg	癃
uwyo	癄
ugjl	癅
uwxc	癈
ubwc	癊
ukkm	癌
ugyg	癍
ulge	癏
umae	癑
utmt	癓
uujn	癔
uyxy	癕
unkf	癖
ufld	癗
uenn	癙
uylt	癛
unac	癜
ugkm	癞
uyuj	癠
uqgg	癣
utgm	癪
ufhm	癫
uhhy	癯
ulli	癳
uyxr	癴
uyxw	癵
wgdu	癸
wwcu	癹
wfqb	発
wgku	登
rrrr	白
rqyy	的
xxrf	皆
rdfj	皋
rxbj	皍
rywr	皎
rifj	皐
rmnn	皑
rtfk	皓
rpfq	皖
rmfk	皗
srrf	皙
rrrf	皛
rgiq	皝
rrif	皡
rept	皧
rgjq	皩
hcfh	皯
qvhc	皱
plhc	皲
giyc	皳
cwtc	皴
sjgc	皶
hcpl	皹
haec	皻
ylkc	皽
flmc	皾
gflf	盂
xhlf	盄
khlf	盅
wvlf	盆
dylf	盇
bclf	盈
uwlf	益
dcyl	盋
qblf	盌
fclf	盍
mdlf	盎
fxyl	盏
fhlf	盐
jtyl	监
wgkl	盒
igfl	盓
dolf	盔
iwyl	盕
uglf	盖
uqwl	盗
telf	盘
gehl	盙
giyl	盚
dnxl	盛
vilf	盝
jelf	盟
xgel	盠
ldyl	盢
eilf	盥
wynl	盦
edml	盨
fufl	盩
ahnl	盬
xful	盭
hhhh	目
hgfh	盱
ynhf	盲
hynn	盳
htnn	盵
hfqn	盶
hqug	盷
hgbn	盹
hwgn	盻
hwvt	盼
rfhd	盾
ithf	省
hqan	眂
hghn	眄
hrcy	眅
hitt	眇
hpqn	眈
htfn	眊
hniu	県
hary	眍
hfiy	眎
hmdy	眏
hxet	眑
hjhh	眒
hwet	眕
hkqn	眖
hqkg	眗
duhf	眘
hckg	眙
tghf	眚
hpsh	眝
xhnw	眞
fhwu	真
hnan	眠
hqay	眡
qbhf	眢
hrwy	眣
hnxn	眤
hhxn	眦
hvkg	眧
htpy	眨
hyxy	眩
hgmw	眪
hugh	眫
hdxy	眬
hffg	眭
hmgk	眮
hgcf	眰
hqjg	眴
hqqy	眵
hagg	眶
udhf	眷
hctg	眸
hudy	眹
hqiy	眺
hvey	眼
hrey	眽
hyni	眿
ughf	着
hqvh	睁
hcwt	睃
hieg	睄
hpfq	睆
huxt	睇
hkgg	睈
hwwf	睉
hkeg	睊
htry	睋
hqkq	睌
hhqn	睍
hrdh	睎
hgoy	睐
hwgg	睑
hooy	睒
hwga	睔
hpqb	睕
hfwt	睖
hjqr	睗
lgke	睘
hyny	睙
hdff	睚
hgeg	睛
tqth	睝
hywf	睟
hudb	睠
htfg	睡
hwyg	睢
hgih	督
hlgj	睤
hrtf	睥
hfwf	睦
hqaj	睧
heqn	睨
hviy	睩
hgvh	睫
hesy	睬
hmfk	睭
hwgj	睮
nnah	睯
hadk	睰
hnhc	睱
hjtg	睲
hplh	睴
hfky	睵
hvgp	睷
hnhg	睸
hftj	睹
hwnd	睺
hpgg	睻
hjgh	睼
hwgd	睽
tlff	睾
hpgh	睿
cnhh	瞀
hhdy	瞁
rfhy	瞂
hrfh	瞃
halg	瞄
htoy	瞅
hkhm	瞆
hwcn	瞈
hovk	瞊
hfcl	瞌
hehc	瞍
hpdk	瞎
hpjw	瞑
hagw	瞒
hykh	瞓
hwvo	瞗
hajd	瞙
htwh	瞛
hlvg	瞜
hyrc	瞝
hsfi	瞟
hipf	瞠
hfwq	瞡
alph	瞢
hkkn	瞣
hugg	瞤
umih	瞥
hfkk	瞦
hwyo	瞧
hogw	瞨
hnty	瞩
hwgu	瞪
hsjf	瞫
heph	瞬
hyct	瞮
hueg	瞯
hnbt	瞰
hagf	瞱
hcnk	瞲
hujf	瞳
hrlo	瞴
hoqh	瞵
hujg	瞷
haas	瞸
hept	瞹
hqdy	瞻
fkuh	瞽
hhpa	瞾
hhwy	瞿
htmt	矀
hton	矁
hkks	矂
hpns	矃
htgo	矄
hnwy	矅
hawc	矆
hrpy	矈
hpgm	矉
hxrh	矊
hoaw	矌
hhwc	矍
hqmt	矎
hthy	矏
hhal	矑
halh	矒
haky	矔
yxxh	矕
fhfh	矗
hipo	矘
hunt	矙
cnht	矛
cnhc	矝
cnhk	矞
ctdu	矣
xtdy	矤
tdkg	知
qdtd	矦
tdxh	矧
tdan	矩
tdte	矪
tdtj	矫
tdwf	矬
tdgu	短
tdtv	矮
tdac	矱
tdlx	矲
dgtg	石
dgqn	矹
dwyy	矾
dnrt	砀
dcgg	码
ditt	砂
dmyg	砃
dnwy	砄
dfwy	砆
dhdf	砉
dywn	砊
davt	砌
dqwy	砍
dwjh	砎
dbyy	砐
daht	砑
dxxn	砒
dwcy	砓
dgah	研
dvfh	砕
dfny	砖
dgbn	砘
dmqn	砚
dwyn	砛
dwry	砜
dfcy	砝
dthf	砟
degg	砠
dskg	砢
dpxn	砣
dqay	砥
hxdf	砦
dhkg	砧
dynn	砨
dxjh	砩
dygg	砫
dtpy	砭
vcdf	砮
dyiy	砯
dguf	砰
dwyc	砱
dhcy	破
dsgg	砵
djhh	砷
damh	砸
dary	砹
ddgq	砺
dxyd	砻
dwag	砼
dehh	砽
dtni	砾
docy	砿
dbmh	础
dcag	硁
digq	硄
dffg	硅
dtlr	硇
dfkg	硈
dvgh	硉
dqdb	硊
dtkg	硌
dvey	硍
dgaj	硎
dgdf	硏
dmgk	硐
duah	硑
dftx	硓
dawy	硔
ddmy	硕
dgud	硖
datq	硗
dlkg	硘
dtdj	硚
dyoy	硛
dgva	硜
dieg	硝
dthp	硟
dyve	硠
dpdc	硡
dwgs	硢
dceh	硧
dtry	硪
dyck	硫
dgjr	硬
dayn	硭
dqeh	确
iitd	硰
dlsy	硱
dwwk	硲
dfoy	硳
dhlr	硵
dmwn	硶
dwgg	硷
dmdf	硸
dswc	硹
dgey	硺
ahnd	硻
deeg	硼
ddjn	硽
dpwa	硿
dqvh	碀
adwd	碁
dpfi	碂
dgeg	碃
dlty	碅
ihcd	碆
dpgh	碇
dqaj	碈
dmfk	碉
daay	碊
dmsk	碋
dviy	碌
djgf	碍
dywf	碎
drtf	碑
dwyg	碓
dfhy	碔
dpqb	碗
dmaw	碘
dukg	碚
dgmy	碛
dcde	碜
dans	碟
dyks	碠
dmnk	碢
djqn	碣
damd	碤
dyna	碥
dptk	碦
grdf	碧
dlge	碨
dadn	碪
dvtr	碯
duog	碰
ddgy	碱
dyuh	碲
dmdo	碳
dsjg	碴
dhmy	碵
ddhd	碶
dpgg	碹
dykk	碻
damy	碽
dnae	碾
dnie	碿
dubp	磀
duxx	磁
dqyl	磂
drhw	磃
dovk	磄
dyuy	磅
dtlx	磇
drqc	磈
dccs	磉
dddf	磊
duga	磋
dpdk	磍
dexd	磎
duvo	磏
tewd	磐
dkmy	磒
dwnp	磓
dqas	磔
dfcl	磕
dnrg	磖
dgef	磗
derm	磘
dywe	磙
lrdf	磛
dwfi	磜
dmee	磞
dnwe	磟
dhlo	磠
dade	磡
dlxi	磥
dsfi	磦
ossd	磨
ddhy	磩
dtwh	磫
fnwd	磬
ddfe	磭
dmwa	磮
dooe	磱
dias	磲
dulj	磳
dwgu	磴
deqo	磶
doqh	磷
dusd	磸
dsjf	磹
damw	磺
dtol	磻
dwys	磼
dkkl	磾
dttd	磿
dueg	礀
dwyo	礁
dipr	礃
dykt	礅
dtmd	礇
duep	礈
lbwd	礊
dlff	礋
dajn	礍
errd	礐
dipl	礑
dugy	礒
dglg	礓
dnkf	礔
nkud	礕
degw	礖
dpgm	礗
djxo	礘
dafl	礚
dahl	礛
egnd	礜
dfdj	礝
dape	礞
dcor	礟
duxn	礠
dufe	礢
daly	礣
dawi	礤
dahm	礥
dlll	礧
drrm	礩
dooi	礯
dued	礲
dosd	礳
daif	礴
dfsh	礵
daky	礶
daal	礷
dtfm	礸
dkkt	礹
pyyy	礻
pynn	礼
pybt	礽
pyfg	社
pybh	祁
pycg	祃
pywj	祄
pygd	祆
pyrh	祈
pyhg	祉
pywc	祋
pykh	祌
pyfh	祎
pyrw	祑
pyvk	祒
pydy	祓
pyeg	祖
pyqy	祗
fifi	祘
pyfi	祙
pytf	祚
pyfc	祛
pydg	祜
pykq	祝
pyjh	神
bmfi	祟
pynk	祠
hxfi	祡
pyte	祣
pyug	祥
pykd	祦
pyqi	祧
sfiu	票
pyri	祩
pyqb	祪
wfiu	祭
pyhm	祯
pyuq	祱
pyvc	祲
pyde	祳
pyaa	祴
pyls	祵
pyut	祶
pydf	祷
pykw	祸
pyqm	祹
pyaw	祺
pyld	祻
pyjs	祼
pyyf	祽
ylki	禀
ssfi	禁
pymk	禂
pyvi	禄
pyul	禅
pyrf	禆
pyfj	禇
pypl	禈
pydd	禊
pysf	禋
pyux	禌
pygl	福
pyec	禐
pyjy	禑
pyxe	禒
pyjr	禓
pynh	禕
pyas	禖
pyln	禗
pyyh	禘
pyue	禙
pyuo	禚
pyfw	禛
oopi	禜
pyyk	禞
pyok	禟
pyco	禡
pyjn	禢
pyaf	禥
pyfk	禧
pyxy	禨
pyme	禯
pyye	禳
pywa	禴
pytm	禶
tkmy	禹
jmhy	禺
yrbc	离
hlrc	禼
wyrc	禽
tttt	禾
tgvi	秉
ttfj	秊
tkhh	种
twvt	秎
tfcy	秐
tufh	科
titt	秒
txxn	秕
tqan	秖
tntt	秘
tnxn	秜
tegg	租
tdhg	秠
tdcy	秡
tgsy	秣
tguf	秤
dwtu	秦
tmdy	秧
trwy	秩
tsyy	秫
ttnt	秭
tckg	秮
tkwy	积
tqiy	称
tgcf	秷
tfkg	秸
tpta	秺
tqqy	移
triy	秼
tmqy	秽
tpey	秾
tgey	秿
trdh	稀
tyve	稂
tebg	稃
tcwt	稄
tkkg	稆
tlsy	稇
tuxt	稊
tkgg	程
twfi	稌
tieg	稍
tukq	税
twga	稐
tldg	稒
twyn	稔
trtf	稗
twyg	稚
tlty	稛
tjsy	稞
tmfk	稠
takg	稢
qgty	稣
tyki	稤
tojf	稥
tdhd	稧
tleg	稩
ttjt	稪
tgkl	稫
tdmd	稬
txxr	稭
trbt	稯
tnhe	稰
tehj	稲
tqvn	稳
tuvo	稴
tuxx	稵
tgky	稶
tlwt	稷
tyxl	稸
tfhw	稹
tnuf	稺
teeg	稻
tpge	稼
tdnj	稽
tykk	稿
tabg	穁
tgmn	穂
tpwk	穃
tovi	穅
trie	穆
osst	穈
tvcq	穊
tnwe	穋
tevn	穏
tqjn	穐
tfuk	穑
twvo	穒
tlaw	穓
tgjn	穗
togw	穙
twyo	穛
tjbc	穝
tuep	穟
tmae	穠
tywe	穣
tegw	穥
tpgm	穦
twkm	穨
toaw	穬
tqoj	穭
tyke	穰
tgmx	穲
ttfm	穳
pwnb	穵
pwvb	究
pwer	穷
pwqu	穸
pwxb	穹
pwaf	空
pwsu	穼
pwtd	穾
pwat	穿
pwgn	窀
pwdy	突
pwav	窃
pwtf	窄
pwhf	窅
pwtp	窆
pwqn	窇
pwxe	窈
pwqb	窌
pwan	窍
pwqg	窎
pwff	窐
pwrm	窑
pwgf	窒
pwcn	窓
pwqi	窕
pwtk	窖
pwtq	窗
pwvk	窘
pwfv	窛
pwkh	窜
pwkw	窝
pwqe	窞
pwnm	窟
pwjs	窠
pwcc	窡
pwag	窢
pwjx	窤
pwfq	窥
pwfd	窦
pwuj	窨
pwdd	窫
pwwj	窬
pwov	窭
pwem	窰
pwof	窲
pwry	窳
pwvs	窼
pwxw	窽
pwbg	窿
pwgq	竀
pwfn	竃
pwfx	竈
uuuu	立
utfh	竏
uwcy	竐
ukhj	竒
uwvt	竕
jcuf	竖
uqkg	竘
uhkg	站
upsh	竚
ujnb	竜
ukqb	竞
ujqb	竟
ujfj	章
uctd	竢
ucwt	竣
updc	竤
ujff	童
ugki	竦
uhjf	竨
ahnu	竪
ujqn	竭
umdj	端
udjf	竰
ugjf	竱
uulj	竲
uwgu	竳
uusf	竴
ujft	竷
ujqq	竸
thth	竹
tgfj	竽
tynb	笀
tvyu	笂
tcgf	笃
tgaj	笄
trru	笅
tyhu	笇
tbyu	笈
tquf	笉
trhy	笊
tvtr	笋
taht	笌
tmwu	笍
tqrr	笏
ttdu	笑
txxb	笓
ttfn	笔
tmqb	笕
ttgf	笙
tbmj	笜
tlcu	笝
tckf	笞
trcy	笟
tnna	笢
tqnb	笣
tvkf	笤
tngk	笥
twfu	符
tmmg	笧
tsgf	笨
txht	第
tthf	笮
tvcu	笯
tqkf	笱
tcaj	笲
tekf	笳
tskf	笴
tqtb	笷
takf	笸
tanb	笹
tfxy	笺
tdxy	笼
tepu	笾
ttkf	笿
tfff	筀
tmaf	筁
tldu	筃
tqiu	筄
ttfq	筅
tabj	筇
tffu	等
tywr	筊
teer	筋
twgf	筌
twau	筏
tagf	筐
tawy	筑
tmgk	筒
twgk	答
tgmi	策
twkh	筗
trkf	筘
tdiu	筙
txxf	筚
tjgh	筛
tivf	筜
tqvh	筝
tpsu	筞
tebf	筟
tfqu	筠
trcb	筢
ttjj	筣
tpfq	筦
tceh	筩
talj	筪
taww	筮
tege	筯
twht	筱
tief	筲
ttfp	筳
tthp	筵
tnnw	筷
tjfj	筸
tdtf	筹
tagy	筺
tgjr	筻
tkmu	筼
tkgd	筽
twgg	签
tujf	简
tukf	箁
tbcu	箃
tlgj	箅
tick	箈
trke	箉
tgcj	箌
trah	箍
tgef	箐
tvph	箒
tviu	箓
tirf	箔
tadw	箕
thaj	算
tltu	箘
tebc	箙
tbry	箛
tpwa	箜
traf	箝
tjxx	箟
ttfg	箠
tphn	管
tpqb	箢
tgmj	箣
tihc	箥
tgmu	箦
tagd	箧
trcg	箨
tlqu	箩
tulj	箪
tvij	箫
tadk	箬
tuej	箭
tpgg	箮
twgr	箯
tqjb	箰
tshf	箱
titq	箲
tnua	箳
tdgy	箴
tith	箵
tdef	箶
tytb	箷
tftj	箸
txqy	箹
tdwj	箺
ttvg	箻
tiej	箾
tkbf	箿
trgf	篁
tnhf	篃
tmdj	篅
txge	篆
tyna	篇
twnd	篌
ttou	篍
thit	篎
tafw	篏
tkhm	篑
twye	篒
tovf	篓
tfcl	篕
tovk	篖
tahd	篚
txuu	篛
tbio	篜
tamf	篝
thdc	篡
tamu	篢
tssu	篥
ttlx	篦
tbwi	篨
trhw	篪
tujn	篭
tjtl	篮
tukb	篰
tyrc	篱
tdhv	篲
tgep	篴
ttwh	篵
tgho	篶
ttdp	篷
thdb	篹
trrf	篺
trqq	篼
tldy	篾
tthh	簁
tlag	簂
ttqq	簃
tync	簄
tpfc	簆
tytd	簇
tntf	簈
tadf	簊
tvel	簋
tgkw	簌
traj	簎
tonx	簏
tmfe	簓
tyge	簔
take	簕
tonr	簖
tivs	簗
tvoj	簘
tlgy	簚
tadr	簛
tijr	簜
tdui	簝
tsjf	簟
tgel	簠
tlmu	簤
twgu	簦
tamw	簧
tooe	簩
taqj	簪
tkhk	簬
tawk	簭
tfwj	簮
terf	簲
tltk	簵
tpyi	簶
tadc	簸
tipl	簹
tpaf	簺
tmnp	簻
tigf	簿
trql	籀
tgkm	籁
takm	籄
tawc	籆
tsfy	籈
tdij	籍
txth	籎
tytw	籏
thde	籑
trgl	籒
tlvt	籔
tsql	籕
tqvi	籙
thal	籚
tqaa	籛
tyny	籝
ttri	籞
tugi	籣
twgw	籨
thhc	籰
oyty	米
tyou	籴
otnn	籺
ovyy	籾
odyy	粀
otfh	粁
oxxn	粃
oqrt	粅
owvt	粉
xxou	粊
ovfh	粋
oxhh	粌
otfn	粍
ogsy	粖
oegg	粗
ohkg	粘
vojk	粛
bmou	粜
odgq	粝
uqwo	粢
ommg	粣
tlon	粤
xoxn	粥
oqah	粦
oofg	粧
oftx	粩
oawu	粪
odmj	粫
omag	粬
oyve	粮
ohqn	粯
ivwo	粱
hqco	粲
ogjr	粳
ojfg	粴
oviy	粶
oqoy	粷
oadw	粸
oywf	粹
odey	粻
oqab	粼
opfi	粽
ogeg	精
ojsy	粿
oawx	糀
ocde	糁
ojgr	糃
ocns	糅
ownd	糇
onhe	糈
orbt	糉
odeg	糊
ouej	糋
othj	糌
ouxx	糍
odjf	糎
onie	糏
oxuu	糑
oath	糒
ocyj	糔
ougo	糕
oovk	糖
othy	糗
opge	糘
oipf	糛
osso	糜
ogmj	糟
oovi	糠
oujq	糡
oaet	糤
oxkj	糨
nkuo	糪
olfj	糬
oobt	糭
ofdj	糯
btwo	糱
oguo	糳
awno	糵
txiu	系
yxiu	紊
xdny	紌
xdyy	紎
xufh	紏
xdhy	紑
xwjh	紒
xxhh	紖
xpqn	紞
xwyn	紟
gxiu	素
fpxi	索
xvfh	紣
rnxi	紥
jcxi	紧
xrwy	紩
xhxn	紪
hxxi	紫
xxcy	紭
lxiu	累
xhcy	紴
xpsh	紵
xwyc	紷
xmdy	紻
xpxn	紽
xmkg	絅
xqkg	絇
xsyy	絉
xsgg	絊
xocy	絋
xwtf	絍
xjxt	絏
xriy	絑
xffg	絓
xdjg	絔
xigq	絖
xlkg	絗
xuqw	絘
xgjg	絙
xghg	絚
xwgg	絟
xdeg	絠
xuah	絣
xwdy	絥
xmgk	絧
ccci	絫
udxi	絭
vkxi	絮
xynw	絯
xgcf	絰
rvyi	絷
xhqn	絸
xrdh	絺
xqkq	絻
xkkg	絽
xgiy	絿
xgki	綀
xykq	綂
xpfq	綄
xvpc	綅
xdww	綊
xpdc	綋
xwwk	綌
xfpb	綍
xtfp	綎
xukq	綐
xebg	綒
dfni	綔
xfny	綕
xthp	綖
xmwk	綗
xfpq	続
xvyn	綛
xssy	綝
xyny	綟
vkbi	綤
xlgj	綥
adwi	綦
xadw	綨
xpqb	綩
xgeg	綪
xaay	綫
ynti	綮
xqrm	綯
xjsy	綶
xywf	綷
xrtf	綼
xgvv	緀
xgvh	緁
xooy	緂
xbcy	緅
xjqr	緆
xfuf	緈
xtvg	緌
xqaj	緍
xakg	緎
xamd	緓
xyjg	緕
rmhi	緜
xalg	緢
xwks	緥
xusg	緧
xngg	緪
xqrn	緫
xleg	緭
xtjt	緮
xwgj	緰
odhi	緳
xrbt	緵
xplh	緷
xsfg	緸
xmnk	緺
xhmy	緽
xdjf	緾
xckn	緿
xnhc	縀
xvey	縁
xukn	縂
xnhe	縃
xjjn	縄
xpgg	縇
xubp	縌
xyuy	縍
xmeg	縎
tewi	縏
xuga	縒
xdri	縓
xccs	縔
xlwl	縕
xpdk	縖
xyke	縗
xexd	縘
xabg	縙
xkmy	縜
xpuf	縡
xgxi	縤
xdwt	縥
xtuh	縦
xwhs	縧
xjiq	縨
xwfi	縩
xajd	縸
xlpy	縺
xcce	縿
txti	繁
ermi	繇
xhqi	繉
xfoy	繊
lwci	繋
xtlt	繌
xvoj	繍
xqdo	繎
xnnw	繏
xgjn	繐
xtdk	繑
xjbc	繓
xaet	繖
xoqh	繗
xcnk	繘
gxif	繛
xusf	繜
xueg	繝
xkkl	繟
nnni	繠
xvfg	繣
ahdi	繤
xfkk	繥
xxkj	繦
xffc	繧
xfup	繨
xfwk	繬
xaqn	繱
xqeg	繲
nkui	繴
xylg	繵
xujn	繶
xmae	繷
xuep	繸
xqvo	繺
xfdj	繻
xahl	繿
xwow	纀
xtgo	纁
thdi	纂
xyuj	纃
xatp	纄
xrxs	纅
xlff	纆
oxim	纇
xfwm	纉
xdet	纋
xfhy	纎
xywm	纐
xhal	纑
xlxy	纙
gxhi	纛
xlli	纝
xyxn	纞
xnng	纟
xnhh	纠
xgfh	纡
xtfh	纤
xtnn	纥
xqyy	约
xbyy	级
xvyy	纫
xfnh	纬
xfcy	纭
xgbn	纯
xxxn	纰
xitt	纱
xmry	纲
xmwy	纳
xwwy	纵
xwxn	纶
xwvt	纷
xqan	纸
xnhf	纽
xcnh	纾
xfxy	线
xafg	绀
xann	绁
xdcy	绂
xanw	练
xegg	组
xjhh	绅
xkwy	织
xtuy	终
xqvg	绉
xugh	绊
xxjh	绋
xbmh	绌
xvkg	绍
xcgh	绎
xcag	经
xckg	绐
xdtb	绑
xadt	绒
xfkg	结
xdfn	绔
xatq	绕
xtgs	绗
xwfc	绘
xwgk	给
xqjg	绚
xtah	绛
xtkg	络
xqcn	绝
xywr	绞
xycq	统
xgjr	绠
xieg	绡
xkeg	绢
xtbt	绣
xevg	绥
xtsy	绦
xonn	继
xuxt	绨
xgmy	绩
xftj	绪
xfwt	绫
xfnd	续
xdsk	绮
xhdd	绯
xhjf	绰
ximk	绱
xjxx	绲
xkjn	绳
xwyg	维
xrmh	绵
xepc	绶
xeeg	绷
xmfk	绸
xthk	绺
xudb	绻
xpfi	综
xpgh	绽
xphn	绾
xviy	绿
xccc	缀
xvlg	缁
xakf	缂
xshg	缃
xdgy	缄
xdmd	缅
xjtq	缆
xjgh	缇
xhit	缈
xkbg	缉
xkhm	缋
xlny	缌
xtfg	缍
xwdc	缎
xwgr	缏
xwnd	缑
xwnp	缒
xegc	缓
xyuh	缔
xovg	缕
xyna	编
xnaj	缗
xxge	缘
xgoj	缙
xgef	缚
xdff	缛
xfhw	缜
xtdp	缝
xykk	缟
xojf	缠
xyrc	缡
xuwl	缢
xuvo	缣
xprw	缤
xsfi	缥
xjlc	缦
xlxi	缧
xmmv	缨
xpwj	缩
xnwe	缪
xvjs	缫
xfkm	缬
xdui	缭
xugk	缮
xulj	缯
xglg	缰
xkhp	缱
xkks	缲
xlge	缳
xryt	缴
xtfm	缵
rmbh	缷
rmag	缸
rmou	缹
rmnw	缺
rmgy	缻
rmqw	缼
rmua	缾
rmqi	罀
rmmm	罁
mmrm	罂
fnwm	罄
rmhf	罅
rmxm	罆
rmir	罉
lbwm	罊
yxtm	罋
lllm	罍
rmjc	罎
rmhl	罏
rmay	罐
mrri	网
muyn	罔
pwfj	罕
lwyu	罖
ldhu	罘
lyjj	罚
legf	罝
lcnt	罞
lghf	罡
lfcu	罢
luxt	罤
lkef	罥
lebf	罦
lssu	罧
ldjn	罨
lhjf	罩
lhdd	罪
lffh	罫
lfhf	置
lfmf	罱
lftj	署
llnu	罳
lfco	罴
lqyl	罶
lyfu	罸
lnwy	罹
lvjs	罺
lnff	罻
ljaf	罼
ldoj	罽
lulj	罾
mrrl	羀
lakg	羁
lxke	羂
lajh	羃
lxhf	羄
lakk	羇
lyxi	羉
ufqb	羌
ugdu	美
ghhy	羐
ugwv	羒
ugcn	羓
ugou	羔
ugyi	羕
ugnc	羗
ugwc	羚
ugxj	羛
ugps	羜
ugqy	羝
ugnf	羞
ugca	羟
uggw	羠
uguw	羡
ugad	羢
vtkg	群
ugpq	羦
ugct	羧
ugye	羪
ugpa	羫
ugwj	羭
ugjn	羯
ugmo	羰
ugty	羲
ugtl	羳
ugfm	羵
ugod	羹
ugfj	羺
ugot	羻
nugg	羼
nnyg	羽
wcnf	翁
nwvt	翂
fcnd	翅
nvfj	翆
ndcy	翇
wycn	翎
nwer	翏
fkng	翓
ugng	翔
wgkn	翕
atgn	翘
mqng	翙
nplj	翚
nwyf	翟
nywf	翠
mfkn	翢
nuvf	翣
ftjn	翥
uejn	翦
ynmn	翩
nrfq	翫
nwnd	翭
gkmn	翮
nykk	翯
sfin	翲
atdn	翳
nwvo	翵
rifn	翶
famn	翸
thin	翺
toln	翻
nlaw	翼
hdgn	翽
lgkn	翾
fnan	翿
igqy	耀
ftxb	老
ftgn	考
ftxn	耄
ftjf	者
ftxj	耆
ftqk	耇
ftxk	耈
ftxf	耋
dmjj	而
dmjv	耍
dmjf	耐
dish	耓
dibg	耔
difj	耕
diit	耖
ditn	耗
difc	耘
dicn	耙
dihc	耚
dick	耛
dihn	耜
diek	耞
dian	耟
diwk	耠
diee	耡
diae	耢
diaj	耤
diik	耥
dijy	耦
diov	耧
didf	耨
diaf	耩
diyy	耪
digm	耫
dixw	耭
dioe	耮
diac	耯
diod	耱
diye	耲
bghg	耳
wwbf	耸
bwyn	耹
bfcy	耺
bpqn	耽
bdcy	耾
bwvt	聁
bccu	聂
bmfg	聃
btdy	聅
bwyc	聆
bxet	聈
bbmh	聉
bqtb	聊
dxyb	聋
bkwy	职
bpsh	聍
bqiy	聎
bdmj	聏
bfkg	聐
btdg	聒
awyb	聓
budy	联
btfk	聕
bdww	聗
bmgn	聘
bgeg	聙
bciu	聚
bpwa	聜
bakg	聝
tdkb	聟
buah	聠
bwcn	聡
bpgh	聢
beqn	聣
byks	聤
btky	聥
bqrn	聦
bwgd	聧
bxxa	聨
bkhm	聩
bukn	聪
bxxd	聫
bxxo	聮
gqtb	聱
bfln	聴
bqdy	聸
bpwi	聺
ilrb	聻
nbfn	聼
ynvg	肁
gqvg	肂
vijk	肃
xtdg	肄
dcvg	肆
yntg	肇
ynag	肈
mwwi	肉
etnn	肐
evyy	肒
ynef	肓
ecyy	肞
efnn	肟
enrt	肠
ewcy	股
efcy	肢
ewyn	肣
efwy	肤
edhy	肧
edhh	肨
yned	肩
egbn	肫
edny	肬
emwy	肭
eywn	肮
edcy	肱
ycef	育
eqrt	肳
rdef	肴
exxn	肶
eqwy	肷
ewfh	肸
ewgn	肹
egmh	肺
hpef	肻
efjh	肼
edyy	肽
jcef	肾
ekhh	肿
etay	胀
eewy	胁
ejhh	胂
ejgg	胆
muqk	胊
ehkg	胋
uxef	背
ercy	胍
eckg	胎
mubm	胐
enxn	胒
eguf	胓
hxmw	胔
ewfy	胕
eugh	胖
ewet	胗
ethf	胙
edhg	胚
etgg	胜
eqay	胝
eqnn	胞
eskg	胢
etbn	胣
txen	胤
nhef	胥
emdy	胦
edxy	胧
eaiy	胨
ehgh	胩
ehnt	胪
ecag	胫
vcmw	胬
eldy	胭
edfn	胯
egxw	胰
eigq	胱
eynw	胲
etkg	胳
emgk	胴
egcf	胵
eywr	胶
qrbe	胷
eqrb	胸
edmj	胹
epvg	胺
etgs	胻
euah	胼
cexx	能
effg	胿
bige	脀
muqi	脁
exjg	脂
eqcn	脃
edoy	脄
eqdb	脆
eyni	脉
iwef	脊
vvve	脋
erhf	脌
ewfc	脍
ersy	脎
eofg	脏
eyjh	脐
eyrb	脑
epey	脓
yomw	脔
eqkq	脕
efpb	脖
eqrk	脗
epfq	脘
egiy	脙
efcb	脚
ewwf	脞
eefy	脟
ethp	脠
etxy	脢
edfe	脤
edww	脥
eany	脦
egki	脨
erdh	脪
eebg	脬
ekgg	脭
eevg	脮
egey	脯
egku	脰
eukq	脱
eniy	脲
eirb	脳
edhk	脴
ekgd	脵
ekmw	脶
etjh	脷
ewgg	脸
eywf	脺
egvh	脻
egmy	脼
ertf	脾
ewga	腀
ejsy	腂
eudb	腃
etfg	腄
eooy	腅
emaw	腆
etvg	腇
egeg	腈
eeqn	腉
eajg	腊
eywy	腋
edjn	腌
eccc	腏
owfw	腐
eowf	腑
endg	腒
ehdd	腓
epwa	腔
epqb	腕
egji	腖
emgj	腗
elgy	腘
epfi	腙
epgh	腚
engf	腛
eafs	腜
exge	腞
edwd	腠
ejmy	腢
eyuh	腣
ejtg	腥
ewgj	腧
emdj	腨
efmf	腩
eplh	腪
ecns	腬
ekkn	腭
elny	腮
erfh	腯
esvg	腰
evgp	腱
elge	腲
enhc	腵
ewdc	腶
egkl	腷
etjt	腹
eriy	腺
eafy	腻
edmd	腼
ejlg	腽
eudg	腾
evep	腿
eyuy	膀
euvo	膁
ytee	膂
eehc	膄
eovk	膅
egxi	膆
ewnp	膇
egkh	膈
euwl	膉
egef	膊
oope	膋
eiwe	膌
eexd	膎
eprw	膑
eakk	膒
etjr	膓
eonx	膔
elag	膕
etdp	膖
esfi	膘
exkj	膙
eipf	膛
eajd	膜
eswi	膝
egjf	膞
eyxf	膟
elvg	膢
epwf	膣
efvg	膤
gsdw	膥
eoqh	膦
muuf	膧
efke	膨
eyuk	膪
edui	膫
etfn	膬
ekhm	膭
effq	膮
etol	膰
eujy	膱
ewyo	膲
eugk	膳
erlo	膴
eayf	膵
eugg	膶
extb	膷
edap	膸
efam	膹
owwe	膺
eylg	膻
emnp	膼
nawe	臀
eouo	臁
nkue	臂
eyxy	臃
elqj	臅
eujn	臆
eajn	臈
ekks	臊
efkc	臌
enyf	臎
etgo	臐
efdj	臑
eady	臓
eahm	臔
eono	臕
emge	臖
epay	臗
eako	臙
etfm	臜
ehhy	臞
akfw	臡
ahnh	臣
ahnc	臤
nhah	臦
dndy	臧
nhaj	臩
thsu	臬
thdy	臭
thgx	臰
thsb	臲
gcff	至
gcft	致
gcfk	臵
fgcy	臷
gcfy	臹
ethg	臼
tfed	臿
dwef	舂
egno	舃
eqou	舄
eler	舅
elgw	舆
emgg	舋
wfkf	舍
tdnh	舏
tdqa	舐
wfkh	舒
tdjr	舓
tdgn	舔
tdoo	舕
wfky	舖
wfkn	舘
tdqy	舚
qahh	舛
epqh	舜
nvph	舝
rlgh	舞
tevt	舠
teag	舡
temh	舢
teyr	舣
tewy	舤
tecn	舥
tedy	舦
tety	舧
terc	舨
teyw	航
teyt	舫
tewc	般
texx	舭
teyn	舮
tekh	舯
temq	舰
tewb	舱
temg	舳
tetf	舴
tepx	舵
terg	舶
teyx	舷
tesk	舸
tewk	船
telh	舺
tehn	舻
tesg	舾
tedn	舿
teeb	艀
tejf	艃
teie	艄
teye	艆
tetp	艇
teyk	艈
tenn	艉
tebl	艋
tewn	艌
tend	艍
teuh	艏
tert	艐
teya	艑
tejh	艒
teas	艓
teoc	艔
teyy	艕
teua	艖
teec	艘
tegj	艚
telv	艛
teah	艜
tefv	艝
teti	艞
teuf	艟
tewu	艠
teil	艡
tefk	艢
teky	艥
teac	艧
teae	艨
teyj	艩
teqj	艪
teqy	艬
yvei	良
cvey	艰
dhqc	艳
xjqc	艴
uaqc	艵
magc	艶
aghh	艹
avyu	芄
acyu	芆
amhj	芇
atfj	芊
agfj	芋
afnb	芌
aqyu	芍
aynb	芒
bhbh	芔
axtr	芗
axxb	芘
afwu	芙
agbn	芚
avtr	芛
afqb	芜
arnb	芞
awcu	芟
aqwu	芡
adhu	芣
abnb	芤
awjj	芥
aynr	芦
acnh	芧
abyu	芨
aqab	芪
awvr	芬
awxb	花
aqrr	芴
anwu	芵
aqcu	芶
afcu	芸
atdu	芺
atfn	芼
aaht	芽
agmh	芾
awbr	芿
aywb	苀
awwu	苁
adcu	苃
ayhu	苄
arjj	苅
aavr	苆
afnh	苇
ader	苈
aaqb	苉
adbb	苊
amqb	苋
atay	苌
awbb	苍
apgf	苎
aewu	苏
axht	苐
aqbb	苑
amff	苒
awyc	苓
ackf	苔
amkf	苘
aehj	苚
askf	苛
auxb	苝
aqnb	苞
aqkf	苟
anab	苠
anyw	苡
aanf	苣
adhg	苤
adkf	若
anxb	苨
agmw	苪
ahkf	苫
alwu	苬
axer	苭
awmj	苮
asgf	苯
axcu	苰
amdu	英
athf	苲
atuu	苳
aegf	苴
awiu	苶
aaff	苷
atuf	苸
aguf	苹
awfu	苻
arcy	苽
antr	苾
afiu	苿
axjj	茀
abmj	茁
adxy	茂
aibb	范
aekf	茄
acnt	茅
aqtb	茆
adcy	茇
ahxb	茈
agsu	茉
argf	茊
aqay	茋
awff	茌
acaf	茎
aqry	茐
aqyg	茑
aqbj	茒
apwu	茓
apff	茔
apnf	茕
atkf	茖
avvv	茘
aadr	茙
aqgb	茚
aveu	茛
aahh	茝
avgj	茟
apbf	茡
agqj	茢
aqqu	茤
agmi	茦
auqw	茨
argk	茩
aigq	茪
aiyn	茫
adhf	茬
aywr	茭
ahgi	茮
awdy	茯
ajru	茰
ariu	茱
aiaf	茳
alkf	茴
aldu	茵
awsu	茶
awau	茷
avkf	茹
aycq	茺
btbh	茻
amgk	茼
awkh	茽
aawy	茿
aqjf	荀
adfn	荂
awgf	荃
aynw	荄
agaj	荆
atgs	荇
aqah	荈
ajfj	草
admj	荋
apvf	荌
anht	荍
agcf	荎
awtf	荏
adhb	荐
agxw	荑
aynk	荒
auaj	荓
aeee	荔
aeer	荕
aftx	荖
auff	荘
agud	荚
aatq	荛
axxf	荜
amjj	荝
atdj	荞
awfc	荟
ayjj	荠
ainr	荡
apsu	荣
aplj	荤
apiu	荥
aptg	荦
apou	荧
avfu	荨
anyu	荩
abiu	荪
abef	荫
anud	荬
axaf	荭
axfu	荮
axqy	药
asff	荰
antn	荱
ajff	荲
agku	荳
arfw	荴
akwn	荶
awsk	荷
afpb	荸
ahhr	荹
afqu	荺
aqto	荻
awgs	荼
aevf	荽
acwt	荾
adfe	莀
akej	莂
ardh	莃
awuf	莅
agey	莆
aege	莇
aiwc	莈
atjj	莉
aukq	莌
agiy	莍
aiit	莎
aipq	莐
akkf	莒
atxu	莓
amwg	莔
aufj	莘
avtk	莙
athp	莚
atfp	莛
awht	莜
apfq	莞
atbr	莠
akhu	莡
ayve	莨
aebf	莩
atry	莪
ajdu	莫
aqkq	莬
avcb	莭
aler	莮
aisu	莯
afqw	莰
agou	莱
alpu	莲
ajfu	莳
akmw	莴
atky	莵
awgg	莶
aqty	获
apgy	莹
apqg	莺
abkx	莻
axgn	莼
adya	莽
agmj	莿
apqb	菀
agef	菁
arqy	菂
aian	菃
agji	菄
aphn	菅
abcu	菆
avdf	菇
aruf	菈
aviu	菉
aqou	菊
akfi	菋
altu	菌
ajxx	菎
aisk	菏
oguw	菐
avlf	菑
ajsu	菒
aebc	菔
awga	菕
ajjf	菖
armf	菗
aswc	菘
atfg	菙
aaau	菚
aesu	菜
ardy	菝
atqt	菞
aihc	菠
abib	菡
arqn	菢
aahc	菣
audb	菤
asrj	菥
arpu	菦
aoqy	菧
auvf	菨
aukf	菩
apdf	菪
agkg	菫
aivk	菬
aovw	菮
abry	菰
afwt	菱
ahdd	菲
avph	菷
aywu	菸
aieg	菹
ayne	菺
assu	菻
aoou	菼
ahgc	菽
agdn	菾
agcj	菿
ahaw	萀
aadw	萁
aywf	萃
aqrm	萄
artf	萆
ahqy	萈
aecb	萉
agvv	萋
ajef	萌
atvf	萎
aqef	萏
agvh	萐
awyf	萑
apeg	萓
arvk	萔
aeqb	萖
apfi	萗
adfi	萘
aspq	萙
arcg	萚
ahaj	萛
alqu	萝
aeef	萠
airf	萡
aiqn	萢
apgh	萣
apju	萤
apkk	营
apxi	萦
avij	萧
abut	萨
atou	萩
atjf	萫
aqmu	萯
agli	萰
apgg	萱
aegc	萲
afmf	萳
aiej	萷
ajhf	萺
aujf	萻
akkn	萼
aitk	落
abcl	萾
aitd	萿
artd	葀
augv	葁
aqke	葂
ajtf	葃
awks	葆
acns	葇
acks	葈
agkl	葍
atvg	葎
aivg	葏
afff	葑
atis	葕
apwy	葖
aftj	著
agvl	葘
ashf	葙
aadn	葚
ajqn	葛
adhd	葜
agve	葝
axbf	葞
awvc	葠
aqgy	葡
adyl	葢
atgf	董
auej	葥
afpe	葧
alge	葨
arcb	葩
aqej	葪
adef	葫
agqa	葬
anhc	葭
awdc	葮
awct	葰
aqrn	葱
adgy	葳
awgd	葵
alnu	葸
aytb	葹
akbf	葺
arbt	葼
asvf	葽
aqbn	葾
ajlf	蒀
asyp	蒁
ayuh	蒂
axge	蒃
aivs	蒅
aawv	蒆
axxr	蒈
auqf	蒋
aovf	蒌
ayto	蒍
aire	蒎
apsg	蒏
arvc	蒑
alwl	蒕
afhw	蒖
aiye	蒗
avkr	蒘
apfe	蒙
agkh	蒚
afii	蒜
adri	蒝
auqk	蒟
athn	蒠
ayuy	蒡
abws	蒢
atws	蒣
aiws	蒤
aqyl	蒥
adhy	蒧
awge	蒨
ateg	蒩
auga	蒫
apqy	蒬
aqbt	蒭
aeej	蒯
atec	蒰
aigy	蒲
axmw	蒳
aube	蒴
aexd	蒵
axwv	蒶
akmu	蒷
abio	蒸
auvo	蒹
autd	蒺
axuu	蒻
aldn	蒽
aopu	蒾
aykk	蒿
adwt	蓁
apjw	蓂
aehc	蓃
ayxl	蓄
amef	蓇
ayvb	蓈
apwk	蓉
awcn	蓊
aovk	蓎
adff	蓐
ayke	蓑
awuk	蓓
augo	蓔
atlx	蓖
aywe	蓘
aowf	蓙
awhe	蓚
agmt	蓛
asgn	蓜
ajtl	蓝
aqgj	蓟
ayrc	蓠
aivc	蓡
acnm	蓣
apqf	蓥
ajdg	蓦
awhs	蓧
acne	蓩
acep	蓪
agep	蓫
atdp	蓬
athh	蓰
aiua	蓱
aakg	蓳
agjf	蓴
argh	蓵
arwy	蓷
atrb	蓹
afuy	蓻
anwe	蓼
ahlo	蓾
apwj	蓿
aukb	蔀
axkj	蔃
avcq	蔇
asfi	蔈
aojf	蔊
agkw	蔌
aonx	蔍
aywc	蔎
ayuk	蔏
ayud	蔐
aldy	蔑
avto	蔒
ajlc	蔓
aaqh	蔕
ahag	蔖
aoao	蔗
acce	蔘
ayth	蔙
anff	蔚
agqt	蔜
ahou	蔝
aytd	蔟
axtu	蔠
awfi	蔡
aihv	蔢
apnm	蔤
adhv	蔧
alub	蔨
alrj	蔪
agho	蔫
anhk	蔬
alag	蔮
abgi	蔯
aync	蔰
arsc	蔱
aige	蔳
aoss	蔴
agmu	蔶
afuk	蔷
arqq	蔸
awgt	蔹
auwy	蔺
apfc	蔻
ayjn	蔼
aumt	蔽
aeto	蔿
aeue	蕂
atol	蕃
aunu	蕄
aijy	蕅
asjf	蕈
awyo	蕉
annn	蕊
ahhh	蕋
aiwj	蕍
auef	蕑
almu	蕒
afuc	蕔
aias	蕖
akhk	蕗
agjn	蕙
ahdn	蕜
axqc	蕝
ajbc	蕞
avki	蕠
afam	蕡
aeph	蕣
ageg	蕤
aahy	蕥
attt	蕧
aduw	蕨
axxi	蕬
aeqo	蕮
abtg	蕯
atie	蕱
aulr	蕲
axjl	蕴
aqwe	蕵
afwc	蕶
anhp	蕸
ayxy	蕹
akby	蕺
adcw	蕻
amae	蕽
aflf	蕾
aoec	蕿
aill	薀
atmd	薁
aryt	薂
aigf	薄
aept	薆
atmt	薇
ahdy	薉
auqm	薋
aecn	薍
alpa	薎
aujn	薏
ahqo	薒
aouo	薕
amnp	薖
alfy	薗
agqr	薚
awnf	薛
ankf	薜
aqdy	薝
agqe	薞
aodm	薠
afkc	薣
agqg	薤
alqj	薥
alpx	薨
ausr	薪
aris	薬
atrf	薭
aovt	薮
alfj	薯
atgo	薰
aogf	薱
apgm	薲
afkp	薳
apns	薴
afnf	薵
aejf	薶
afdj	薷
aisi	薸
afkf	薹
aonf	薼
agwr	薾
axth	薿
aooo	藀
ayks	藁
abci	藂
aykw	藃
aadi	藄
alyj	藅
aegw	藇
ahwd	藈
adij	藉
atya	藊
anwy	藋
apnj	藌
adny	藏
aerq	藐
aqmt	藑
atjn	藒
aqgg	藓
apdi	藔
adiy	藕
aahm	藖
agkp	藗
ahan	藘
auec	藙
apeo	藛
atqi	藜
addd	藞
alll	藟
arrr	藠
ayup	藡
alcx	藣
aeui	藤
aosr	藦
axec	藧
aono	藨
aitl	藩
aisf	藫
aswo	藮
anfn	藯
aqyj	藰
aurc	藱
asak	藲
aykt	藳
awke	藵
agej	藸
aiks	藻
apgn	藼
ausq	藽
agkm	藾
afwy	藿
arlf	蘀
agkk	蘁
anns	蘂
ahhs	蘃
atqs	蘅
atwm	蘈
alpc	蘉
atri	蘌
atge	蘍
afec	蘎
axfm	蘏
ayec	蘐
aosd	蘑
atqn	蘒
atqo	蘓
axtm	蘔
axtp	蘕
awns	蘖
aatn	蘙
aade	蘛
aako	蘜
aben	蘟
ammv	蘡
aamg	蘣
areo	蘤
afkk	蘦
ahap	蘧
aeri	蘨
atxi	蘩
aldj	蘮
axjc	蘰
allf	蘲
aamf	蘳
abuy	蘵
atvc	蘶
hght	蘷
asgo	蘸
anye	蘹
albi	蘻
alls	蘽
afye	蘾
ayug	虀
autt	虁
aiwy	虃
aeuo	虅
alli	虆
axay	虇
akkk	虈
agko	虉
ayxs	虊
aemv	虋
aumx	虌
hawv	虎
haee	虏
haag	虐
hani	虑
hayi	虔
harg	虗
haeg	虘
hant	虙
haog	虚
hawr	虝
hakd	虞
ywrw	虠
efhw	虢
fhnw	虣
haww	虤
hawa	虥
hase	虨
ijiw	虩
hawo	虪
jhny	虫
ntji	虱
jtan	虴
gqji	虺
jynn	虻
jtnn	虼
jghy	虾
gqju	虿
qnjy	蚀
jyry	蚁
jcgg	蚂
xtju	蚃
jgah	蚈
jmwy	蚋
jdhh	蚌
jxxn	蚍
jfcy	蚑
jmyg	蚒
jxhh	蚓
jqan	蚔
gdju	蚕
jkhh	蚛
jaht	蚜
jtfn	蚝
wvju	蚠
jywn	蚢
jwcy	蚣
cyju	蚤
jwry	蚥
jwjh	蚧
jfwy	蚨
bhgj	蚩
jufh	蚪
jmqn	蚬
jway	蚮
jguf	蚲
jqay	蚳
jxet	蚴
jskg	蚵
jafg	蚶
jryy	蚸
jmfg	蚺
snju	蚻
jdhg	蚽
jhcy	蚾
jygg	蛀
jdcy	蛂
jhkg	蛅
jegg	蛆
jpxn	蛇
jwyc	蛉
nhju	蛋
ipju	蛍
jdgq	蛎
jcfg	蛏
jmag	蛐
jctg	蛑
jtkg	蛒
fjxy	蛓
jlkg	蛔
wnnj	蛗
jugh	蛘
jffg	蛙
jgqj	蛚
jriy	蛛
jvey	蛝
jtdg	蛞
jywr	蛟
juah	蛢
jfkg	蛣
jwgk	蛤
jqqy	蛥
jgxw	蛦
jmrr	蛧
awyj	蛩
dhvj	蛪
jqdb	蛫
jgcf	蛭
yoju	蛮
jftx	蛯
rvyj	蛰
jgud	蛱
jjgh	蛳
jyjh	蛴
jgva	蛵
jefy	蛶
jgiy	蛷
jieg	蛸
jceh	蛹
jtry	蛾
lqju	蜀
jtnh	蜁
jtdh	蜂
dfej	蜃
rrju	蜇
jkgd	蜈
jebg	蜉
jtjh	蜊
jyve	蜋
jxxf	蜌
jwgs	蜍
jkeg	蜎
jtbt	蜏
jfce	蜐
thpj	蜑
jthp	蜒
jtfp	蜓
jqlg	蜔
jukq	蜕
jmjd	蜖
jkmw	蜗
jtdk	蜘
jswc	蜙
hdhj	蜚
pntj	蜜
jadw	蜞
jyce	蜟
jlty	蜠
jajg	蜡
jblg	蜢
jugn	蜣
srju	蜤
jwga	蜦
jyny	蜧
jgvh	蜨
jmfk	蜩
jbib	蜬
jakg	蜮
jdwg	蜯
ecju	蜰
jrtf	蜱
jtvg	蜲
jykb	蜳
jjqr	蜴
jjgg	蜵
judb	蜷
ahnj	蜸
jwyg	蜼
jgmy	蜽
jjsy	蜾
jpqb	蜿
jgji	蝀
gfgj	蝁
jthc	蝂
jccc	蝃
jmun	蝄
jhgf	蝆
jkjn	蝇
jlgy	蝈
julh	蝉
jpgh	蝊
jiwg	蝋
jtuf	蝌
jvcb	蝍
jjqn	蝎
jyks	蝏
jjhg	蝐
jnhe	蝑
jdmd	蝒
jwgj	蝓
jxxr	蝔
jrgg	蝗
jajv	蝘
jyna	蝙
jcns	蝚
jdgy	蝛
jqmy	蝜
jnhg	蝞
jleg	蝟
jgkl	蝠
jytb	蝣
jusg	蝤
jjgr	蝪
jrbt	蝬
jtjt	蝮
jdff	蝰
jgxy	蝳
jdeg	蝴
toju	蝵
jans	蝶
jout	蝷
jjlg	蝹
jtky	蝺
jfmf	蝻
jovg	蝼
jdwj	蝽
japs	蝾
jjjn	蝿
uqfj	螀
jvep	螁
jyvb	螂
jyuy	螃
jthn	螅
juxx	螆
jexd	螇
jdri	螈
juvo	螊
jehc	螋
tewj	螌
gkmj	融
jgkh	螎
jutd	螏
jwno	螐
jthy	螑
jdwt	螓
jrhw	螔
jtlx	螕
jmeg	螖
jovk	螗
sjju	螙
cexj	螚
jpdk	螛
fpgj	螜
jrqc	螝
jpjw	螟
juwl	螠
yjju	螡
eudj	螣
yjjw	螤
jgxi	螦
jagw	螨
jwhs	螩
fotj	螫
jgmj	螬
jyrc	螭
jaqh	螮
gqtj	螯
jonx	螰
nfij	螱
jipf	螳
bgjj	螴
jsfi	螵
anjj	螶
ortj	螷
jlrh	螹
jlxi	螺
tujj	螽
jpgw	螾
nhdj	螿
jyxf	蟀
jwvs	蟂
jjlc	蟃
joao	蟅
jajd	蟆
jnwe	蟉
jton	蟋
jtln	蟌
jtjs	蟍
javj	蟏
jiph	蟐
jujf	蟑
jada	蟒
jqke	蟓
jlfo	蟔
jhxh	蟕
jadr	蟖
jwam	蟘
jujy	蟙
fkuj	蟚
jfke	蟛
jias	蟝
jdui	蟟
jtol	蟠
jeto	蟡
jnnw	蟤
jamw	蟥
jfam	蟦
jooe	蟧
jduw	蟩
jgjn	蟪
jwyo	蟭
jugk	蟮
jvfj	蟰
jrlo	蟱
jvaf	蟳
jipl	蟷
jylg	蟺
aqkj	蟼
jfup	蟽
jqdy	蟾
lbwj	蟿
juqm	蠀
xtyj	蠁
jaas	蠂
jajy	蠇
madj	蠈
jlge	蠉
jouo	蠊
jlqj	蠋
jape	蠓
jfdj	蠕
jawc	蠖
jpgm	蠙
adkj	蠚
jaly	蠛
srrj	蠜
jlll	蠝
tvcj	蠞
xgej	蠡
dwjj	蠢
usgj	蠤
btwj	蠥
fpdj	蠧
jyfj	蠩
uegj	蠪
ejjj	蠫
jatn	蠮
uwlj	蠲
jmmv	蠳
jalj	蠴
jmwk	蠵
jhhy	蠷
jaky	蠸
gkhj	蠹
jhhc	蠼
vxxj	蠿
tlvy	衂
tldh	衃
tlnf	衄
tlug	衅
tliu	衆
tlre	衇
tlbg	衈
vgdl	衋
tgsh	行
tigs	衍
tfgs	衎
tfqs	衏
tans	衐
tqgs	衔
tmgs	衕
taws	衖
tffs	街
trhs	衘
tgks	衙
tdes	衚
tuts	衜
tnks	衞
tvds	衟
tqds	衡
thhs	衢
puyy	衤
puhy	补
pugf	衧
pucy	衩
pubn	衪
puet	衫
pufy	衬
pufw	衭
ywce	衮
puwv	衯
ykge	衰
puby	衱
pumw	衲
puwc	衳
pupq	衴
ykhe	衷
puwj	衸
yahe	衺
pumf	衻
putf	衽
wyne	衾
puwn	衿
puqu	袀
fkeu	袁
punw	袂
avye	袃
putd	袄
qyne	袅
pumy	袇
ekye	袈
pupx	袉
waye	袋
yqne	袌
puqn	袍
puxe	袎
puda	袏
pujg	袒
pusk	袔
pupw	袕
pumg	袖
putb	袘
pudy	袚
puqy	袛
pugs	袜
puwf	袝
yrwe	袠
puug	袢
puan	袣
ycne	袤
pubm	袦
puyx	袨
puhc	被
ycke	袬
dxye	袭
xyeu	袰
puwy	袱
yqqe	袲
puqq	袳
pudn	袴
pudb	袸
pudj	袹
putk	袼
puri	袾
puff	袿
puld	裀
fyey	裁
gqje	裂
puts	裄
ufye	装
puiv	裆
pupl	裈
puve	裉
pugu	裋
pukg	裎
yjfe	裏
puke	裐
putt	裑
yeeu	裒
puaa	裓
yemk	裔
puwk	裕
pude	裖
giye	裘
puvk	裙
rrye	裚
iite	裟
vtke	裠
pulp	裢
puwg	裣
puol	裤
puuj	裥
yqge	裦
puoo	裧
purf	裨
pujx	裩
puqm	裪
puft	裬
pujj	裮
pumk	裯
pucc	裰
puge	裱
pugy	裲
ipke	裳
hdhe	裴
yhde	裵
puhd	裶
puub	裷
pujs	裸
yjse	裹
hgie	裻
pujr	裼
pund	裾
pudk	裿
puaw	褀
jseu	褁
pufh	褂
puhe	褃
pugv	褄
puyh	褅
pujh	褆
pudd	褉
puya	褊
puas	褋
pujn	褐
puec	褑
ywke	褒
puws	褓
pugl	褔
puav	褗
punh	褘
puue	褙
puov	褛
eqne	褜
puil	褝
puaf	褠
puak	褡
yrqe	褢
pupk	褣
pufe	褤
pudf	褥
pucx	褦
boye	褧
puua	褨
tewe	褩
puvp	褪
purw	褫
pucs	褬
ycoe	褭
puoh	褯
pawe	褰
ylie	褱
pujl	褴
punr	褶
fufe	褺
pusn	褼
nfie	褽
puxj	襁
puce	襂
ykke	襄
puow	襆
pujc	襊
pukl	襌
puqe	襐
puvf	襑
puut	襒
pufq	襓
puay	襔
puui	襕
pulf	襗
puup	襚
pume	襛
pusi	襟
pulj	襡
puww	襥
pugr	襧
puof	襨
pufm	襩
puji	襮
puud	襱
puer	襷
putm	襸
pugx	襹
puaj	襺
pusr	襻
puac	襼
puai	襽
gmjg	襾
sghg	西
stpu	覂
sjfj	覃
svqr	覅
sttt	覆
sake	覇
sakk	覉
sako	覊
chqn	覌
ihqb	覍
hqbd	覎
hqrr	覐
dhhq	覔
nthq	覕
ngkq	覗
qihq	覙
iphq	覚
rehq	覛
fohq	覝
hqhq	覞
fnhq	覟
vtkq	覠
oohq	覢
tvhq	覣
hawq	覤
mawq	覥
ahnq	覧
kkfq	覨
ftjq	覩
yupq	覫
pjyq	覭
oopq	覮
haeq	覰
lrhq	覱
rwyq	観
wgkq	覴
ecmq	覶
ujhq	覸
hqtt	覹
hagq	覻
gwmq	覼
ptoq	覾
cmqn	观
mqbd	觃
fwmq	规
emqb	觅
pymq	视
hkmq	觇
ipmq	觉
mnmq	觊
awwq	觋
fnuq	觌
wgeq	觎
amfq	觏
akgq	觐
haoq	觑
qehj	角
qehh	觓
tqeh	觕
qehw	觖
qeha	觗
qeht	觘
qehy	觚
hxqh	觜
qehr	觞
udqh	觠
qehk	觡
dhvh	觢
qehg	解
qehb	觤
qehq	觥
qehi	觫
qehl	觯
qmfj	觰
dgkh	觱
errh	觷
qehm	觹
qehs	觻
qeho	觾
yyyy	言
yqyy	訋
ygfh	訏
yxhh	訠
yrry	訤
ypqn	訦
yrbh	訩
yitt	訬
ygah	訮
ybyy	訯
ygbn	訰
ysyy	訹
yqkg	訽
hxyf	訾
yhxn	訿
yhkg	詀
yyxy	詃
ywyc	詅
ymdy	詇
yvcy	詉
yafg	詌
yann	詍
yxet	詏
ypxn	詑
yfcy	詓
yhcy	詖
ymkg	詗
ydcy	詙
yjgg	詚
ybhc	詜
ypsh	詝
dxyy	詟
ywnk	詤
yvey	詪
ydeg	詴
yyth	詶
qdwy	詹
ytkg	詻
yqrb	詾
yuah	誁
yqiy	誂
yqqy	誃
ygcf	誈
igwy	誉
ynny	誋
ygki	誎
ytry	誐
rryf	誓
ytjh	誗
ygva	誙
yvpc	誛
ycwt	誜
yftb	誟
yhqn	誢
ydfe	誫
yfpq	読
yawx	誮
ygvh	誱
ynbm	誳
ypfi	誴
yrde	誵
ymun	誷
yxyx	誸
ysww	誺
yijg	誻
yeqn	誽
yrtf	諀
yccc	諁
yssy	諃
adwy	諅
yadw	諆
ytfg	諈
yqoy	諊
ygji	諌
wkky	諐
yhgc	諔
yhaw	諕
yqaj	諙
ypgh	諚
ynhe	諝
yjgh	諟
ywgl	諡
ymnk	諣
ytgf	諥
ygkl	諨
yyks	諪
ymdj	諯
ylny	諰
ydgy	諴
yfmf	諵
yrgg	諻
yakf	諽
yjtg	謃
pawy	謇
yrqc	謉
yskk	謌
yehc	謏
yexd	謑
yfhw	謓
yrhw	謕
ydri	謜
yykk	謞
yeeg	謟
yffn	謣
ysfi	謤
ytln	謥
yyrc	謧
ajdy	謩
ygmy	謮
ylpy	謰
ylvg	謱
ycce	謲
yxfm	謴
ynrg	謵
yoao	謶
yhaf	謼
ykkl	譂
yulj	譄
yvyh	譅
yfkk	譆
ydfj	譇
yykt	譈
yffq	譊
yueg	譋
yeto	譌
owwy	譍
ygjn	譓
ynnw	譔
yrlo	譕
ytwk	譗
yfwj	譛
ylge	譞
yipl	譡
yryt	譤
aqky	警
youo	譧
ymae	譨
yujn	譩
yajn	譪
nkuy	譬
yeac	譭
yywe	譲
yfdj	譳
yogf	譵
yyyf	譶
yfnf	譸
yyke	譹
yxth	譺
mmyf	譻
ahny	譼
ydhn	譿
yqmt	讂
yfwm	讃
ylll	讄
yptl	讅
tnky	讆
yuqe	讇
ydth	讈
uegy	讋
yako	讌
yben	讔
yaky	讙
yafc	讛
yhgg	让
ytnn	讫
yyry	议
ynfh	讯
yfjh	讲
yfnh	讳
yary	讴
yang	讵
yaht	讶
ymwy	讷
ytfh	许
ywxn	论
ywry	讽
ywcy	设
yghg	证
yskg	诃
yguf	评
yegg	诅
ykwy	识
ythf	诈
yryy	诉
ywet	诊
yqay	诋
yqvg	诌
yngk	词
ybmh	诎
yvkg	诏
ycgh	译
yckg	诒
yagg	诓
ydiy	诔
yaay	试
yffg	诖
yffy	诗
yfkg	诘
ydoy	诙
ydny	诚
yriy	诛
ytfq	诜
ytdg	话
ythp	诞
yrgk	诟
ywgg	诠
yqdb	诡
yqjg	询
yxjg	诣
yqvh	诤
yynw	该
yugh	详
ypta	诧
yplh	诨
yaah	诫
yaww	诬
ygkg	语
yieg	诮
ykgd	误
ytfk	诰
ytbt	诱
ytxy	诲
yqtg	诳
yukq	说
yceh	诵
yctd	诶
ygeg	请
yftj	诸
ybcy	诹
yadk	诺
yfnd	读
ygey	诼
yhdd	诽
yjsy	课
ytvg	诿
yewy	谀
ywyg	谁
ywyn	谂
ymfk	调
yqeg	谄
yyki	谅
yykb	谆
yywf	谇
yooy	谈
ypjh	谉
ypeg	谊
yafs	谋
yadn	谌
yans	谍
yayk	谎
ygli	谏
yxxr	谐
yhag	谑
yjqn	谒
yleg	谓
ykkn	谔
ywgj	谕
yegc	谖
yqku	谗
yuqk	谘
yujg	谙
yute	谚
yyuh	谛
yopy	谜
yyna	谝
yajd	谟
yipq	谠
ylwt	谡
ytmf	谢
yerm	谣
yyuy	谤
yuwl	谥
yuvo	谦
yntl	谧
yakg	谨
yjlc	谩
yyud	谪
yuev	谫
ynwe	谬
ysjf	谭
yaqj	谮
ywyo	谯
yugi	谰
yuoj	谱
ycnk	谲
yfmy	谳
ykhp	谴
yqdy	谵
ywwg	谶
wwkf	谷
wwkc	谹
wwka	谾
wwkd	豀
wwke	豂
gkuf	豆
gkua	豇
gkuc	豉
magu	豊
gkub	豌
gkuo	豏
magt	豑
mdhl	豓
geyi	豖
gqge	豗
gegn	豘
gewc	豛
gega	豜
gecn	豝
geyn	豟
qkeu	象
udge	豢
geve	豤
gegy	豧
ykpe	豪
cnhe	豫
genc	豭
gefm	豮
geed	豯
gejl	豱
gedi	豲
mgee	豳
geyd	豴
geth	豵
gefu	豷
etyt	豸
eqyy	豹
eftt	豺
epwy	貁
evkg	貂
evgh	貄
ewsy	貅
egjg	貆
evey	貇
etey	貈
edjg	貊
ejfh	貋
erqn	貌
etlx	貔
ekkl	貚
eaky	貛
ehhc	貜
aymu	貣
mywn	貥
fmny	貮
cdmu	貵
mtgg	貹
muah	賆
mtlg	賉
mdxy	賎
pnmu	賔
mwgs	賖
mkkh	賗
mofy	賘
mmfk	賙
fwfm	賛
mpws	賝
vhgm	賮
mqjb	賯
mdwj	賰
mplh	賱
wksm	賲
mjhg	賵
fkkm	賷
muwl	賹
atdm	贀
mmty	贁
yfhm	贇
msjf	贉
mogw	贌
majy	贎
ahnm	贒
mmmu	贔
qytm	贕
mipm	贘
hawm	贙
mady	贜
mhny	贝
mftt	财
jcmu	贤
mtay	账
wxmu	货
rfmi	质
mrcy	贩
wynm	贪
wvmu	贫
mtpy	贬
mqcy	购
mpgg	贮
xfmu	贯
afmy	贰
mfxy	贱
famu	贲
anmu	贳
mhkg	贴
khgm	贵
mkqn	贶
waym	贷
qyvm	贸
xjmu	费
ekmu	贺
mckg	贻
madt	贼
rvym	贽
mdeg	贿
hxmu	赀
wtfm	赁
mtkg	赂
mofg	赃
uqwm	资
mynw	赅
mnyu	赆
mgiy	赇
mdfe	赈
gomu	赉
mwfi	赊
mfhy	赋
mftj	赌
fwwm	赍
mfnd	赎
ipkm	赏
mjqr	赐
ovwm	赓
mukg	赔
mooy	赕
gkim	赖
gqtm	赘
mgef	赙
muvo	赚
pawm	赛
dwwm	赝
tfqm	赞
mulj	赠
mqdy	赡
ynky	赢
ujfm	赣
foqw	赥
foty	赦
fobc	赧
fojy	赨
foqc	赩
fohm	赪
fofo	赫
fofj	赭
fonc	赮
fook	赯
fuyu	赱
fhee	赲
fhnh	赳
fhhi	赴
fhri	赵
fhfk	赶
fhnv	起
fhmk	赸
fhqu	赹
fhit	赻
fhqw	赼
fhrk	赾
fhqa	赿
fhwe	趁
fhrw	趃
fheg	趄
fhvk	超
fhqy	趆
fhgy	越
fhqv	趋
fhqq	趍
fhuw	趑
fhws	趓
fhgj	趔
fhgi	趚
fhqo	趜
fhik	趟
fhhf	趠
fhvi	趢
fhbc	趣
fhpd	趤
fhuk	趦
fhjh	趧
fhaw	趪
fhwo	趭
fhks	趮
fhgr	趰
fhtm	趱
khwy	趴
khqy	趵
khtn	趷
gqkh	趸
khnw	趹
khfw	趺
khwn	趻
khga	趼
khhg	趾
khby	趿
khtd	跃
khry	跅
khck	跆
khwe	跈
khwc	跉
khfi	跊
khdy	跋
khrw	跌
khpx	跎
khek	跏
khhx	跐
khqn	跑
khsk	跒
khyg	跓
khdg	跖
khwf	跗
khmg	跚
khhc	跛
khnx	跜
khan	距
khti	跞
khve	跟
khgw	跠
khqq	跢
khtq	跣
khyr	跤
khbs	跥
khri	跦
khdn	跨
khjx	跩
khqb	跪
awyh	跫
khff	跬
khtk	路
khwk	跲
khqi	跳
khfy	践
khdp	跶
khaq	跷
khxf	跸
khtp	跹
khws	跺
khyj	跻
khnn	跽
whth	跾
khbn	踂
rrkh	踅
khtx	踇
khgi	踈
khye	踉
khch	踊
khfb	踋
khdf	踌
khdk	踎
khij	踏
khtv	踒
khhf	踔
khqo	踘
khwa	踚
khjs	踝
khnd	踞
khpb	踠
khjr	踢
khuk	踣
khyf	踤
khuv	踥
khwh	踨
khes	踩
khpi	踪
khrm	踬
khok	踮
khub	踯
khoc	踱
khtf	踵
khjh	踶
khmj	踹
khvp	踺
khmk	踻
khty	踽
khgl	踾
khas	蹀
khya	蹁
khcs	蹂
khak	蹃
khyh	蹄
pawh	蹇
khee	蹈
khua	蹉
khed	蹊
khjn	蹋
khne	蹍
khbc	蹑
lrkh	蹔
khde	蹖
khox	蹗
khah	蹛
khpj	蹜
khxm	蹞
khlp	蹥
khme	蹦
khgj	蹧
khkm	蹪
khwu	蹬
khuj	蹭
khsn	蹮
khtl	蹯
khuf	蹲
khyy	蹴
ykih	蹵
khdw	蹶
dubh	蹷
khoh	蹸
khow	蹼
khph	蹿
khks	躁
khlj	躅
khaj	躇
khrt	躈
khgr	躎
khay	躏
khvn	躐
khof	躔
khxg	躖
khuy	躙
khtm	躜
khui	躝
khyc	躞
khun	躢
khhy	躣
tmdt	身
tmdx	躬
tmdq	躭
tmdv	躮
tmdr	躯
tmdg	躰
tmds	躲
tmde	躴
tmdn	躵
tmdo	躹
tmdk	躺
tmdd	躾
tmdi	躿
tmdl	軃
tmdm	軉
lgqn	軏
lwyy	軓
lwcy	軗
lhcy	軙
lmwy	軜
lqan	軝
ltfn	軞
ltfg	軠
lfcy	転
lqkg	軥
lkqn	軦
lqay	軧
lckg	軩
lxet	軪
cdlj	軬
lagg	軭
lmdy	軮
lguf	軯
uxlj	軰
lqnn	軳
lygg	軴
lwfy	軵
ldcy	軷
lcfg	軽
luah	軿
lawy	輁
awlj	輂
ligq	輄
ltey	輈
mdlj	輋
lgmm	輌
lwwk	輍
lieg	輎
lsgg	輏
lpfq	輐
lvtk	輑
lmfk	輖
leqn	輗
lbcy	輙
ljsy	輠
lqeg	輡
leeg	輣
lphn	輨
lyki	輬
ldmd	輭
lcns	輮
ldgy	輱
lrfh	輴
ljqn	輵
lusg	輶
ltjt	輹
lgvl	輺
ljlg	輼
lcdl	輽
llwl	轀
ldwt	轃
ldhv	轊
llpy	轋
lfvg	轌
lnbb	轏
logw	轐
lfam	轒
ltol	轓
lajn	轕
lfwk	轖
ldgn	轗
lugy	轙
lbwl	轚
logf	轛
lfdj	轜
egnl	轝
lahl	轞
ldth	轣
lauy	轥
lgnh	车
lvyy	轫
lfny	转
ldbn	轭
lwxn	轮
lqwy	软
lccu	轰
lskg	轲
lhnt	轳
lkwy	轵
lrwy	轶
ltuf	轷
lwet	轸
ltni	轹
lvkg	轺
lcag	轻
laay	轼
flxy	载
lgcf	轾
ltdj	轿
lwgg	辁
lywr	较
lbnn	辄
lgey	辅
lgmw	辆
fwfl	辇
hdhl	辈
igql	辉
ljxx	辊
lmun	辋
lccc	辍
lvlg	辎
ldwd	辏
lgkl	辐
lkbg	辑
lwgj	输
lxxk	辔
lfke	辕
lpdk	辖
lnae	辗
lonx	辘
lyct	辙
loqh	辚
dufj	辜
ckuf	辝
tduf	辞
udgi	辣
epcf	辤
btwf	辥
udvf	辧
udyf	辩
hwnf	辪
udxf	辫
dfei	辰
dfef	辱
ssde	辳
kkle	辴
pyny	辶
typi	込
tfpk	迁
gfpk	迂
tnpv	迄
nfpk	迅
gqpe	迈
gmhp	迊
gbnp	迍
qbpk	迎
dypi	迏
fcpi	运
ahtp	迓
rcpi	返
gdpi	迗
dhpi	还
khpk	迚
fjpk	进
fqpv	远
fnhp	违
nypi	迟
hkpd	迠
nxpv	迡
vkpd	迢
anpv	迣
tbpv	迤
mkpd	迥
ekpd	迦
jhpk	迧
ckpd	迨
ygpd	迬
rwpi	迭
thfp	迮
qhpi	迯
sypi	述
pxpv	迱
capd	迳
mgkp	迵
uapk	迸
yopi	迹
qqpi	迻
fkpd	迼
wnnp	追
gqjp	迾
qjpd	迿
vepi	退
udpi	送
tdpd	适
qipi	逃
tahp	逄
rgkp	逅
ubtp	逆
fbpv	逇
tmkp	逈
tfqp	选
bipi	逊
gehp	逋
hmnp	逌
iepd	逍
sgpd	逎
tbpe	透
gepi	逐
giyp	逑
uxhp	递
rfmp	逓
wgsp	途
qtop	逖
gkup	逗
ctdp	逘
cehp	通
qtgp	逛
gkpd	逜
rrpk	逝
kgpd	逞
gkip	速
tfkp	造
cwtp	逡
tdhp	逢
gmyp	逦
wwkp	逧
swwp	逨
dfap	逩
ajpd	逪
cccp	逫
tgdp	逬
phnp	逭
vipi	逮
rtbp	逰
ycep	逳
hjfp	逴
fwfp	逵
tvpd	逶
jqrp	逷
qkqp	逸
fufp	逹
fnwp	逺
lqpi	逻
gklp	逼
adkp	逽
wgep	逾
jgqp	逿
rfhp	遁
uepi	遂
mdmp	遄
nugp	遅
jmhp	遇
jghp	遈
hmpi	遉
kkfp	遌
ynmp	遍
jqwp	遏
nhfp	遐
rgpd	遑
uthp	道
fmup	遖
khgp	遗
amfp	遘
ehcp	遚
qyvp	遛
lipi	遝
jnpd	遢
copi	遤
ermp	遥
xfmp	遦
ujfp	遧
gqtp	遨
gmap	遭
oaop	遮
egep	遯
aqpp	遰
lvpd	遱
oqap	遴
usgp	遵
fffp	遶
cnhp	遹
kkup	遻
hagp	遽
nkup	避
rytp	邀
qehp	邂
pwup	邃
ylkp	邅
wgkp	邆
erqp	邈
vlrp	邋
tqtp	邌
tlvp	邍
qytp	邎
vkcb	邕
gfbh	邘
ynbh	邙
fwbh	邞
ywbh	邟
wvbh	邠
gabh	邢
ngbh	那
pqbh	邥
gbnb	邨
ahtb	邪
dtkc	邫
qngb	邬
qkbh	邭
afbh	邯
ckbh	邰
rgbh	邱
ntbh	邲
dhgb	邳
gmwb	邴
vkbh	邵
uxbh	邶
gnnb	邷
qayb	邸
qvbh	邹
ogbh	邺
wycb	邻
agbh	邼
ffbh	邽
ribh	邾
debh	郁
yntb	郂
rdcb	郄
gcfb	郅
fkbh	郆
qjbh	郇
rgkb	郈
ywrb	郊
thbh	郋
ffkc	郌
tebh	郍
yvcb	郎
gudb	郏
wfcb	郐
udbh	郑
yvcc	郒
plbh	郓
rdmb	郗
kkbh	郘
gehb	郙
gkbh	郚
ebbh	郛
tfkb	郜
fobh	郝
yveb	郞
gjrb	郠
vtkb	郡
kgbh	郢
fpbb	郣
wwkb	郤
gmyb	郦
kmbh	郧
ukbh	部
rdeb	郩
gvhb	郪
rtfb	郫
gebh	郬
ykbb	郭
mfkb	郮
oobh	郯
bcbh	郰
uabh	郱
swwb	郲
eqbh	郳
ssbh	郴
ukkc	郶
xtvb	郷
ulbh	郸
hdyb	郹
qqvc	郺
hnvb	郻
nkab	郼
ftjb	都
ajvb	郾
nhbh	郿
adkb	鄀
uxeb	鄁
kkfb	鄂
sfbh	鄄
tkmb	鄅
wntb	鄇
xtbb	鄊
ehcb	鄋
ovhb	鄌
pjyb	鄍
thnb	鄎
dfeb	鄏
yxlb	鄐
gogb	鄑
xtrb	鄕
oveb	鄘
kflb	鄙
ajdb	鄚
vjsb	鄛
onjb	鄜
nweb	鄝
akgb	鄞
gjhb	鄟
wvgb	鄡
ghgb	鄢
ujfb	鄣
jlcb	鄤
rlgb	鄦
vakb	鄩
xjmb	鄪
uljb	鄫
qyvb	鄮
ugub	鄯
tolb	鄱
kkkb	鄵
magb	鄷
alpb	鄸
bcib	鄹
ojfb	鄽
depb	鄾
akkb	鄿
akub	酀
qkxb	酁
fkkb	酃
mwyb	酅
mdhb	酆
sgsh	酊
sgqy	酌
sgnn	配
sgfy	酎
sgbn	酏
sgfh	酐
sggf	酑
isgg	酒
sgpq	酖
sgrb	酗
sgwc	酘
sgwv	酚
sgfq	酛
sgfc	酝
sgdy	酞
sghk	酟
sgsk	酠
sgpx	酡
sgtf	酢
sgaf	酣
sgdg	酤
sgty	酥
sgny	酦
sgpf	酧
fsgy	酨
sgqk	酩
sgyh	酬
sgmk	酮
sgxj	酯
sgtq	酰
uqsg	酱
sgxe	酳
sgws	酴
sgfb	酵
sgtx	酶
sgtk	酷
sgct	酸
sgef	酹
sgyk	酼
sggd	酽
sggy	酾
sgye	酿
sgvi	醁
sgqm	醄
sguk	醅
sgyb	醇
sgoo	醈
sgyf	醉
sgcc	醊
sgaj	醋
sgjx	醌
sgjh	醍
sgde	醐
sgjg	醒
sgpl	醓
tosg	醔
sgwq	醗
sgfl	醘
sgec	醙
sgop	醚
sgag	醛
sgua	醝
oopg	醟
sgml	醠
sgdl	醢
sgok	醣
uefg	醤
sgsi	醥
sgak	醧
sgyc	醨
sggj	醩
sgne	醪
sgow	醭
sgwo	醮
sgyl	醯
sgme	醲
sgmu	醴
sghe	醵
sgun	醷
sgto	醺
sgao	醼
sgod	釄
tomg	釉
tocg	释
tgjf	重
jfch	野
jgjf	量
qqqq	金
wrfu	釜
qgfh	釪
qfnn	釫
qftt	釮
qtnn	釳
qayy	釴
qrhy	釽
qgah	鈃
qwcy	鈆
qfwy	鈇
qwxn	鈋
qxhh	鈏
qwvt	鈖
qcqn	鈗
qfcy	鈘
qxxn	鈚
qnyy	鈬
hxqf	鈭
qbmh	鈯
qnna	鈱
qckg	鈶
qthf	鈼
qwet	鉁
qkry	鉂
qygg	鉒
qtmh	鉓
qtuy	鉖
qxjh	鉘
qkwy	鉙
qwfy	鉜
qdhg	鉟
qmdy	鉠
qsyy	鉥
qwiy	鉩
qann	鉪
qekg	鉫
qjhh	鉮
qnyw	鉯
qngk	鉰
qocy	鉱
qhgh	鉲
quxn	鉳
jtyq	鉴
qgaj	鉶
qawy	鉷
qaay	鉽
qctg	鉾
qdjg	銆
qdiy	銇
qffg	銈
qvgh	銉
qdgy	銊
qdhb	銌
qgcf	銍
awyq	銎
qmmg	銏
gqjq	銐
qgdf	銒
qdhf	銔
qgxw	銕
qrgk	銗
qdfn	銙
qwsy	銝
qjqf	銞
qmmh	銟
qfiy	銢
qigq	銧
qdxy	銭
yoqf	銮
qxiy	銯
qary	銰
rrqf	銴
qtmt	銵
qgiy	銶
qbnn	銸
nhdq	銺
qqak	銽
qaiy	銾
qceh	銿
qgku	鋀
qtxy	鋂
qgoc	鋄
itdq	鋈
qgki	鋉
qwwk	鋊
qthp	鋋
qfpb	鋍
qpfq	鋎
qpdc	鋐
qcwt	鋑
qqkq	鋔
qfny	鋕
qevg	鋖
qkeg	鋗
qkgd	鋘
qgkg	鋙
whtq	鋚
qkhy	鋜
qgva	鋞
qdfe	鋠
qwyk	鋡
qebg	鋢
qhqn	鋧
qayn	鋩
tjqf	鋫
rrcq	鋬
qrgw	鋲
qdqn	鋴
qtwn	鋵
qbcy	鋷
qdey	鋹
qpqb	鋺
qhjf	鋽
qqrm	鋾
qimk	鋿
qwga	錀
qfwt	錂
ihcq	錃
qqaj	錉
qywf	錊
qeeg	錋
qmdf	錌
qrtf	錍
qqeg	錎
qgfg	錏
qufq	錓
hgiq	錖
qtvg	錗
qpfi	錝
qykb	錞
qdsk	錡
qccc	錣
qadw	錤
qyce	錥
qphn	錧
qgji	錬
qmfk	錭
qsoy	錰
qfwf	錴
qawx	錵
qlnn	錷
qheg	錹
qayt	錺
qfhy	錻
qdfi	錼
qgot	錽
lrqf	錾
qhaw	錿
qyki	鍄
qamd	鍈
qjgh	鍉
qrfh	鍎
qnkh	鍏
qrbt	鍐
qtjt	鍑
qcns	鍒
qkbg	鍓
qplh	鍕
qadn	鍖
qyuh	鍗
iawq	鍙
qjgr	鍚
qnhc	鍜
qjmy	鍝
qhmy	鍞
qrgg	鍠
qlge	鍡
qavk	鍣
qqyg	鍧
qwgd	鍨
cnhq	鍪
toqf	鍫
qwnd	鍭
qwgj	鍮
qans	鍱
qnnj	鍲
qmdj	鍴
qdff	鍷
qpgg	鍹
qjqn	鍻
qyna	鍽
qwhe	鎀
qbbh	鎁
qire	鎃
qlwj	鎅
quej	鎆
qjng	鎉
qpdk	鎋
quvo	鎌
qfpi	鎍
qrno	鎎
iycq	鎏
qerm	鎐
qfcl	鎑
qwcn	鎓
qovk	鎕
qube	鎙
qwnp	鎚
qgef	鎛
qtlx	鎞
qccs	鎟
qlgh	鎠
quxx	鎡
qjiq	鎤
qxhw	鎭
qfke	鎱
qipq	鎲
qthn	鎴
qskk	鎶
qcoy	鎷
qpyg	鎺
qvmy	鎻
qjlg	鎾
qhlo	鏀
qvjs	鏁
qxfm	鏆
qgkw	鏉
gqtq	鏊
qamy	鏋
qjaf	鏎
qdhv	鏏
qnwe	鏐
qcce	鏒
qtln	鏓
qonx	鏕
onjq	鏖
qiph	鏛
qtdp	鏠
qoao	鏣
qpwj	鏥
qtwh	鏦
fnwq	鏧
qlrh	鏩
qgmj	鏪
qhaf	鏬
qovi	鏮
qdrr	鏯
qmee	鏰
qujf	鏱
qyxg	鏲
qulj	鏳
qwys	鏶
qwxc	鏺
qoqh	鏻
qaet	鏾
qips	鏿
qkhm	鐀
qadr	鐁
qgjl	鐂
qamw	鐄
umiq	鐅
bueq	鐆
qtol	鐇
qbjr	鐊
qqke	鐌
qcnk	鐍
qwyo	鐎
qusf	鐏
qxfk	鐑
qaqj	鐕
qxxy	鐖
queg	鐗
qgfn	鐚
qjyi	鐛
ykbq	鐜
qvaf	鐞
qfwj	鐟
qfky	鐡
srrq	鐢
qugk	鐥
quep	鐩
qhae	鐪
qhdy	鐬
qtmd	鐭
qkks	鐰
qwgw	鐱
qnkf	鐴
qaas	鐷
qmnp	鐹
qfam	鐼
nkuq	鐾
qept	鑀
qobt	鑁
qtgo	鑂
qoos	鑅
qogf	鑆
qafl	鑉
lgvq	鑋
mmqf	鑍
qakm	鑎
qpns	鑏
qfdj	鑐
qkhp	鑓
qrrm	鑕
qaly	鑖
qlll	鑘
qtdj	鑙
qfwm	鑚
qoaw	鑛
qipm	鑜
qatp	鑝
qvln	鑞
qflm	鑟
qhbh	鑡
qqoj	鑥
qahm	鑦
qpay	鑧
qued	鑨
qgkk	鑩
qqqf	鑫
qahq	鑬
qaif	鑮
qwwy	鑯
qqky	鑱
qpah	鑳
qmwk	鑴
qaky	鑵
qady	鑶
qllf	鑸
qpwn	鑹
qhhy	鑺
qsrr	鑻
qhay	钀
qhhc	钁
qipo	钂
qnij	钃
qaui	钄
qtgn	钅
qtfh	钎
qwyy	钒
qqyy	钓
qcyy	钗
qghn	钙
qdhy	钚
qdyy	钛
qang	钜
qgbn	钝
qitt	钞
qkhh	钟
qmwy	钠
qmry	钢
qrcy	钣
qwyn	钤
qqwy	钦
qqug	钧
qqng	钨
qqcy	钩
qywn	钪
qnhf	钮
qgyy	钰
qfxy	钱
qghg	钲
qafg	钳
qsgg	钵
qskg	钶
qakg	钷
qdmh	钸
qdcy	钹
qgny	钺
qhkg	钻
qjgg	钽
qrwy	铁
qwyc	铃
qtni	铄
qwkg	铅
qqtb	铆
qymh	铈
qyxy	铉
qpxn	铊
qntt	铋
qnxn	铌
qhcy	铍
qcgh	铎
qftn	铐
qftx	铑
qdeg	铕
qdny	铖
qgud	铗
qahb	铘
qatq	铙
qivg	铛
qmgk	铜
qkkg	铝
qkmh	铞
qldy	铟
qmnn	铠
qmjh	铡
qriy	铢
qtfq	铣
qtfp	铤
qtfc	铥
qwxf	铧
qwgg	铨
qrsy	铩
qwgk	铪
qqiy	铫
qtkg	铬
qqkg	铭
qqvh	铮
qqcn	铯
qywr	铰
qyey	铱
qutt	铲
qycq	铳
qinr	铴
qpvg	铵
qvey	银
qvkg	铷
qdtf	铸
qape	铹
qgey	铺
qgoy	铼
qany	铽
qlpy	链
qjcf	铿
qieg	销
qimy	锁
qjfg	锂
qkgg	锃
qege	锄
qkmw	锅
qtfk	锆
qtbt	锈
qwwf	锉
qefy	锊
qtdh	锋
qufh	锌
qyck	锍
quga	锎
qujg	锏
qukq	锐
quxt	锑
qyve	锒
qvpc	锓
qbsk	锕
qgeg	锖
qftj	锗
qadk	锘
qajg	错
qalg	锚
qdfa	锛
qjgf	锝
qjsy	锞
qjxx	锟
qjqr	锡
qldg	锢
qlqy	锣
qtfg	锤
qwyg	锥
qrmh	锦
qrfm	锧
qrqw	锨
qudb	锩
qqrn	锪
qukg	锫
qooy	锬
qpgh	锭
qvgp	键
qndg	锯
qblg	锰
qvlg	锱
qdhd	锲
qxxr	锴
quqf	锵
qlny	锶
qkkn	锷
qtgf	锺
qwdc	锻
qehc	锼
qegc	锾
qoac	镀
qugd	镁
qovg	镂
qxjm	镄
qnhg	镅
qajd	镆
qfhw	镇
qgkh	镉
qbcc	镊
qwyb	镌
qths	镍
qwgr	镎
qqyl	镏
qykk	镐
qyuy	镑
quwl	镒
qpge	镓
qprw	镔
qpwk	镕
qsfi	镖
qipf	镗
qjlc	镘
qlxi	镙
qovh	镛
qujq	镜
qyud	镝
qytd	镞
qyth	镟
qsjf	镡
qduw	镢
qdui	镣
qogw	镤
qqgj	镥
qykt	镦
qugi	镧
quoj	镨
qpwh	镩
qxkj	镪
qwgu	镫
qawc	镬
qflg	镭
qlqj	镯
qouo	镰
qujn	镱
qpwi	镲
qono	镳
qyke	镶
dcqy	镹
dctd	镺
dcrw	镻
dcnm	镼
dcdi	镽
dcgr	镾
tayi	长
uufk	閗
ucak	閞
unte	閟
uudi	関
uwww	閦
uawi	閧
utfp	閮
rsuw	閷
ujyi	閺
uawn	闀
uudb	闂
usvd	闄
uhhc	闅
urii	闎
uwtj	闏
uths	闑
ujnd	闒
uxxo	闗
uynk	闙
uipf	闛
umti	闝
uwgn	闟
ukhm	闠
uipl	闣
umau	闦
ufkp	闧
uyhn	门
ufte	闭
ucgd	闯
ufnh	闱
udci	闳
uywv	闶
uymh	闹
uffd	闺
ukkd	闾
umnv	闿
uwai	阀
utkd	阁
uynw	阂
ulsi	阃
uqjn	阄
uukq	阅
uyve	阆
uakg	阈
udjn	阉
ujjd	阊
ueqv	阋
uepc	阌
uqaj	阍
uqed	阎
uulk	阐
ugli	阑
uhdy	阒
uitd	阔
ufcl	阖
ufhw	阗
uubw	阙
unbt	阚
wnnf	阜
bnfh	阠
btfh	阡
bgqn	阢
bufh	阧
bdhy	阫
bywn	阬
bcqn	阭
bfqn	阮
bxxn	阰
bfjh	阱
bwjh	阶
bynn	阸
bqay	阺
begg	阻
bthf	阼
bhkg	阽
bskg	阿
bpxn	陀
bhcy	陂
bgmw	陃
bwfy	附
bfiy	际
bgbh	陆
bdxy	陇
baiy	陈
bcag	陉
bqqy	陊
bgmn	陋
bdjg	陌
btah	降
briy	陎
bdeg	陏
bvey	限
bqdb	陒
bdfn	陓
bgud	陕
bcwt	陖
bieg	陗
bdfe	陙
bxxf	陛
bhht	陟
bgey	陠
bfhy	陡
bpfq	院
bwgs	除
bqhj	陥
bjfg	陧
bkmy	陨
bwgg	险
bukg	陪
bhdd	陫
bbcy	陬
bdsk	陭
bwyg	陮
bqoy	陱
btfg	陲
brtf	陴
bfwt	陵
bqrm	陶
bqeg	陷
btaj	陹
bwgw	険
bsfg	陻
bftj	陼
bdmd	陾
badw	陿
bajv	隁
bwgj	隃
bjmy	隅
btgg	隆
bdgy	隇
blge	隈
bdae	隋
brgg	隍
bdep	随
bqvn	隐
bmgu	隑
buvo	隒
bdaa	隓
bgkh	隔
bwno	隖
brqc	隗
buwl	隘
biji	隙
bipf	隚
bujf	障
bwvo	隝
bgqt	隞
bvjs	隟
bevn	隠
butg	隡
bffq	隢
boqh	隣
bwgu	隥
bnkf	隦
buep	隧
btmd	隩
bfam	隫
bgwr	隬
bfnf	隯
bjxo	隰
bito	隲
bdan	隳
bhaa	隵
pwyd	隺
wybr	隽
cwyg	难
aywy	隿
iwyf	雀
dwwy	雁
dcwy	雄
ahty	雅
wysu	集
ynwy	雇
hghy	雈
tdwy	雉
hxwy	雌
yxty	雍
egwy	雎
qvwy	雏
mfky	雕
myac	雘
akky	雚
vkcy	雝
wyyy	雠
nwey	雡
erry	雤
fghy	雨
ffnb	雩
fbyu	雭
fwvr	雰
fder	雳
fmdu	雵
fwyc	零
fqnb	雹
fcnt	雺
fter	雾
fdmj	需
fyjj	霁
fisu	霂
fipq	霃
fief	霄
ftfp	霆
fdfe	震
figh	霈
ftxu	霉
ffog	霊
fgvv	霋
fmfk	霌
fwyf	霍
fuvf	霎
fhdd	霏
ffcn	霒
feqb	霓
fiyg	霔
fssu	霖
fiwc	霗
famd	霙
fxxx	霛
fshf	霜
fnhc	霞
fiaw	霟
fuwn	霠
feyi	霡
fere	霢
fkmu	霣
fsse	霦
fnrf	霫
fyjn	霭
fian	霮
faet	霰
fcnk	霱
fkhk	露
fbtg	霳
ffci	霴
fkby	霵
fiyy	霶
fjjr	霷
fake	霸
fnkf	霹
fmau	霻
ffco	霼
fejf	霾
fcnh	霿
fape	靀
flll	靁
ffcm	靅
ffcp	靆
ffct	靉
fidh	靋
fpgm	靌
fwyo	靍
fqwo	靎
fpwo	靏
flfl	靐
gmhg	靑
gemq	靓
ugeg	靖
geiq	靗
geqc	靘
geqh	静
geph	靛
gero	靝
hdhd	非
tfkd	靠
dmjd	面
dlkf	靣
ddyd	靥
dmjm	靧
akfj	革
akfx	靴
akfc	靶
akfg	靼
akfd	鞅
akff	鞋
pvaf	鞌
akfv	鞍
akfp	鞑
akfq	鞔
akfa	鞚
akfo	鞠
akfu	鞡
akfs	鞣
akfy	鞫
akfr	鞭
akfb	鞯
akfl	鞰
akfh	鞴
tewf	鞶
gkmf	鞷
akfm	鞼
nkay	韍
nkas	韎
nkak	韐
igqh	韑
nkae	韒
nkal	韗
nkaf	韚
nkah	韛
nkan	韢
nkaj	韣
nkam	韥
fnhk	韦
fnhy	韧
fjfh	韩
jghh	韪
fnhl	韫
fnhe	韬
hdhg	韭
hqcg	韰
ujgh	韴
ujqu	韵
ujvk	韶
ujbm	韷
ujth	韸
ujtp	韼
wynj	韽
ujac	頀
vdmy	頄
hdmy	頉
fcdm	頍
hkdm	頕
ugdm	頖
pvdm	頞
tkdm	頟
qdbm	頠
hahm	頥
ndmy	頨
uadm	頩
qadm	頯
efdm	頱
tfpm	頲
fodm	頳
xfim	頴
vtkm	頵
tfkm	頶
tbdm	頺
edmx	頾
ehxm	頿
pghm	顁
swwm	顂
oodm	顃
bibm	顄
ynem	顅
ywwm	顇
xxim	顈
qdmy	顉
lndm	顋
pldm	顐
dgkm	顑
jmhm	顒
tlrm	顖
mgkm	顗
xhnm	顚
medm	顝
nwem	顟
sfim	顠
fffm	顤
wyom	顦
dmdj	顨
hdgm	顪
alpm	顭
ooym	顲
sdmy	顶
xdmy	顷
fdmy	顸
admy	项
kdmy	顺
edmy	须
gdmy	顼
fqdm	顽
dbdm	顾
gbnm	顿
rdmy	颀
wvdm	颁
wcdm	颂
ywdm	颃
cnhm	预
hndm	颅
wycm	领
hcdm	颇
cadm	颈
fkdm	颉
gudm	颊
wgkm	颌
xidm	颍
yntm	颏
ahkm	颐
hhdm	频
twdm	颓
xtdm	颖
jsdm	颗
jghm	题
kkfm	颚
mdmm	颛
utem	颜
ptkm	额
bccm	颞
agmm	颟
fhwm	颠
cccm	颡
jykm	颢
ylkm	颤
fdmm	颥
hhdf	颦
akkm	颧
wtje	颩
ghwj	颪
wtjt	颬
wtjk	颭
wtjy	颰
wtjo	颷
wtjn	颸
ermj	颻
mgkj	颽
cowj	颿
wtjl	飀
nrwj	飁
wtji	飃
wrnr	飏
wrhk	飐
wrqn	飑
uwry	飒
wrhw	飓
wrln	飔
wrec	飕
ermr	飖
wrql	飗
sfir	飘
dydr	飙
wroo	飚
tolh	飜
nuth	飝
wyve	食
uwye	飡
wysh	飣
qwye	飧
xtwe	飨
udye	飬
wyvw	飮
wyyh	飰
wyqb	飹
hxwe	飺
wyar	餀
wytd	餂
wyqi	餆
wymk	餇
ddye	餍
wytk	餎
wyye	餏
hqce	餐
wygy	餔
wyct	餕
wygu	餖
wygi	餗
wyjs	餜
wycc	餟
wytv	餧
wypl	餫
wyda	餴
wyme	餶
wyok	餹
wygf	餺
wyee	饀
wyfl	饁
wyjl	饂
wyak	饇
wyat	饊
nbte	饏
wyfu	饐
wyis	饓
yxte	饔
kgne	饕
wyhy	饖
wyfm	饙
wyal	饚
wyly	饠
qnsh	饤
qnwn	饥
qnnr	饧
qngn	饨
qnrn	饩
qntf	饪
qntd	饫
qnte	饬
qnrc	饭
qnqw	饮
qnfy	饯
qnth	饰
qnqn	饱
qnnk	饲
qnbm	饳
qnck	饴
qnbg	饵
qnaq	饶
qntk	饷
qnwk	饸
qnyr	饺
qnye	饻
qnua	饼
qnfb	饽
qngu	饾
qnty	饿
qnws	馀
qnev	馁
qnct	馂
qnjs	馃
qnjx	馄
qnqe	馅
qnpn	馆
qnsg	馇
qnkm	馈
qnme	馉
qnec	馊
qnqu	馋
qnfl	馌
qnad	馍
qngf	馎
qnql	馏
qnuf	馐
qnag	馑
qnjc	馒
qnat	馓
qnnw	馔
qnge	馕
uthf	首
vuth	馗
uthg	馘
tjnx	馜
tjeb	馟
tjwk	馠
tjhd	馡
tjaa	馢
tjdn	馣
tjjn	馤
tjtt	馥
tjuo	馦
tjjl	馧
fnwj	馨
tjfm	馩
tjpm	馪
cofh	馯
coqy	馰
cota	馲
coaj	馵
cofc	馶
cogh	馷
corh	馸
cojg	馹
coby	馺
cocq	馻
coyy	馼
cokh	馽
copq	馾
coyn	馿
cody	駀
xfco	駂
conw	駃
cony	駅
coar	駆
coty	駇
corg	駈
comk	駉
cohc	駊
covk	駋
qbco	駌
cogf	駍
comg	駎
coan	駏
codg	駓
cowc	駖
cowe	駗
comd	駚
cont	駜
cotb	駞
coqb	駠
kkco	駡
coqi	駣
coad	駥
udco	駦
coqj	駨
cowg	駩
cotq	駪
coiq	駫
cobg	駬
coyr	駮
cori	駯
cold	駰
coyh	駲
cotp	駳
coaa	駴
cogn	駵
conk	駶
cogi	駷
covc	駸
coye	駺
cojf	駻
cows	駼
coke	駽
couq	駾
couf	騂
cocd	騃
covi	騄
cowk	騇
cotf	騈
cojx	騉
coqm	騊
cosw	騋
cown	騐
cohd	騑
cocj	騒
coww	験
cojn	騔
cosv	騕
ynmo	騗
coqn	騘
couj	騚
conh	騛
covp	騝
codd	騞
cojh	騠
conc	騢
cort	騣
cowd	騤
cocs	騥
coln	騦
coil	騨
corc	騩
coec	騪
cotx	騬
coed	騱
coaf	騲
coco	騳
cojv	騴
codi	騵
coag	騹
fufo	騺
codr	騻
coox	騼
conr	騽
cock	驈
cohg	驉
covj	驌
cooh	驎
coyt	驐
cogl	驑
cokl	驒
cosf	驔
cofy	驖
coyg	驙
cooi	驜
cofs	驝
copm	驞
coao	驠
couo	驣
coay	驩
cgcy	驭
cgdy	驮
cgkh	驯
cgbn	驰
cgar	驱
cgjg	驲
cgrr	驳
cgyn	驴
cgeg	驵
cgkr	驶
cglg	驷
cgwf	驸
cgqk	驹
cgqv	驺
cgyg	驻
cgpx	驼
vccg	驽
ekcg	驾
cgcg	驿
cgck	骀
cgaq	骁
kkcg	骂
cgld	骃
cgtj	骄
cgtk	骆
cgyw	骇
cgua	骈
cggy	骊
cgmn	骋
cgwg	验
cgvc	骎
cgct	骏
cgaw	骐
cgdk	骑
cgjs	骒
cgwy	骓
cgpi	骔
cgvj	骕
cgce	骖
cgya	骗
bhhg	骘
cgwd	骙
cgcj	骚
cgql	骝
pawg	骞
cgsi	骠
cgli	骡
cgtn	骢
cgnb	骣
cgbi	骤
cguw	骥
cgye	骧
mevn	骩
mewy	骪
mevy	骫
megf	骬
mefh	骭
meay	骮
mewc	骰
mewj	骱
meqn	骲
mehc	骳
mehx	骴
mesg	骵
meqy	骶
medg	骷
meyw	骸
meyr	骹
merk	骺
medn	骻
metk	骼
meev	骽
megr	骾
meua	骿
merf	髀
mejs	髁
mepk	髂
mejy	髃
meov	髅
meyk	髇
meyy	髈
mepy	髉
mepq	髋
mepw	髌
meos	髍
mene	髎
mefq	髐
melj	髑
medp	髓
mehl	髗
ykmk	高
yjfk	髙
ykmv	髛
ykme	髝
dcet	髟
dceq	髡
dcey	髣
dcen	髦
dcec	髪
dcek	髫
dceg	髬
dcex	髭
dcef	髯
dcej	髴
dcea	髷
dces	髹
dced	髺
dcei	鬃
dcer	鬄
dceb	鬈
dceo	鬏
dcew	鬓
dcee	鬟
hggf	鬦
hggt	鬫
hggr	鬬
obxb	鬯
srre	鬰
gkmh	鬲
hagh	鬳
gkmy	鬴
fwmh	鬶
gkmt	鬷
gkml	鬸
gkmr	鬺
xoxh	鬻
rqci	鬼
rqcr	鬿
rqcj	魀
rqcf	魁
fcrc	魂
rqcy	魃
rrqc	魄
ddyc	魇
rqce	魈
rqcw	魉
rqcg	魊
rqcn	魍
tvrc	魏
rqco	魐
rqcc	魑
ossc	魔
fnac	魗
ilrc	魙
qovt	魛
qowy	魜
qojh	魝
qoty	魞
qoag	魟
qota	魠
qoqy	魡
qonn	魢
qoch	魣
qowx	魤
qoby	魥
qoit	魦
qoyw	魧
qogn	魨
qoqr	魩
qowj	魪
qopq	魫
qorc	魬
qofq	魭
qoxx	魮
qoyy	魰
qogg	魱
qoyn	魲
qogh	魳
qowv	魵
qomw	魶
qotn	魸
qosk	魺
qolh	魻
qofc	魼
qoaf	魽
qodg	魾
qowc	魿
qody	鮁
qolw	鮂
qoxj	鮄
qont	鮅
hxqo	鮆
qofi	鮇
qoqk	鮈
qorg	鮊
qomg	鮋
qoyx	鮌
qohc	鮍
qohk	鮎
qotg	鮏
qotf	鮓
qoan	鮔
qotu	鮗
qohi	鮛
qork	鮜
udqo	鮝
qopv	鮟
qoqb	鮠
qoqi	鮡
qori	鮢
qotk	鮥
qomk	鮦
qoua	鮩
qodn	鮬
qowk	鮯
qolk	鮰
qofx	鮱
qofn	鮳
qows	鮴
qouq	鮵
qout	鮷
qoie	鮹
ugqo	鮺
qoct	鮻
qovc	鮼
qoev	鮾
qobn	鮿
qosg	鯂
qogk	鯃
qogy	鯄
qotp	鯅
qoyk	鯍
qotj	鯏
qofh	鯐
qorh	鯑
qott	鯓
qotv	鯘
qoyb	鯙
qotb	鯚
qouv	鯜
qold	鯝
qogi	鯟
qosw	鯠
qojr	鯣
qoff	鯥
qowa	鯩
qobl	鯭
qopi	鯮
qorj	鯯
qohw	鯱
qoyu	鯲
qonj	鯴
qoce	鯵
qopl	鯶
qowd	鯸
qojg	鯹
qofj	鯺
qogj	鯻
qort	鯼
qowr	鯾
qoya	鯿
qoec	鰀
qomj	鰂
qole	鰃
qojy	鰅
qodj	鰆
qocs	鰇
qoav	鰋
qoug	鰌
qovp	鰎
qogl	鰏
qokn	鰐
qonc	鰕
qode	鰖
qopf	鰘
qoak	鰙
qopg	鰚
qojl	鰛
qowo	鰞
qocj	鰠
qoql	鰡
qoco	鰢
qowh	鰤
qoux	鰦
eudo	鰧
qofl	鰪
qopk	鰫
qohy	鰬
qoll	鰮
qoxu	鰯
qoph	鰰
qomt	鰴
txto	鰵
qowi	鰶
qonr	鰼
qogm	鰿
vcao	鱀
qogp	鱁
qonf	鱂
qouf	鱃
qooh	鱅
qooi	鱇
qock	鱊
qohg	鱋
qoqe	鱌
qosf	鱏
qovj	鱐
qokl	鱓
qotl	鱕
qofk	鱚
qouj	鱛
qoxb	鱜
qofm	鱝
qomd	鱡
qoks	鱢
qoyg	鱣
qoxg	鱦
qoij	鱨
qojj	鱪
qoet	鱫
qoew	鱮
qolj	鱰
qovn	鱲
qors	鱳
qoay	鱴
qoue	鱶
qoqo	鱻
qgnn	鱾
qgdy	鱿
qggn	鲀
qgjf	鲁
qgyt	鲂
qgcn	鲃
qgsk	鲄
qggf	鲆
qghk	鲇
qgmg	鲉
qgtf	鲊
qgwf	鲋
qgqn	鲍
ipqg	鲎
qghc	鲏
qgck	鲐
qgff	鲑
qgfk	鲒
qgde	鲔
qgdj	鲕
qgrk	鲘
qgwc	鲙
qgyj	鲚
qgyr	鲛
qgug	鲜
ugqg	鲝
udqg	鲞
qgvf	鲟
qggr	鲠
qggy	鲡
qglp	鲢
qgts	鲦
qgti	鲧
iitg	鲨
qgpq	鲩
qgvk	鲪
qgvb	鲫
qgch	鲬
qgge	鲭
qgft	鲮
qgbc	鲰
qghd	鲱
qgjx	鲲
qgjj	鲳
qgld	鲴
qgeq	鲵
qgwn	鲶
qgmk	鲷
qgyi	鲸
qgce	鲹
qgnj	鲺
qgvl	鲻
qgfm	鲼
qgas	鲽
qggl	鲾
qgic	鲿
qgjh	鳀
qgle	鳂
qgln	鳃
qgkn	鳄
qgto	鳅
qgtt	鳆
qgrg	鳇
qgri	鳈
qgya	鳊
qgcj	鳋
gqtg	鳌
qgfj	鳍
qgjn	鳎
qgli	鳏
qgem	鳐
qguo	鳒
qgae	鳓
qgsi	鳔
qgfv	鳕
umig	鳖
qgjc	鳗
txtg	鳘
qgnf	鳚
qgnr	鳛
qgdw	鳜
qguk	鳝
qgoh	鳞
qguf	鳟
qgac	鳠
qgdn	鳡
qgmu	鳢
qgtn	鳤
wvgn	鳦
wvge	鳨
dwvo	鳫
wvgw	鳬
vwvo	鳭
cwvo	鳮
wwvo	鳯
tywo	鳰
fwvo	鳱
nfwo	鳵
fcwo	鳷
ynwo	鳸
wyno	鳹
wvwo	鳻
ywvo	鳼
gawo	鳽
gmho	鳾
dhwo	鴀
tdwo	鴁
nwwo	鴂
aqwo	鴄
mywo	鴅
ghwo	鴊
arwo	鴎
ekwo	鴐
vcwo	鴑
wyco	鴒
tpwo	鴔
nnao	鴖
uwvo	鴗
hxwo	鴜
kgno	鴞
jgwo	鴠
egwo	鴡
xewo	鴢
wvgu	鴤
rwwo	鴩
lwvo	鴫
wnno	鴭
dfno	鴮
xjwo	鴲
pvwo	鴳
tgso	鴴
qiwo	鴵
fkwo	鴶
ugwo	鴹
vkwo	鴽
ctgo	鴾
wtfo	鵀
ywro	鵁
tewo	鵃
gcfo	鵄
tkwo	鵅
twvs	鵆
rhfo	鵇
nnwo	鵋
wvgs	鵌
pfqo	鵍
evwo	鵎
geho	鵏
awwo	鵐
wvgt	鵔
cwto	鵕
rdmo	鵗
gvao	鵛
trxo	鵞
gkio	鵣
ugjo	鵥
wvgi	鵦
uawo	鵧
wgdo	鵨
ebco	鵩
hjfo	鵫
qwvo	鵭
qewo	鵮
mfko	鵰
yneo	鵳
qkqo	鵵
pqbo	鵷
dsko	鵸
pwao	鵼
ccco	鵽
jxxo	鵾
ykio	鶁
eqwo	鶂
gewo	鶄
vlwo	鶅
gvho	鶈
ovwo	鶊
ndwo	鶋
nbmo	鶌
jqro	鶍
pfio	鶎
efwo	鶏
sypo	鶐
oowo	鶑
alwo	鶓
ujwo	鶕
towo	鶖
jgho	鶗
yupo	鶙
xxro	鶛
acno	鶜
gklo	鶝
rfho	鶞
pwdo	鶟
ajvo	鶠
egdo	鶢
nhwo	鶥
dewo	鶦
amdo	鶧
xgeo	鶨
hdyo	鶪
glio	鶫
wyvo	鶬
xywo	鶭
ykmo	鶮
kmwo	鶰
wcno	鶲
qbto	鶵
ovho	鶶
pdho	鶷
xuxo	鶸
qyvo	鶹
iweo	鶺
wyfo	鶽
fjfo	鶾
uwlo	鷁
jpvo	鷃
exdo	鷄
sswo	鷅
xhno	鷆
fpdc	鷇
rhao	鷉
gkmo	鷊
wvgo	鷌
rdfo	鷎
jdfo	鷐
gjho	鷒
atdo	鷖
oveo	鷛
lvwo	鷜
jafo	鷝
drro	鷞
ytto	鷟
rlgo	鷡
dubo	鷢
sjfo	鷣
kklo	鷤
agao	鷨
umio	鷩
hhpo	鷪
vfjo	鷫
amwo	鷬
tolo	鷭
tdko	鷮
thio	鷱
nfto	鷵
lmwo	鷶
ujno	鷾
lqjo	鸀
iexo	鸂
ryto	鸄
lfuo	鸅
hako	鸆
ylko	鸇
sjgo	鸉
pnlo	鸋
wvgc	鸌
gwmo	鸍
mmwo	鸎
apfo	鸏
qtyo	鸑
lllo	鸓
fsho	鸘
hhwo	鸜
qyng	鸟
vqyg	鸠
cqyg	鸡
ayqg	鸢
kqyg	鸣
nqyg	鸤
arqg	鸥
ahtg	鸦
wbqg	鸧
xfqg	鸨
pqqg	鸩
dqyg	鸪
aiqg	鸫
hnqg	鸬
lqyg	鸭
kgng	鸮
mdqg	鸯
wycg	鸰
qayg	鸱
qkqg	鸲
qbqg	鸳
qynx	鸵
xxgg	鸶
rvyg	鸷
dmjg	鸸
tdqg	鸹
wsqg	鸺
teqg	鸼
wgkg	鸽
yoqg	鸾
iaqg	鸿
fpbg	鹁
gmyg	鹂
keqg	鹃
trxg	鹅
wwkg	鹆
usqg	鹇
uxhg	鹈
fhng	鹉
ajqg	鹊
alqg	鹋
djng	鹌
jxxg	鹍
eeqg	鹏
qeqg	鹐
ykbg	鹑
ovwg	鹒
pqbg	鹓
vijg	鹔
deqg	鹕
jqwg	鹖
kkfg	鹗
meqg	鹘
toqg	鹙
uxxg	鹚
nhqg	鹛
cnhg	鹜
gkmg	鹝
ermg	鹞
qyvg	鹠
uwlg	鹢
uvog	鹣
pwyg	鹤
atdg	鹥
mmvg	鹦
oaog	鹧
nweg	鹨
dujg	鹩
wyog	鹪
ykig	鹫
khtg	鹭
lgkg	鹮
owwg	鹰
qync	鹱
apfg	鹲
akkg	鹳
fshg	鹴
hlon	鹶
hloc	鹷
hlow	鹸
hloo	鹻
hlra	鹾
onjx	鹿
onjw	麂
wvox	麄
onjt	麇
onjg	麈
ffox	麉
onjo	麋
onjd	麌
onjk	麍
onje	麎
ssox	麓
onji	麖
onjj	麘
onjy	麙
onjc	麚
onjs	麜
onjf	麝
onjh	麟
swwc	麬
swwa	麯
swww	麳
swwo	麴
gqfw	麸
gqqo	麹
gqdd	麺
ossi	麻
ossx	麼
ossn	麾
ossk	麿
ossm	黂
amwu	黄
amwn	黅
amwq	黆
amwk	黇
ipaw	黉
twiu	黍
tqti	黎
twik	黏
twic	黐
lfou	黑
jfou	黒
lfon	黔
lfoy	默
jfdo	黙
wayo	黛
lfom	黜
lfoe	黝
lfoq	黟
lfok	黠
ddyo	黡
lfot	黢
lfox	黣
lfoi	黥
lfob	黦
tqto	黧
lfod	黩
lfoa	黭
lfoj	黯
lfow	黰
djeo	黶
lfol	黸
ogui	黹
oguv	黺
oguy	黻
kjnb	黾
fwxf	鼀
jgxf	鼂
ffxf	鼃
rixf	鼄
tdkx	鼅
pjyx	鼆
umix	鼈
nkux	鼊
fqkn	鼋
jgkn	鼌
kkln	鼍
hndn	鼎
bhnn	鼐
hhnn	鼑
fthn	鼒
fkuc	鼓
fafc	鼖
qifc	鼗
fkuf	鼙
ijgc	鼝
fkuu	鼟
enun	鼠
enuy	鼣
enux	鼧
enuu	鼨
enug	鼪
enum	鼬
enuf	鼭
enup	鼮
enuk	鼯
enue	鼱
enul	鼲
enuw	鼶
enud	鼷
enuo	鼸
enuv	鼹
thlj	鼻
thlh	鼼
thlv	鼽
thlf	鼾
thlq	鼿
thlk	齁
thli	齂
thln	齃
thlg	齄
thlc	齆
thle	齈
yuho	齌
yuhl	齍
yuhm	齎
yjhg	齑
hbnn	齓
hbtn	齕
hbat	齖
hbrh	齗
hbwj	齘
hbtf	齚
hban	齛
hbck	齝
hbkw	齞
hobc	齢
udhb	齤
hbjx	齥
hbeg	齨
hbyr	齩
hbls	齫
hbrr	齭
hbdk	齮
hbeq	齯
hbaj	齰
hbbc	齱
hbpl	齳
hbue	齴
hbjy	齵
hbkn	齶
hbul	齸
ugab	齹
hbqt	齺
hbfw	齻
hbsh	齼
hbsi	齽
hagb	齾
hwbj	齿
hwbr	龂
hwbg	龃
hwbc	龄
hwbn	龅
hwbx	龇
hwbe	龈
hwbk	龉
hwbh	龊
hwby	龋
hwbf	龌
uega	龏
uegi	龒
fkkd	龗
dxyi	龙
dxyw	龚
wgky	龛
ttxg	龝
qjnb	龟
wgka	龠
wgki	龣
aaab	㐂
rvnv	㐆
vcnb	㐐
vknb	㐒
sknb	㐓
yknb	㐔
fknn	㐖
gknb	㐚
wdkn	㐛
giyv	㐜
rqkn	㐝
olnv	㐣
qegn	㐥
egnn	㐦
ynht	㐧
gbwi	㐪
yrbj	㐫
yckb	㐬
ylkf	㐭
ywae	㐮
wcgg	㐷
wqwy	㐸
wrnn	㐹
wbmh	㑁
wxet	㑃
wthg	㑅
wkqn	㑆
waiy	㑈
wmag	㑋
wagg	㑌
wdiy	㑍
wpfy	㑏
whgi	㑐
wcdc	㑓
wdmy	㑔
wmqy	㑕
wtmt	㑗
waah	㑘
wbnn	㑙
wrrh	㑜
wgah	㑝
woah	㑞
wrgw	㑟
wjcf	㑠
wvcb	㑡
walg	㑤
wjqr	㑥
wtbg	㑧
wktd	㑨
wlqy	㑩
wlgj	㑭
wplh	㑮
wcns	㑱
wfmf	㑲
wutd	㑵
wrno	㑶
wcex	㑷
wwyb	㑺
wpnm	㑻
wltk	㑼
wipf	㑽
wqyg	㑾
wvjs	㑿
wlff	㒁
wafj	㒂
wafy	㒃
wqdo	㒄
wyqe	㒅
wrlo	㒇
wips	㒉
wvyh	㒊
wadr	㒋
woow	㒌
wcci	㒍
wtqj	㒐
wogi	㒒
wfup	㒓
wlqj	㒔
wajy	㒖
wahu	㒘
wxrh	㒙
wean	㒚
wegw	㒜
waly	㒝
wmwm	㒞
whqg	㒠
weri	㒡
wown	㒣
wbbb	㒤
wmdu	㒥
wllf	㒦
wetn	㒨
wxgj	㒩
wahe	㒪
ghfq	㒫
fqgd	㒬
kqkq	㒭
fqge	㒮
igqf	㒯
tyaf	㒰
tyqu	㒱
tybm	㒴
muwn	㒺
jhqb	㒻
amhy	㒼
cccq	㓄
uwxn	㓆
uawy	㓋
uwgg	㓌
uycq	㓍
uvpc	㓎
umwk	㓏
ujaf	㓖
udhi	㓗
fjjh	㓝
dhvt	㓞
hcjh	㓟
hkjh	㓠
rmjh	㓡
tkjh	㓢
fkjh	㓤
ivjh	㓥
djjh	㓦
yvcv	㓪
udvj	㓬
jqwj	㓭
mfkj	㓮
vljh	㓯
ynmj	㓲
jghj	㓳
kkfj	㓵
thsj	㓷
nngj	㓸
dooj	㓹
hayj	㓺
lghj	㓻
swij	㓼
mpfj	㓽
twij	㓿
jykj	㔀
xqcv	㔃
sojh	㔄
vfjj	㔅
wxwj	㔇
ahdj	㔈
ntkj	㔉
ylkj	㔊
bcij	㔌
btwv	㔎
tghj	㔐
awnv	㔑
mwyj	㔒
tfet	㔓
ekkf	㔔
xjet	㔗
bmet	㔘
uaet	㔙
tdet	㔚
fker	㔛
ebet	㔜
gmhe	㔝
tgve	㔟
jqwe	㔠
xqce	㔢
llle	㔣
ptoe	㔤
lcee	㔥
ugwe	㔦
quxe	㔨
xjfj	㔬
awkd	㔯
aqhi	㔰
aewi	㔱
awyv	㔲
awyw	㔳
annw	㔵
aujm	㔶
arhw	㔸
dhfj	㔻
hlkf	㔽
gnhk	㔿
dgak	㕃
dgxi	㕄
dyei	㕈
dwyd	㕍
dfkf	㕑
cwty	㕙
cyyi	㕚
khcu	㕜
nmhc	㕞
hmac	㕟
kwyy	㕨
kdhh	㕩
kpqn	㕪
ktdy	㕭
kwry	㕮
krbh	㕳
kpwn	㕴
ydhk	㕻
ikxb	㕾
kvgh	㖀
krdc	㖁
kjxt	㖂
krgk	㖃
kyth	㖄
kmag	㖆
kdmj	㖇
kwhg	㖉
kvfy	㖊
wjkx	㖋
ufkx	㖍
kxwj	㖎
kkvt	㖐
kuxt	㖒
ktdh	㖓
kgdk	㖔
ufkf	㖖
kmwn	㖗
kdfe	㖘
ekkx	㖙
wfkx	㖚
dkxb	㖛
ykkx	㖜
fikx	㖝
kdfi	㖠
kohx	㖢
kukg	㖣
kbib	㖤
klty	㖥
kgji	㖦
kqaj	㖧
kviy	㖨
kbcy	㖩
kakg	㖪
kfwt	㖫
kecy	㖬
kgdn	㖭
mgkx	㖯
kxmk	㖰
vkkx	㖲
ivkx	㖳
kaqr	㖴
ksfg	㖶
kjgh	㖷
kwvl	㖹
kdwj	㖺
kcns	㖻
kafs	㖼
kkut	㖾
kbbh	㖿
kmxx	㗀
kith	㗂
knnj	㗃
knhc	㗇
kcee	㗈
kpgf	㗌
ktjg	㗍
keks	㗎
kdyl	㗐
kwnp	㗓
kamf	㗕
keeg	㗖
kerf	㗗
kgef	㗘
kqbt	㗙
kttd	㗛
kyxl	㗜
kugo	㗝
kdhc	㗞
iygx	㗟
vckx	㗠
ktge	㗢
kaqh	㗣
dhgk	㗤
kbqb	㗦
atdk	㗨
knrg	㗩
khxi	㗪
kwfi	㗫
kton	㗭
qkow	㗮
ftjx	㗯
ktwh	㗰
kwys	㗱
kvfg	㗲
ktwk	㗳
kueg	㗴
koow	㗵
kwxc	㗶
kpam	㗷
ktrs	㗸
kgdd	㗺
kmnp	㗻
kogi	㗼
xtyk	㗽
kakx	㗾
kusk	㗿
keoy	㘀
kuxn	㘂
ksly	㘄
ktqs	㘅
koos	㘇
kxth	㘈
ktvb	㘉
kfyg	㘊
kahm	㘋
kiwa	㘍
kcor	㘐
kffi	㘑
ttgx	㘒
kugi	㘓
kaal	㘕
kutm	㘖
yxxk	㘘
kkkt	㘙
kwgd	㘛
lnte	㘠
lked	㘣
lijg	㘤
leri	㘥
fxxn	㘩
fqcy	㘬
ftet	㘯
fmfg	㘱
fnvn	㘲
uxff	㘳
fdmh	㘵
qahf	㘶
fary	㘷
gqxf	㘸
fway	㘺
fldy	㘻
fftn	㘼
ffxy	㘽
ftxy	㙁
fukq	㙂
frgw	㙃
fxxf	㙄
fksy	㙅
fdey	㙊
fadw	㙋
fvij	㙌
fccc	㙍
fdgy	㙎
ftjt	㙏
fmdj	㙐
tkmf	㙑
lcnf	㙒
fnkh	㙔
fleg	㙕
ftky	㙖
flge	㙗
fsvg	㙘
idnf	㙙
ykmf	㙜
feee	㙝
fths	㙞
atdf	㙠
ftwh	㙡
famy	㙢
fxde	㙣
fhaf	㙤
fgjl	㙧
fxxy	㙨
fdui	㙩
fwys	㙫
fduw	㙭
ftwk	㙮
fwfc	㙯
kgnf	㙱
fyxy	㙲
fqdy	㙴
fykf	㙵
fjxo	㙷
fwow	㙸
falq	㙹
fakm	㙺
fojf	㙻
fddj	㙽
ferb	㙾
fhaa	㚀
fgke	㚂
fpru	㚃
rbwt	㚇
bqqu	㚉
qqyw	㚊
qqmk	㚋
qqjs	㚌
qqkm	㚍
dtyy	㚒
dxjj	㚕
fwfw	㚘
ekdu	㚙
dqkf	㚚
dwff	㚝
dssu	㚞
qkxd	㚟
dskk	㚡
vayy	㚤
vgjh	㚦
vnfh	㚨
vtfn	㚪
vbyy	㚫
vqug	㚬
vpwn	㚮
vwry	㚯
vdhg	㚰
vhkg	㚲
vekg	㚳
vdmh	㚴
vtuy	㚵
vhnn	㚶
vwiy	㚷
vngk	㚸
vqtb	㚹
vbbg	㚺
agnv	㚽
vkqn	㚾
vqnn	㚿
vqvg	㛀
vguf	㛁
vrcn	㛂
dhvv	㛃
vyey	㛄
vbsy	㛆
vofg	㛇
vftn	㛈
vwsy	㛊
vwny	㛋
vctg	㛌
vdww	㛍
vkkg	㛎
vgiy	㛏
vgjr	㛐
hqcv	㛑
vgku	㛒
vrdh	㛓
vtdh	㛔
vkcn	㛕
vcwt	㛖
vfpb	㛘
vufh	㛙
vceh	㛚
vtmt	㛛
whtv	㛜
vqmd	㛟
vujg	㛠
vpfq	㛡
vtbt	㛢
vkmy	㛣
vssy	㛦
vmdg	㛧
vufq	㛨
vyce	㛩
vdjn	㛪
vjqr	㛫
vfwf	㛬
vajg	㛭
vpoc	㛮
vqke	㛯
vnnj	㛰
yupv	㛳
vvtr	㛴
vemf	㛵
vmdo	㛶
tdnv	㛷
vfku	㛸
vwgr	㛹
vpoy	㛽
vgkh	㛿
vshg	㜀
vsjg	㜁
fffv	㜂
vwtj	㜄
vyxl	㜅
vopy	㜆
vvkc	㜉
vnae	㜊
vuwl	㜋
vovk	㜍
vexd	㜎
vmgu	㜐
igev	㜑
veah	㜒
vawk	㜓
vlpy	㜕
vgmj	㜖
vhag	㜘
vonx	㜙
vpwj	㜚
vlqw	㜛
vgqt	㜜
lrvf	㜞
vnbt	㜟
vtwh	㜡
vlvg	㜢
vqdo	㜣
vsjf	㜤
vlmy	㜥
vvaf	㜦
vduw	㜧
vnig	㜨
vtmd	㜩
vqdy	㜬
vipl	㜭
vahl	㜮
vaho	㜯
vrxs	㜰
vrrm	㜱
vyny	㜲
vyle	㜳
valh	㜴
xgwv	㜷
vhhy	㜹
vtfm	㜺
vyxn	㜻
bcnh	㜿
qjbf	㝁
brrh	㝂
bqkq	㝃
bfkk	㝆
yxxb	㝈
pqyu	㝌
pwjj	㝏
pwcu	㝐
pncu	㝕
pqqu	㝖
pyve	㝗
pggw	㝙
pthp	㝚
pgfg	㝞
pghq	㝟
ptky	㝢
pdhd	㝣
pamf	㝤
pnho	㝥
pwyb	㝦
pfke	㝨
povi	㝩
pfuy	㝪
pbtg	㝫
pdhw	㝬
pnjg	㝭
pbmc	㝮
ptdk	㝯
pthy	㝰
pnhq	㝱
pnhh	㝲
jgfu	㝵
lqfu	㝶
vavf	㝷
irqb	㝸
uvot	㝺
dnii	㝽
dnjx	㞁
dnev	㞂
wwky	㞃
dnle	㞇
dnya	㞈
dnua	㞉
nvyi	㞍
ntpi	㞏
nffn	㞑
nthd	㞒
nxjd	㞓
nqqi	㞔
nwed	㞕
ngmi	㞖
ntfi	㞙
ntfe	㞚
ntxj	㞛
nttv	㞜
dhgn	㞝
nusd	㞟
naae	㞡
bhgd	㞢
bhwv	㞣
mtyu	㞥
mwyu	㞩
mqyu	㞮
mtfh	㞰
mkhh	㞲
mufh	㞳
mqan	㞴
bhgf	㞷
mdhu	㞸
mskg	㞹
mtdu	㞺
mkgn	㞻
bimj	㞼
mnxn	㞾
mfru	㞿
mdfh	㟁
mngk	㟃
mugh	㟄
mrbq	㟅
mwwf	㟇
mptg	㟉
mebg	㟊
mukq	㟋
mevg	㟎
mayn	㟐
mfpb	㟑
mrdh	㟓
mkuf	㟕
mgaj	㟖
mwvv	㟗
majg	㟙
sfcm	㟚
mraf	㟛
mxqi	㟜
maay	㟞
mawb	㟟
mmum	㟠
mudb	㟡
mviu	㟤
mcde	㟥
mplj	㟦
mmdj	㟨
nnam	㟩
mnnj	㟭
mptk	㟯
mpjw	㟰
mugo	㟱
mdri	㟲
mlgh	㟵
mawk	㟷
mrdf	㟸
mbqb	㟹
mlvf	㟺
lrmj	㟻
mgqt	㟼
msfi	㟽
movh	㟾
wvgm	㠀
myud	㠃
mnrf	㠄
mttt	㠅
mkkl	㠆
myky	㠇
mugg	㠈
mhag	㠊
madw	㠌
mwys	㠍
maaf	㠏
mtdk	㠐
msfj	㠒
mnkf	㠔
mbtc	㠕
mtmd	㠗
megw	㠘
myke	㠙
mogf	㠚
mawc	㠛
mfwm	㠝
tmgm	㠞
mtqi	㠟
mhal	㠠
myce	㠡
mrqe	㠢
mdth	㠣
mllf	㠥
mmdu	㠦
mosd	㠧
msrf	㠨
wnkb	㠩
uoga	㠮
hnnd	㠯
nadw	㠱
mhxn	㠲
mhvy	㠴
mhtw	㠶
mhby	㠷
mhfw	㠸
mhwj	㠹
mhit	㠺
ftmh	㠻
mhrh	㠼
mhtu	㠽
hxmh	㠿
umii	㡀
mhdn	㡁
mhqj	㡄
mhqq	㡅
mhbn	㡇
mhxx	㡉
mhqe	㡊
mhje	㡌
mhuj	㡐
tomh	㡑
mhpl	㡓
mhuo	㡘
mhtx	㡙
mhaf	㡚
mhak	㡛
mhwi	㡜
mhtp	㡝
mhlv	㡞
mhgj	㡟
mhwu	㡠
yupd	㡣
mhoi	㡤
mhen	㡥
mhpm	㡦
mhet	㡪
xjqn	㡫
xxaq	㡬
xxgn	㡭
xxdn	㡮
otav	㡯
oqyi	㡱
oqav	㡳
okwi	㡶
oegd	㡹
ojgd	㡺
oqtb	㡻
ojxe	㡼
ovgk	㡽
ovei	㡾
oubt	㡿
ogmi	㢀
oqqi	㢁
ogku	㢄
ogak	㢅
ojfd	㢆
owyd	㢈
odsk	㢊
owqq	㢋
obsk	㢌
otfe	㢎
ohag	㢒
otwh	㢔
oxty	㢕
oake	㢙
ohae	㢚
owgw	㢛
oaln	㢜
oqot	㢝
onlw	㢞
imka	㢢
aqka	㢣
sksy	㢦
xnna	㢯
xxgw	㢲
xtey	㢳
xlry	㢴
xmqy	㢷
xxty	㢸
xuvg	㢺
xumi	㢼
xbxn	㢽
xgkh	㣂
xycx	㣃
xias	㣄
xaqj	㣅
xgwg	㣆
fjye	㣋
cket	㣍
rier	㣎
djfe	㣏
riet	㣐
ulje	㣒
taay	㣤
twff	㣥
tvdg	㣨
tssy	㣩
tegc	㣪
tkbg	㣬
tfmf	㣮
tnie	㣯
tton	㣰
tgmy	㣱
trlo	㣳
tfup	㣵
tylg	㣶
tpns	㣷
togg	㣸
town	㣹
nvyy	㣼
ncyy	㣾
nqyy	㣿
bynu	㤂
ngmh	㤄
aqnu	㤅
nrcy	㤆
naht	㤉
nrry	㤊
nafg	㤌
eknu	㤎
ntuy	㤏
hknu	㤐
ndkg	㤑
ndfh	㤒
nwfy	㤔
nbmh	㤕
npsh	㤖
dwnu	㤗
mngn	㤙
ntgs	㤚
nycq	㤝
npta	㤞
manu	㤟
gqjn	㤠
ngqj	㤡
ndeg	㤢
njry	㤤
nynw	㤥
ngkr	㤦
nrgk	㤧
nawy	㤨
gqbn	㤪
denu	㤫
nffg	㤬
ntdj	㤭
nmwk	㤯
wthn	㤰
ngku	㤱
ndhk	㤳
nbnn	㤴
btnu	㤵
nwyk	㤷
nfoy	㤸
qytn	㤻
ndtf	㤽
npws	㤾
ndjn	㤿
nfhg	㥀
njgf	㥂
nfwt	㥄
nepc	㥅
nviy	㥆
mhhn	㥈
nukg	㥉
wyen	㥋
nqoy	㥌
nmaw	㥏
depn	㥑
nesy	㥒
ndsk	㥓
nyce	㥔
oonu	㥕
njyy	㥗
nkhn	㥙
newy	㥚
nbkg	㥛
nleg	㥜
nxbg	㥝
nuey	㥞
nxge	㥟
nnhe	㥠
nnxs	㥡
nusg	㥢
dffn	㥣
njmy	㥥
novg	㥪
nykj	㥫
nyuy	㥬
ndwi	㥭
eavn	㥯
nehc	㥰
nahd	㥱
ndri	㥳
nrhw	㥴
nnan	㥸
owvn	㥹
nfcl	㥺
dtxn	㥻
ngho	㥼
ngmy	㥽
gqtn	㥿
lpnu	㦁
ipkn	㦂
naqh	㦅
nhaf	㦆
nonx	㦇
nugl	㦈
nagf	㦊
nkkt	㦍
nvfg	㦎
nnnw	㦏
nafy	㦐
nnbt	㦑
nlyg	㦒
nqdo	㦓
jedn	㦔
nbtg	㦕
nuny	㦖
nssi	㦗
rytn	㦘
njmn	㦙
udnf	㦚
ejfn	㦟
nogf	㦠
nrxs	㦡
ntvb	㦢
tnkn	㦣
npdn	㦥
nueq	㦦
nugi	㦨
nben	㦩
nyoc	㦪
ntfm	㦫
nlxy	㦬
nfkw	㦭
acgd	㦯
fqxy	㦲
atkd	㦴
riay	㦵
ceha	㦷
hjfa	㦸
jgqa	㦹
dfea	㦺
nray	㦻
dwea	㦼
deav	㦽
ynbv	㦾
ynsi	㦿
ynld	㧂
rnhh	㧃
rmgg	㧇
rgmh	㧊
raht	㧎
rqtb	㧕
hxrj	㧘
rntt	㧙
jtyr	㧛
ramh	㧜
ekrj	㧝
rtdc	㧞
rciy	㧠
rynw	㧡
rriy	㧣
rycq	㧤
rtfq	㧥
rqjg	㧦
ryck	㧧
rrgk	㧨
rwgh	㧩
rqdb	㧪
rdmj	㧫
abrj	㧭
rftx	㧯
rtni	㧰
rpsy	㧲
rdhk	㧵
rtmt	㧶
rgdk	㧷
rykb	㧸
rjgf	㧹
rldg	㧽
rtgi	㨀
rfhg	㨁
rgji	㨂
ihcr	㨇
ryjg	㨈
rnnj	㨉
rdae	㨊
fprc	㨌
fffr	㨍
rdmd	㨎
rmdo	㨏
rwks	㨐
rbcl	㨕
rgct	㨖
rhvh	㨗
rith	㨘
rexd	㨙
rhay	㨜
rnie	㨝
rgxi	㨞
rmgu	㨟
rpjw	㨠
rcex	㨢
rxmw	㨥
rqyl	㨨
rotp	㨩
rjiq	㨪
rjtl	㨫
rfke	㨬
rync	㨭
rrqq	㨮
rywe	㨰
raps	㨲
rfjn	㨴
ruev	㨵
rpnm	㨸
rdhv	㨹
lrrj	㨻
ltkr	㨼
rugi	㨾
rqef	㩂
rpau	㩃
rmln	㩄
rgjl	㩅
ryky	㩆
rvfg	㩇
rvfj	㩋
rxjm	㩌
rjey	㩎
rlfo	㩏
rtff	㩐
rgdd	㩑
rssi	㩒
eawr	㩓
rnac	㩔
rfwc	㩕
rglg	㩖
rmwb	㩗
rpaf	㩙
rlgf	㩛
rahl	㩜
rpas	㩟
rddd	㩡
raly	㩢
rnpl	㩣
rget	㩤
rjai	㩧
rdhn	㩨
rxim	㩩
rxdm	㩪
rrrm	㩫
rhaa	㩬
rerb	㩭
regr	㩮
rtxi	㩯
raks	㩰
raky	㩲
rhhy	㩴
rpao	㩷
rllg	㩸
xxfc	㩺
qdbc	㩻
tfac	㩾
tnty	㩿
gfty	㪀
rnhc	㪂
skhc	㪃
xjty	㪄
gmwc	㪅
qayc	㪆
ffhc	㪈
vtkc	㪊
jfhc	㪋
cehc	㪌
fpbt	㪍
yndc	㪐
djnc	㪑
eqhc	㪒
tfuc	㪓
sshc	㪔
hjfc	㪕
ukhc	㪗
jsty	㪙
adwc	㪛
mdmc	㪜
glic	㪝
ykjt	㪟
uvoc	㪠
pdhc	㪡
ehcc	㪢
jaft	㪤
pgmt	㪦
vfjc	㪩
gdhc	㪪
halc	㪭
fkkc	㪮
yqmd	㪱
fquf	㪴
djuf	㪶
lvuf	㪹
dhhf	㪺
skrh	㪼
gjrj	㪽
tkrh	㪾
btbr	㪿
jjrh	㫀
xxgr	㫁
oaor	㫂
ywfj	㫅
yrkh	㫊
yrhg	㫌
ytpl	㫎
ytsv	㫏
jgqb	㫕
jkqn	㫛
jbhc	㫞
jwkg	㫟
jtuu	㫡
jjnb	㫣
jpvg	㫨
fajf	㫩
dwhj	㫪
jgog	㫫
jqjg	㫬
jffu	㫭
jjgq	㫯
jfpb	㫲
jvph	㫶
jrnr	㫹
jrmj	㫼
jviy	㫽
jimk	㫾
jiwk	㬁
jjmy	㬂
jcko	㬃
jlyr	㬅
jnnj	㬆
jqmd	㬇
jwnd	㬋
jyji	㬌
jgef	㬍
jgoj	㬐
jpyg	㬕
jynk	㬖
jyct	㬚
jwgn	㬛
julj	㬝
jmjn	㬞
qruj	㬟
jqvo	㬠
jfwc	㬡
jjxo	㬤
jbmo	㬥
jbmi	㬧
jfoo	㬨
jdhn	㬩
akuj	㬫
gjrl	㬲
etfh	㬳
eawy	㬴
etfk	㬶
elsy	㬷
eawx	㬸
eqvh	㬹
eayk	㬻
dett	㬼
atde	㬾
eykt	㬿
snfh	㭄
bgsu	㭆
scqn	㭇
snwy	㭈
sthn	㭊
sdhh	㭋
stgh	㭌
sfnh	㭏
dgsu	㭐
scah	㭓
swgk	㭘
sffy	㭙
stey	㭚
srey	㭛
sadt	㭜
ssvb	㭝
stfq	㭠
stlr	㭡
sqyg	㭤
sqmy	㭥
sahb	㭨
sefy	㭩
skej	㭭
svgq	㭮
sbnn	㭯
hxgi	㭰
salh	㭱
swwk	㭲
sftb	㭳
sqlg	㭵
sayt	㭶
slet	㭷
sxyx	㭹
sdjn	㭺
simk	㭻
sijg	㭼
soqy	㭽
snbm	㭾
sjqb	㭿
sbib	㮀
srde	㮁
hdsu	㮂
stvg	㮃
sfqy	㮄
swug	㮆
sdfi	㮈
sdeb	㮋
uejs	㮍
sdhl	㮎
sith	㮐
stfe	㮑
ssfg	㮒
sngg	㮓
stgf	㮔
sdmd	㮕
sakf	㮖
hlws	㮚
sanf	㮜
suqk	㮞
sdsy	㮟
saps	㮠
swnd	㮢
vcas	㮣
scdl	㮥
sfpi	㮦
swno	㮧
slwt	㮨
saws	㮪
sclf	㮭
sdhr	㮮
stlx	㮰
sqbt	㮲
seud	㮳
sehc	㮴
syty	㮵
sube	㮶
sdnj	㮷
sudp	㮸
scyj	㮻
stec	㮽
yvcs	㮾
sjaf	㮿
sbuk	㯁
saqh	㯂
sswi	㯃
ssrc	㯄
sorf	㯅
sutg	㯆
shdf	㯇
sgkp	㯈
shaf	㯉
sgho	㯊
xsdm	㯋
sysy	㯎
bdas	㯐
sxde	㯑
sehq	㯒
sadr	㯕
sfln	㯖
syct	㯙
stwk	㯚
sayf	㯜
skhk	㯝
sxke	㯞
ssvi	㯟
syxg	㯠
swin	㯡
snnw	㯢
gjii	㯥
sads	㯦
sfwc	㯪
shae	㯫
ssvp	㯬
slqj	㯮
stam	㯯
slfh	㯰
saqt	㯳
sapk	㯴
sobt	㯶
swow	㯷
svhl	㯸
ahns	㯺
safl	㯼
sgmp	㯾
svln	㯿
stqi	㰀
sddd	㰁
sptl	㰂
srmi	㰃
smaa	㰄
syup	㰅
sslp	㰈
sfwo	㰊
shhm	㰋
uegs	㰍
smwm	㰎
styk	㰏
sbdp	㰐
snns	㰑
serb	㰒
sahm	㰓
syoc	㰔
sahq	㰖
sxga	㰘
saky	㰙
syry	㰚
sars	㰛
sfhm	㰜
nnqw	㰝
mqwy	㰞
rnqw	㰟
gaqw	㰢
hxqw	㰣
skqw	㰤
anqw	㰥
fcqw	㰦
ckqw	㰧
kwqw	㰨
ffqw	㰪
tfqw	㰫
qjqw	㰬
dfnw	㰭
dfew	㰮
gkuw	㰯
dwww	㰰
tfjw	㰱
thkw	㰶
gqxw	㰷
dgkw	㰹
nhfw	㰺
ajvw	㰽
ryqw	㰾
exdw	㰿
qbtw	㱀
bmfw	㱁
oviw	㱂
fpgw	㱅
depw	㱊
fwyw	㱋
bbbw	㱌
yxxw	㱍
liqw	㱎
fhyi	㱐
hskf	㱒
hwyc	㱓
hxqu	㱔
hvph	㱕
djeh	㱘
gqgn	㱙
gqhy	㱜
gqxe	㱝
gqug	㱞
gqhc	㱟
gqye	㱢
gqev	㱣
gqdk	㱦
gqpb	㱧
gqph	㱨
gqfd	㱩
gqnj	㱪
gqle	㱬
gqmu	㱯
gqrc	㱱
ajdq	㱳
gqgm	㱴
gqfe	㱶
gqws	㱷
gqnf	㱸
gqhl	㱺
nnwc	㱼
pqwc	㱽
yntc	㱾
fmgc	㱿
dfec	㲀
pwac	㲁
imkc	㲂
hjxc	㲃
fnwu	㲇
qkxx	㲋
tfnb	㲌
fctn	㲍
qktn	㲒
uftn	㲔
eftn	㲕
ietn	㲖
ebtn	㲗
mtfn	㲘
tdkn	㲛
ootn	㲜
amdn	㲟
ehcn	㲣
ykgn	㲤
ovhn	㲥
abtn	㲨
ogun	㲫
wyon	㲬
ooon	㲭
pnln	㲰
qayw	㲳
rnho	㲶
rnkl	㲷
ivyy	㲽
idwy	㳁
iqwy	㳄
idhy	㳅
iufh	㳆
idmh	㳍
icah	㳎
ikry	㳏
isnn	㳐
idkg	㳓
icfy	㳔
iudg	㳕
iyey	㳖
icyf	㳗
iceg	㳙
iewy	㳛
ifpy	㳡
iftx	㳣
iuay	㳤
iaah	㳦
ibnn	㳧
ivgq	㳨
iamy	㳩
idhk	㳪
itnh	㳬
iksy	㳭
iniy	㳮
ibjg	㳱
idqn	㳳
itbg	㳵
iqrj	㳷
iajg	㳻
akgi	㳼
ixti	㳽
iufq	㳾
iycs	㳿
iatp	㴀
igdj	㴁
iamf	㴂
imwg	㴄
ilwk	㴅
irgm	㴈
iccf	㴉
iubj	㴊
ivij	㴋
ivdg	㴌
ibdi	㴍
idfi	㴎
ipwg	㴏
ihgn	㴐
iout	㴑
ilny	㴓
iqvn	㴔
iakf	㴖
isvg	㴗
ijhg	㴘
itfe	㴙
iuey	㴚
igct	㴛
iyna	㴜
tjwi	㴝
iehj	㴞
idjb	㴟
ibkb	㴠
iiwh	㴢
iigw	㴣
isyg	㴤
imie	㴥
ivkc	㴩
iths	㴪
itmf	㴬
ipwh	㴭
inie	㴮
iexj	㴯
icex	㴰
irhw	㴲
ifdy	㴳
iogn	㴴
intl	㴵
ibpq	㴷
iuwy	㴸
iopy	㴹
igkf	㴻
ipwj	㴼
iton	㴽
ifpt	㴾
isdm	㴿
iytd	㵀
ioao	㵂
ijpx	㵃
iakd	㵄
iwym	㵅
itdf	㵇
iivd	㵈
ijbc	㵊
ilmy	㵋
iuny	㵍
iayf	㵏
iduw	㵐
iekm	㵑
ixjm	㵒
idfj	㵔
iccn	㵕
ivki	㵖
ucoi	㵗
ifkk	㵙
iwrq	㵚
iugk	㵛
iyek	㵝
ipwm	㵠
ijqw	㵣
indw	㵤
ipnl	㵥
idap	㵦
iajn	㵧
iaas	㵩
ibbj	㵫
iebl	㵬
ifto	㵭
idag	㵮
iwdo	㵯
irlh	㵲
ipne	㵳
ibci	㵵
imad	㵹
ieec	㵻
ipeo	㵼
illl	㵽
irrr	㵿
iene	㶀
iiro	㶃
iuqe	㶄
ierb	㶅
iyfj	㶆
iooj	㶈
iexg	㶉
iahm	㶊
iogg	㶋
ibxg	㶌
ilgp	㶎
iben	㶏
iown	㶐
iuco	㶒
iady	㶓
illd	㶔
ituj	㶕
iwho	㶖
txxi	㶗
itsf	㶘
iiog	㶙
isae	㶚
iytw	㶛
inuj	㶜
iion	㶝
ijye	㶞
illi	㶟
icof	㶠
opqn	㶩
duou	㶫
oxet	㶭
gmwo	㶮
osgg	㶱
oehh	㶲
vgou	㶳
oqqy	㶴
opey	㶶
oqjg	㶷
oaiy	㶹
ogdk	㶺
tdho	㶻
octd	㶼
okmw	㶽
ofpb	㶿
oonf	㷀
oceh	㷁
ahno	㷂
odeu	㷃
ownf	㷆
nfof	㷉
ovph	㷌
ojqn	㷎
ttfo	㷏
oefg	㷐
osff	㷑
oehj	㷔
thno	㷗
ocks	㷘
oyod	㷜
odjb	㷞
ownp	㷟
ooqh	㷠
hano	㷡
ougg	㷣
oobg	㷥
boou	㷦
odri	㷧
omth	㷨
owyb	㷪
fnwo	㷫
ofdg	㷯
oyrc	㷰
cefo	㷱
otge	㷲
dtto	㷴
olfo	㷵
onnw	㷷
orlo	㷻
oykf	㸀
oogi	㸁
uepo	㸂
lfho	㸃
oyuj	㸄
otvb	㸅
otfd	㸆
ofwm	㸇
ufoo	㸉
ofwy	㸌
ohaa	㸍
obbb	㸎
tudh	㸔
wreg	㸖
wrmk	㸗
wrls	㸘
wrfj	㸙
thgw	㸝
ahyi	㸦
tnhh	㸨
tgmh	㸬
tpxn	㸰
dtgj	㸴
dhvg	㸷
trgk	㸸
tefy	㸹
tctd	㸻
ttdh	㸼
tvyn	㸾
tfpw	㸿
tfpb	㹀
tplh	㹆
tjqn	㹇
fitg	㹈
tdri	㹉
twhe	㹋
tyud	㹍
tooh	㹙
took	㹚
tdht	㹛
qtqa	㹝
qtnw	㹟
qtyx	㹡
qtek	㹢
qtmg	㹨
qtcf	㹩
qtgw	㹫
qtgr	㹬
qtiq	㹰
qtfb	㹲
qtrq	㹸
qtij	㹺
qttv	㹻
qtqo	㹼
qtaa	㹽
qtvr	㺁
qtak	㺃
qtym	㺆
qtun	㺊
qtuo	㺌
qtlv	㺏
qtvs	㺐
qtce	㺑
qtne	㺒
qttl	㺕
qtkl	㺗
qtwo	㺘
qtew	㺞
qtpy	㺠
qtbg	㺦
qtkk	㺧
gnhh	㺩
gfnn	㺮
wbgy	㺱
gnfg	㺲
gqwy	㺵
gufh	㺶
gcah	㺹
gnhy	㺼
gmkg	㺾
gahh	㺿
gjry	㻀
glkg	㻁
guah	㻂
magy	㻃
gtgh	㻄
gwfc	㻅
gceg	㻆
gwgg	㻇
ghht	㻉
gqkq	㻊
ggki	㻋
gwgs	㻌
gvoy	㻏
glty	㻒
gbcy	㻓
gtfg	㻔
gnbm	㻕
gpjh	㻘
gyce	㻙
gjqr	㻛
gwwh	㻜
ggkj	㻝
gdae	㻟
gpwy	㻠
gans	㻡
gytb	㻢
gusg	㻥
gjmy	㻦
guvo	㻩
gwyb	㻪
gjaf	㻫
gffn	㻬
gyxf	㻭
gwfi	㻮
ghaf	㻯
gdhv	㻰
glvg	㻲
gatj	㻳
gjlc	㻴
gnbb	㻵
gtvg	㻶
ggmi	㻷
gaqj	㻸
gykt	㻻
gsjf	㻼
gwym	㻽
glqj	㻿
gfup	㼀
gugy	㼁
egny	㼂
gvln	㼃
gxxl	㼄
glxy	㼈
rcyq	㼉
gbny	㼊
drcy	㼋
diry	㼍
rcyr	㼎
evry	㼏
gliy	㼑
rcyo	㼓
jlry	㼔
mhgy	㼙
qbgy	㼝
pxgy	㼠
rigy	㼡
ahky	㼢
djgy	㼣
ftgy	㼥
cehy	㼧
jsgy	㼫
fhky	㼭
gvhy	㼮
gjiy	㼯
rtfy	㼰
ayny	㼹
ovhy	㼺
twwy	㼻
ujfy	㼿
toly	㽃
afgy	㽍
iwgf	㽏
afuo	㽐
afsf	㽑
lywn	㽘
lcqn	㽙
ltgj	㽚
kklf	㽞
lefy	㽟
lqoy	㽤
oopl	㽦
luxx	㽧
luga	㽨
lcce	㽩
yxtl	㽫
lmwk	㽯
eenh	㽰
ugnv	㽲
ugfk	㽳
udyi	㽴
upqv	㽸
urci	㽹
ubyi	㽺
ufci	㽻
uxhk	㽼
ubmk	㽾
urcy	㽿
usyi	㾁
uckd	㾂
upxv	㾃
umfd	㾆
ugmi	㾊
uwsi	㾋
udmj	㾍
uhng	㾎
uvkd	㾒
uked	㾓
ujfd	㾖
ugjr	㾘
urdh	㾙
uhxf	㾚
uhhe	㾟
ufcb	㾡
upwa	㾤
uhgc	㾥
uukd	㾦
ujsi	㾧
utfx	㾩
uith	㾪
uyna	㾫
uxxr	㾬
utoi	㾭
urgd	㾮
uwfq	㾱
ugqt	㾲
uuqv	㾳
usjg	㾴
uyfk	㾵
umed	㾶
urhw	㾷
uhxs	㾹
ubws	㾻
uvep	㾼
uwnp	㾽
uuvo	㾾
uyvb	㾿
urdf	㿁
umgt	㿂
uaqh	㿃
uatc	㿄
uthh	㿅
utye	㿆
unrd	㿇
uxty	㿈
uaqj	㿊
ukks	㿋
uwgw	㿌
ufam	㿎
uvtg	㿏
ufhq	㿐
ufnf	㿒
udwh	㿓
ulll	㿔
uuqe	㿕
uhal	㿖
utwm	㿗
uook	㿘
ulxy	㿚
ugmx	㿛
utha	㿜
rqiu	㿡
jerf	㿢
rdwj	㿤
hcvy	㿪
xxhc	㿫
ryhc	㿭
mdhc	㿮
ywrc	㿰
rrhc	㿱
hcvl	㿳
dbhc	㿴
hcdd	㿵
yupc	㿶
ugac	㿷
hcjc	㿸
hcfp	㿹
galf	㿼
wgnl	㿽
pslf	㿾
pntl	䀄
pyfl	䀅
vhgl	䀆
drml	䀇
vcal	䀈
tdkl	䀉
inwl	䀊
fthl	䀋
ujfl	䀍
htfh	䀒
hvyy	䀓
hxhh	䀕
hgdy	䀖
hgah	䀘
havt	䀙
hqbj	䀚
hqrt	䀛
qrhf	䀜
hxxn	䀝
hufh	䀞
hxjh	䀟
hhkg	䀡
htdy	䀢
hntt	䀣
qhhf	䀤
htni	䀥
htdg	䀨
htkg	䀩
htgs	䀪
hwgk	䀫
hynk	䀮
hgey	䀯
hwwk	䀰
htdh	䀱
htxy	䀲
hgki	䀳
hgva	䀴
hctd	䀵
hyve	䀶
hfce	䀷
hdww	䀹
hmgn	䀻
hdfe	䀼
hthp	䀽
dchf	䀾
hrrh	䀿
hrrj	䁀
hyki	䁁
hfuf	䁄
hblg	䁅
hdjn	䁆
pnth	䁇
ynah	䁉
hcyh	䁊
hans	䁋
hleg	䁌
hyks	䁎
hsvg	䁏
hamd	䁐
hjgr	䁑
hkbg	䁒
hrbt	䁓
hegc	䁔
hnnj	䁕
hmgu	䁗
herm	䁘
hjpv	䁙
hkmy	䁚
hrqc	䁛
hjiq	䁜
ooph	䁝
huga	䁟
huvo	䁠
huwy	䁡
hyth	䁢
hgjf	䁣
hyud	䁤
haak	䁥
hakw	䁧
hqoy	䁩
hlrh	䁪
hlfo	䁫
hulj	䁬
haqj	䁮
hadm	䁰
hffq	䁱
hlmy	䁲
hada	䁳
hylg	䁴
hlge	䁵
hryt	䁶
hmae	䁸
hnkf	䁹
hlff	䁺
hrxs	䁻
hvln	䁽
haly	䁾
lfoh	䁿
hugy	䂀
hqky	䂁
helf	䂃
hhhc	䂄
hyxj	䂅
cnhy	䂆
dahs	䂋
cnhi	䂍
tdvk	䂏
tdbm	䂐
tdhx	䂑
tdfk	䂒
gwkf	䂖
dcyy	䂘
dcnh	䂛
dtuy	䂢
dhxn	䂣
dnna	䂥
dldy	䂩
dtah	䂫
dofg	䂯
dtjh	䂰
dukq	䂱
fced	䂲
dfce	䂶
dtfx	䂷
dqoy	䂹
djsy	䂺
dsww	䂾
dgvv	䃀
djxx	䃂
dmun	䃃
dyki	䃄
dulh	䃅
dxxr	䃈
dnnj	䃉
daeg	䃊
duey	䃍
djtg	䃏
dtec	䃑
damf	䃓
oopd	䃕
dwno	䃖
dvij	䃗
dahf	䃘
donx	䃙
dytd	䃚
dlpy	䃛
dftt	䃝
ykbd	䃞
daet	䃟
daqj	䃡
dqqw	䃢
deto	䃣
dvfj	䃤
btgd	䃧
dxkj	䃨
dmae	䃩
dylg	䃪
dqdy	䃫
dmrc	䃬
dfup	䃮
dris	䃯
dpwi	䃰
dtel	䃲
dvln	䃳
dyfj	䃴
dyce	䃵
dyle	䃶
dugi	䃹
dfae	䃻
pyhy	䃼
pyxx	䃾
pyay	䄀
pyan	䄁
pymd	䄃
udfi	䄅
pykg	䄇
pygu	䄈
pyfn	䄊
pydn	䄋
pycc	䄌
pyaj	䄍
pydk	䄎
pyad	䄏
pyqj	䄑
pywn	䄒
pyrg	䄓
pyil	䄕
pyjg	䄗
pygj	䄚
pylv	䄛
pyyc	䄜
pywi	䄞
pyyg	䄠
pyyj	䄢
pyfm	䄣
pygm	䄤
tayy	䄩
tgah	䄯
tmwy	䄲
txjh	䄶
tgxw	䄺
tgmg	䄼
tjxt	䄿
tgqj	䅀
pvtu	䅁
ttkg	䅂
awyt	䅃
teee	䅄
tuqw	䅆
tota	䅊
tqkq	䅋
ttbt	䅎
tntn	䅏
thqn	䅐
tevg	䅑
tayn	䅒
tqkc	䅓
tvlg	䅔
tndg	䅕
tdjn	䅖
tjjg	䅛
tdmy	䅡
tmeg	䅢
ttfe	䅤
talg	䅦
tyji	䅫
tuwl	䅬
tldn	䅰
tmgu	䅱
tfpi	䅴
tugo	䅵
tauf	䅸
tlvg	䅹
tjlc	䅼
fnwt	䅽
tlfo	䆀
touo	䆂
tuqm	䆅
tuxw	䆊
tqxg	䆋
tolw	䆏
pwsj	䆑
pwcq	䆓
pwnw	䆕
pwdc	䆖
pwlj	䆘
pwgh	䆙
pwmk	䆚
pwka	䆛
pwah	䆠
pwge	䆥
pwoo	䆦
pwtv	䆧
pwjd	䆨
pwhd	䆩
igqa	䆪
pwic	䆮
pwcv	䆯
pwak	䆰
pwio	䆱
pwoi	䆲
pwck	䆷
pwuf	䆹
pwhe	䆽
pwab	䇀
uufh	䇆
ucfg	䇈
uocy	䇊
uieg	䇌
ukhy	䇍
uajg	䇎
uykb	䇏
uviy	䇐
urtf	䇑
vcau	䇒
edmu	䇓
ufdj	䇕
tqtr	䇖
twcu	䇗
txhj	䇙
twhu	䇚
tqwu	䇜
taff	䇞
tqer	䇟
tygf	䇠
tpsj	䇡
ttah	䇨
tjxr	䇩
tahh	䇫
triu	䇬
tftx	䇭
tkej	䇷
tkgf	䇸
tvtk	䇹
tgku	䇺
tkcb	䇼
tgki	䇿
tmmj	䈀
tuaj	䈂
tivk	䈃
tbib	䈄
tecb	䈈
tuvf	䈉
tynh	䈍
tndo	䈐
twct	䈗
tckn	䈚
thmc	䈛
twvc	䈜
tykj	䈞
tmjj	䈟
tcks	䈢
tght	䈣
tqee	䈥
teto	䈧
tbve	䈨
txmw	䈫
trqc	䈭
tuqk	䈮
teef	䈱
ttec	䈲
tjnf	䈳
twcn	䈵
tstk	䈷
tqef	䈸
tsie	䈾
tpjw	䈿
toao	䉀
tbwc	䉁
tfuy	䉅
tadj	䉇
taet	䉈
tqey	䉉
tcdl	䉊
tvnh	䉋
tbue	䉌
tunu	䉍
tips	䉎
tqeg	䉏
ttol	䉒
tsjs	䉓
tgqa	䉔
tlwc	䉖
trkb	䉗
tspi	䉘
tffc	䉙
ttmd	䉛
trwc	䉟
ttmt	䉠
tfwk	䉢
teqo	䉣
tovt	䉤
trtn	䉥
tsdp	䉦
tqyj	䉧
tuec	䉨
tsak	䉩
tlll	䉪
ttqi	䉫
towc	䉬
tuwy	䉮
tahm	䉯
tmer	䉰
tpuk	䉱
txgr	䉲
tkkt	䉷
tudf	䉸
tfkw	䉹
uxou	䉾
owgh	䊃
oqkg	䊅
opsy	䊉
ontn	䊊
oudb	䊎
oimk	䊑
omeg	䊘
dgao	䊙
orsc	䊛
ogjf	䊜
oton	䊝
ofpu	䊦
oxjm	䊧
olhd	䊫
tjso	䊬
oyfj	䊰
soug	䊲
oosd	䊳
xftt	䊷
xgxg	䊺
xfwy	䊿
ynxi	䋀
xywn	䋁
xnyy	䋇
vcxi	䋈
xpwy	䋉
xskg	䋍
xjgg	䋎
xthf	䋏
xgny	䋐
xgmw	䋑
xcnt	䋒
wtfi	䋕
xvgh	䋖
xdiy	䋘
ynci	䋜
xivg	䋝
xmrr	䋞
xgey	䋠
xwgs	䋡
rrxi	䋢
xtxy	䋦
xndg	䋧
xukg	䋨
xeqn	䋩
xbsk	䋪
xqvh	䋫
xgdn	䋬
xyce	䋭
hdxi	䋰
xsww	䋱
xuxe	䋳
xcns	䋴
xrfh	䋸
xgkl	䋹
xtoy	䋺
xfmf	䋻
xbcl	䋼
xfff	䋽
xdqq	䋾
xtuf	䌀
xsvg	䌁
xngf	䌂
xgmc	䌄
xovk	䌅
xrqc	䌆
xfpi	䌇
xjng	䌈
xlgh	䌉
xerm	䌊
xawk	䌋
xnrg	䌌
ltki	䌎
xpnm	䌏
xehq	䌐
xahf	䌑
xonx	䌒
txwi	䌓
xoss	䌕
xwys	䌖
xrlo	䌗
xsoy	䌚
xogi	䌜
xssi	䌝
xwgw	䌞
xnkf	䌟
dgki	䌠
xmau	䌡
xfwc	䌢
xtpn	䌣
xgwr	䌤
xean	䌥
xfnf	䌧
xawi	䌨
xaly	䌩
xuqe	䌪
xahq	䌫
xued	䌬
xfsh	䌮
xaky	䌯
xbbb	䌰
xato	䌲
xnij	䌵
xesy	䌽
xjtl	䍀
rmgf	䍂
rmwc	䍅
rmps	䍆
rmkw	䍉
rmyr	䍊
rmuk	䍌
rmao	䍎
mjgd	䍏
mrrf	䍑
laht	䍓
ldcu	䍔
lqnb	䍖
ltxu	䍙
lyve	䍚
lldf	䍛
lwyf	䍜
lijf	䍝
mrrg	䍞
lrbt	䍟
lyrc	䍠
lrlo	䍢
lyuj	䍤
lyry	䍦
uggh	䍨
uggs	䍪
ugpx	䍫
ugxy	䍭
ugqi	䍮
ugqb	䍯
ugws	䍱
ugcc	䍳
ugtv	䍴
ugqh	䍵
uggi	䍶
ugnh	䍷
ugkn	䍺
ugdh	䍽
gang	䍾
mfng	䎃
vkng	䎄
teng	䎇
njxt	䎈
tkng	䎊
tfkn	䎋
nkhy	䎌
nijg	䎓
uljn	䎖
vfjn	䎘
pghn	䎙
ftxx	䎜
vdmj	䎟
dmjo	䎡
dink	䎤
dioo	䎦
diuk	䎧
didn	䎨
divl	䎩
dijf	䎪
dirt	䎫
ditp	䎭
diyd	䎮
diaw	䎯
bntt	䎵
bjhh	䎶
bgkg	䎸
tobf	䎹
brmj	䎺
bmfk	䎻
bviy	䎼
bqaj	䎽
btoy	䎿
bgkj	䏀
bpuf	䏁
behc	䏂
bpjw	䏃
bpwf	䏄
bwfi	䏅
bgmj	䏆
bsfi	䏇
bxxi	䏈
bued	䏊
enwy	䏐
qmww	䏑
ethn	䏒
mufq	䏓
enfg	䏔
exhh	䏖
ernn	䏗
eaqn	䏘
epqn	䏙
eitt	䏚
equg	䏛
ebyy	䏜
egsy	䏞
entt	䏟
ehcy	䏢
engk	䏤
emfg	䏥
etdg	䏦
eqqy	䏧
ewnn	䏨
ectg	䏬
eeiy	䏮
evyn	䏰
ennk	䏱
euxt	䏲
eieg	䏴
exxf	䏶
egkg	䏸
ehqn	䏹
etdh	䏺
eaay	䏼
eukg	䏽
edwg	䏾
edsk	䐀
eviy	䐂
elty	䐃
entd	䐅
eesy	䐆
eqrj	䐇
efhg	䐈
evlg	䐉
ejxx	䐊
ewcn	䐋
mawe	䐌
efku	䐍
ejgh	䐎
edwj	䐏
etoy	䐐
eans	䐑
edqq	䐒
eyna	䐔
ekbg	䐕
enoy	䐖
eftj	䐗
eegc	䐘
eakf	䐙
evcb	䐚
edbg	䐛
eimy	䐝
exuu	䐞
eamf	䐟
yuhw	䐡
eqbt	䐢
ekmy	䐣
euga	䐤
efcl	䐦
eykk	䐧
emgu	䐩
ewyb	䐪
etwh	䐫
egmj	䐬
eaqh	䐭
elxi	䐯
ewhe	䐰
enrg	䐲
eqoy	䐳
vcae	䐴
eamw	䐵
eaqj	䐶
evfg	䐸
evfj	䐹
esjf	䐺
eduf	䐻
edhi	䐼
eamy	䐽
etmd	䐿
enkf	䑀
erre	䑁
eegw	䑂
muae	䑃
ethj	䑄
ealq	䑅
euge	䑆
erxs	䑈
eyny	䑉
ekhp	䑊
eyke	䑋
eugi	䑌
emmv	䑍
ahni	䑐
ahnw	䑑
afpf	䑓
ejgr	䑗
tdeg	䑚
aooh	䑞
epqg	䑟
tecy	䑡
tegq	䑢
teet	䑣
teby	䑥
teqk	䑦
tetb	䑨
teqi	䑬
teia	䑭
tehh	䑰
tepb	䑱
tehf	䑲
teje	䑵
tepi	䑸
tepc	䑹
teyb	䑻
teqt	䑼
tejn	䑽
tepj	䑿
tenr	䒁
tenf	䒂
tefm	䒈
wgnc	䒊
mdqc	䒋
pjyc	䒌
adyc	䒎
uljc	䒏
uytg	䒑
angf	䒒
agnb	䒓
anfj	䒖
atnb	䒗
ahgf	䒙
aitr	䒚
axnb	䒛
atgj	䒜
arru	䒝
adhj	䒠
axhj	䒡
atpu	䒦
apvy	䒯
aagf	䒰
abig	䒱
avta	䒲
avbf	䒵
ajxr	䒶
adiu	䒹
axiu	䒺
amnb	䒻
amaf	䒼
amrr	䒽
ayeu	䒾
apef	䒿
akcb	䓃
aqtr	䓄
airj	䓅
arrj	䓆
afou	䓇
atwc	䓈
aahb	䓉
agkf	䓊
aiqa	䓋
afnu	䓌
adgn	䓐
aqlf	䓒
aftb	䓔
afqp	䓕
atfx	䓙
anbm	䓛
aiqy	䓜
ablf	䓝
amfk	䓟
aijf	䓠
aldf	䓢
agmy	䓣
abkg	䓧
aprm	䓨
asfc	䓩
ajqr	䓪
ahjf	䓬
arsj	䓭
agxu	䓯
ahxs	䓱
atve	䓳
admd	䓴
agkj	䓶
aits	䓷
avvf	䓸
awye	䓹
apfv	䓻
avdy	䓼
aiiv	䓾
aclf	䓿
awtv	䔀
apyg	䔃
aerm	䔄
amgu	䔇
aamu	䔈
agua	䔊
axit	䔋
arsg	䔌
acou	䔍
aiaa	䔐
abuk	䔒
aytf	䔓
aujq	䔔
aegy	䔕
abft	䔖
armg	䔘
aqqy	䔙
axdm	䔛
abmf	䔜
ahxi	䔝
ayxf	䔞
asie	䔠
awwn	䔢
ardj	䔤
avoj	䔥
astx	䔦
atjs	䔧
axty	䔨
agkt	䔩
anhi	䔫
apnh	䔭
apgl	䔰
arkb	䔱
awgu	䔲
aqdo	䔳
abmc	䔴
ausu	䔵
arjh	䔶
aggn	䔷
abde	䔺
avyh	䔼
aijn	䔽
arjn	䔾
ausf	䔿
affw	䕀
ahds	䕁
ackp	䕂
abwc	䕃
abil	䕄
avec	䕅
aswj	䕆
aorc	䕇
alff	䕉
aylg	䕊
afok	䕋
atwy	䕌
ayek	䕍
ajgl	䕎
augy	䕏
apyl	䕐
axev	䕑
apwi	䕓
aijc	䕕
abtp	䕖
athj	䕗
aydw	䕛
anyf	䕜
atef	䕝
auye	䕞
aemw	䕟
aowc	䕠
adua	䕢
apun	䕣
awwr	䕥
amer	䕧
arht	䕫
axgg	䕬
aotl	䕰
aoyi	䕲
axgr	䕳
atwo	䕴
afko	䕵
aosi	䕷
alfk	䕸
aogc	䕺
agmx	䕻
aaky	䕼
akhj	䕽
akkt	䕾
ajmn	䖁
ayxr	䖂
afkw	䖅
asge	䖆
asre	䖇
haxv	䖈
hawj	䖌
hati	䖍
bhaw	䖎
haqy	䖏
hagu	䖒
bmhw	䖓
hawg	䖕
hawl	䖖
hady	䖗
hawi	䖛
ynju	䖟
jwyy	䖠
jnfg	䖡
jitt	䖢
jrhy	䖣
jntt	䖩
hxju	䖪
jwfh	䖫
udju	䖭
ffju	䖯
jrey	䖰
jpta	䖳
trxj	䖸
jyck	䖻
jfcb	䖼
tjju	䖽
tqtj	䖿
jdsk	䗁
jaay	䗃
jwrr	䗄
jdey	䗅
jphn	䗆
jqoy	䗇
jynh	䗈
jafs	䗋
jsfg	䗎
jpoc	䗏
ytbj	䗐
juog	䗒
jfcl	䗘
pawj	䗙
jwhe	䗛
jqyl	䗜
pyjj	䗝
gdjj	䗞
jovh	䗤
jtdp	䗦
jovi	䗧
jdhy	䗩
oaoj	䗪
joss	䗫
jkkn	䗭
jdrr	䗮
jxfm	䗰
jogw	䗱
jwgu	䗳
jglg	䗵
jajn	䗶
jujn	䗷
yxtj	䗸
juxn	䗹
jtvb	䗻
xwyj	䗽
jpns	䗿
fwyj	䘁
jfhy	䘂
jpdn	䘆
jdae	䘈
jtly	䘊
jwwg	䘋
aadj	䘌
ajmj	䘍
jyxx	䘎
tlbh	䘏
tlyi	䘑
tlct	䘒
tlqe	䘓
tlpk	䘔
tyws	䘕
trms	䘖
tmts	䘗
tgxs	䘘
yefj	䘚
puxh	䘟
pudr	䘠
xxye	䘡
pups	䘢
puhx	䘣
pusy	䘤
punx	䘦
pumd	䘧
puqj	䘩
puyq	䘪
vkye	䘫
fwwe	䘮
puie	䘯
putp	䘰
puyf	䘹
puph	䘺
pupb	䘼
pueq	䘽
pupn	䘾
punm	䘿
puee	䙀
pute	䙄
pusv	䙅
puwd	䙆
purh	䙉
pugh	䙊
pued	䙎
puyl	䙒
pulc	䙓
puyd	䙗
puwu	䙞
pugd	䙣
pump	䙤
puaq	䙦
puje	䙨
puae	䙩
pumv	䙬
punj	䙱
sdnb	䙴
spey	䙶
hqfu	䙷
hqfi	䙸
gahq	䙹
tnhq	䙻
vkhq	䙼
duhq	䙽
pxhq	䙾
fihq	䙿
tehq	䚀
tmkq	䚁
hmnq	䚃
vihq	䚄
amdq	䚆
ithq	䚇
sfhq	䚈
dhvq	䚉
uwlq	䚊
kmhq	䚋
rdfq	䚌
gmhq	䚍
oqaq	䚏
tdkq	䚐
ujfq	䚒
sjfq	䚓
gmyq	䚕
tqes	䚘
qehx	䚠
qehn	䚡
qehu	䚥
qehe	䚧
ygdy	䚶
ywgn	䚷
yxxn	䚹
ynfg	䚼
yqwy	䚿
yrcy	䛀
ymfg	䛁
ytah	䛂
yqbn	䛄
ywkg	䛇
ydxy	䛋
yqnn	䛌
yxjh	䛍
ypwy	䛎
ynxn	䛏
ngky	䛐
yntt	䛑
jtyy	䛓
yjry	䛕
yjxt	䛖
ytlr	䛜
ynfm	䛝
yjfh	䛞
ygku	䛠
yqak	䛡
ymgn	䛣
ykhy	䛤
yrdh	䛥
ywwk	䛦
ypwx	䛪
ydey	䛫
yqrm	䛬
yfuf	䛭
ythk	䛮
yjxx	䛰
ykhn	䛱
yepc	䛵
ydhs	䛶
ypqb	䛷
yohk	䛸
yxge	䛹
ylwj	䛺
yrfh	䛻
yeag	䛼
ytfe	䛽
ygxi	䛾
ygkh	䛿
yrdf	䜂
yvjs	䜈
yswi	䜉
ygmj	䜊
ykhm	䜋
ydui	䜍
yooe	䜎
ybde	䜏
bday	䜐
ygfn	䜑
ytmd	䜒
yaas	䜓
ydap	䜔
yajy	䜕
ysmy	䜖
ydgn	䜗
yaqt	䜘
yjxo	䜙
ylip	䜚
yqkq	䜛
yhph	䜜
yrrm	䜠
ydet	䜡
ypdn	䜢
yawy	䜤
yjgp	䜥
wwkv	䜪
hpgk	䜭
wwko	䜯
wwkn	䜲
gkuh	䜶
cnhu	䜼
gkul	䝀
gefg	䝅
qrge	䝆
wqge	䝇
gerb	䝈
gegh	䝊
gecc	䝌
gepl	䝍
gemj	䝎
gelv	䝏
gebe	䝐
gebi	䝒
gevn	䝓
geay	䝔
erhy	䝖
eary	䝙
ehaw	䝞
edhd	䝟
edri	䝠
ejlc	䝢
eias	䝣
etli	䝦
mqug	䝧
mwet	䝩
mnhy	䝪
mygg	䝬
myxy	䝮
mtbn	䝯
eeem	䝱
hqcm	䝳
myki	䝶
tdkm	䝷
mafc	䝸
mpqb	䝹
yymu	䝺
fhnm	䝾
ewmu	䝿
mwnd	䞀
majv	䞁
mdmd	䞂
mdfk	䞅
mimy	䞆
meto	䞈
mudm	䞉
mhah	䞊
musq	䞋
mtdg	䞌
mjjg	䞎
mlny	䞏
foag	䞑
fomk	䞒
foga	䞓
fonn	䞔
fhay	䞖
fhft	䞗
fhtn	䞘
fhgn	䞛
fhxj	䞞
fhrd	䞟
fhry	䞣
fhde	䞥
fhwk	䞩
fhar	䞪
fhtb	䞬
fheb	䞯
fhfo	䞰
fhcc	䞵
fhjr	䞶
fhrg	䞹
fhrh	䞺
fhxe	䞼
fhfi	䞽
fhua	䟀
fhvs	䟁
fhgm	䟄
fhfy	䟈
fhlj	䟉
fhhe	䟊
fhwa	䟑
khsh	䟓
khcy	䟕
khmh	䟖
khqa	䟗
khyw	䟘
khav	䟙
khmw	䟜
khna	䟨
khrg	䟬
khts	䟰
khyq	䟲
khrr	䟷
khef	䟹
khmy	䟺
khcc	䟾
khvi	䟿
khik	䠀
khcf	䠁
sskh	䠂
khlt	䠅
khnm	䠇
khpn	䠉
khrf	䠋
khnc	䠍
khhs	䠕
khpy	䠚
khem	䠛
khab	䠜
khkl	䠤
khtj	䠦
khnj	䠧
khbi	䠫
khuo	䠮
tmdc	䠲
tmdw	䠹
lnhh	䡂
lfqn	䡇
lrry	䡈
lxcy	䡏
tlgs	䡓
lqqy	䡔
awyl	䡗
lqlg	䡘
lrqn	䡚
lfwf	䡜
hwlj	䡞
lhmy	䡠
lxxr	䡡
lyna	䡢
lplh	䡣
ftjl	䡤
lpwk	䡥
lccs	䡦
lwno	䡧
lfhw	䡩
ltdp	䡫
ljlc	䡬
lugf	䡭
ltwh	䡮
ltln	䡯
fnwl	䡰
lkkl	䡲
ladr	䡳
luep	䡵
lnkf	䡶
lafl	䡷
laly	䡸
lfph	䡹
ldhn	䡺
lthy	䡻
ltfm	䡽
lhay	䡾
lfkw	䡿
ckss	䢄
pwdf	䢆
etle	䢉
gjpk	䢋
gapk	䢎
ufpk	䢏
egpd	䢐
qayp	䢑
ywrp	䢒
pgfp	䢓
dgxp	䢕
mapd	䢗
pfpi	䢘
gjrp	䢚
mwkp	䢛
vpmp	䢜
gfgp	䢝
sspi	䢞
ytpi	䢟
oapk	䢠
ansp	䢡
wyvp	䢢
qypd	䢣
tsyp	䢤
ghhp	䢥
yxip	䢦
nwep	䢧
twwp	䢨
gktp	䢩
tdkp	䢪
bdap	䢫
epqp	䢬
ugup	䢭
flpd	䢮
ooqp	䢯
nwyp	䢰
flmp	䢱
hhwp	䢲
tdbh	䢴
mybh	䢷
egbh	䢸
anbh	䢹
bmbh	䢺
awbh	䢼
awkc	䢽
pvbh	䢿
dibh	䣂
gvab	䣆
giyb	䣇
kckc	䣈
iitc	䣉
imkb	䣊
tobh	䣋
vlbh	䣎
wawb	䣏
amdb	䣐
khgb	䣒
gkmb	䣓
imbh	䣔
cobh	䣕
cokc	䣖
ipkb	䣘
meeb	䣙
lvbh	䣚
haeb	䣜
nftb	䣝
kkub	䣞
ugtb	䣡
diab	䣢
hhwb	䣤
sget	䣦
sgay	䣧
sgta	䣨
sggn	䣩
sggh	䣪
sgan	䣰
sgca	䣲
sgnk	䣳
sgrq	䣴
sgbg	䣵
sgtd	䣶
sgri	䣷
sgwa	䣹
sgwk	䣻
sgyi	䣼
sgpg	䣾
sggl	䣿
sgas	䤂
sgpc	䤇
sgnl	䤉
sgab	䤊
sghr	䤏
sgaw	䤑
sgxy	䤒
sgae	䤓
ilrg	䤔
sgrs	䤕
sgji	䤖
ujfg	䤗
ejfg	䤚
qnhh	䤛
qmfg	䤡
qqdb	䤥
qway	䤦
qlkg	䤧
qrey	䤨
qmwn	䤫
qiit	䤬
qrdh	䤭
qhht	䤮
fqwq	䤰
qmrh	䤱
qfoy	䤲
qbib	䤴
qajv	䤷
qxge	䤸
qpoc	䤹
qdrh	䤺
qdae	䤻
qliy	䤽
qdhr	䤿
qbhj	䥀
qclf	䥁
qpfe	䥂
qpwy	䥃
qdaj	䥄
yhdq	䥆
qada	䥈
qpqy	䥉
qgmy	䥊
qyko	䥋
pjjq	䥌
fufq	䥍
qtrb	䥏
qswq	䥑
xcjq	䥒
qadf	䥓
qumt	䥕
qusd	䥖
qwwj	䥘
qbue	䥙
whhq	䥚
qdhi	䥛
qusy	䥜
qrjn	䥟
eawq	䥣
quto	䥥
qdap	䥦
qhph	䥧
qukk	䥨
qjxo	䥪
qagf	䥬
giyq	䥭
qsab	䥮
qlcx	䥯
qynj	䥰
qpeo	䥱
qakw	䥲
qdet	䥳
qmwm	䥴
qjfq	䥵
qdth	䥶
qthj	䥷
xgwq	䥸
qqrt	䥼
qrgq	䥿
qdtb	䦁
dclg	䦉
dchi	䦊
dcgt	䦋
uuak	䦕
ufkd	䦖
utld	䦗
utdd	䦚
ufoi	䦝
uigd	䦞
uifc	䦢
uccc	䦤
ugji	䦨
uhti	䦩
uamd	䦫
utjd	䦭
udwj	䦮
ueto	䦱
uxtb	䦳
ugwr	䦵
ujmy	䦸
bnwy	䦼
wnnq	䦾
bkhh	䦿
bqkg	䧁
bvkg	䧂
btkg	䧄
bgxw	䧅
bawy	䧆
byey	䧇
bhqn	䧋
bevg	䧌
bkeg	䧎
btdh	䧏
bykb	䧐
bsww	䧒
baay	䧖
bxge	䧘
bmwn	䧙
bykk	䧚
byuy	䧛
bovk	䧜
bcoy	䧞
beeg	䧟
bgjf	䧠
bovh	䧡
bakk	䧢
bogw	䧤
bgjn	䧥
beto	䧦
bugy	䧧
bogi	䧨
bnbt	䧩
bodv	䧪
byke	䧫
bpgm	䧬
btln	䧭
bqky	䧯
bqoi	䧰
pqwy	䧵
dkwy	䧺
tfky	䧼
towy	䧽
tyoy	䨀
jpvy	䨃
dujy	䨅
pghy	䨈
mmvy	䨉
ftab	䨋
ffqb	䨌
fxcu	䨎
fuqw	䨏
fgxw	䨑
flkf	䨓
figf	䨕
fdef	䨖
febf	䨗
fhqb	䨘
fitf	䨙
fsrj	䨛
feef	䨜
fbib	䨡
fakf	䨣
fmpu	䨤
fuwc	䨧
fpyh	䨩
ffjf	䨪
fswq	䨫
fiss	䨬
ffce	䨭
fdhv	䨮
fbgi	䨯
fiaf	䨰
fttt	䨱
fogf	䨴
fisf	䨵
fchn	䨶
fwho	䨹
ffcc	䨺
geac	䨼
ohdd	䨾
gdhd	䨿
hdhm	䩀
dmjx	䩃
dmjq	䩄
dmjc	䩅
dmjb	䩊
dmjs	䩋
dmji	䩍
dmjw	䩎
nkaw	䪏
nkat	䪐
nkax	䪑
nkag	䪒
nkao	䪕
nkac	䪗
tnhg	䪠
ujag	䪦
ujqy	䪨
ujwn	䪩
ekuj	䪪
ujga	䪫
ujqt	䪮
oopj	䪯
ujun	䪰
gqdm	䪲
vtdm	䪳
pqdm	䪴
ahtm	䪵
egdm	䪶
qkdm	䪷
kgnm	䪽
dmwe	䪾
vcdm	䫀
qqdm	䫂
dfem	䫃
ukqm	䫄
psdm	䫅
dnxm	䫆
emfm	䫇
dhkm	䫊
adwm	䫏
ssdm	䫐
dskm	䫑
qajm	䫒
dhvm	䫔
yupm	䫕
nhfm	䫗
jqwm	䫘
fasm	䫙
mxxm	䫜
tjdm	䫝
ugom	䫞
kmdm	䫟
edhm	䫠
uvom	䫡
rham	䫢
exdm	䫣
pjym	䫤
rqcm	䫥
fclm	䫦
rdfm	䫧
lvdm	䫫
aqam	䫬
vakm	䫮
ydsm	䫯
dmoh	䫰
lqjm	䫳
ssfm	䫴
thpm	䫵
gkkm	䫷
wtjv	䫸
wtja	䫹
dcwj	䫺
wtjx	䬁
ukqj	䬇
wtjq	䬈
wtjc	䬒
wtjm	䬙
ftjh	䬡
wyvt	䬢
wytn	䬣
nwye	䬤
wywc	䬦
dhwe	䬩
kvwe	䬭
wyvk	䬰
wyqk	䬲
wygs	䬴
wynp	䭀
rrwe	䭁
wykc	䭂
wyld	䭅
ahne	䭆
dewe	䭌
wygl	䭍
wyas	䭎
wyya	䭏
wyun	䭐
wymu	䭓
wywp	䭔
lrwe	䭕
wyji	䭘
wyaj	䭙
wydi	䭜
wywj	䭝
wyyj	䭣
wykp	䭤
wyue	䭥
wyaf	䭦
wyoi	䭧
qnjf	䭪
xjuh	䭫
xjvh	䭬
uthm	䭭
tjdg	䭰
tjui	䭱
tjdk	䭲
tvrj	䭳
cofj	䭴
cowy	䭵
cogj	䭶
cotn	䭷
cowr	䭸
coyw	䭺
cowv	䭻
cotg	䭽
corw	䭿
coca	䮁
coyx	䮄
cogy	䮅
codf	䮆
covg	䮇
coqq	䮈
cote	䮉
cogw	䮊
cogk	䮏
coef	䮑
cohf	䮓
cocc	䮕
cojj	䮖
comf	䮗
coeq	䮘
coft	䮚
cobf	䮛
coas	䮜
copl	䮝
codj	䮞
copc	䮟
cott	䮡
copy	䮤
coyk	䮦
copf	䮨
come	䮩
coqs	䮪
colv	䮫
cosq	䮮
cogt	䮯
coyd	䮰
cogp	䮱
coaw	䮲
cotl	䮳
cowu	䮴
colj	䮷
cohy	䮹
coyj	䮺
coff	䮻
cooo	䮽
coud	䮾
coph	䮿
cobb	䯀
cgpv	䯃
cgkw	䯄
menn	䯆
meet	䯇
meqw	䯉
mesk	䯊
medy	䯋
menv	䯌
mewf	䯎
metd	䯏
meiq	䯑
mets	䯒
meff	䯓
mepa	䯔
metp	䯕
meye	䯖
mexf	䯗
megy	䯙
mexe	䯚
mepb	䯛
mejr	䯜
mede	䯝
memk	䯞
meue	䯟
mejl	䯠
meuo	䯡
osse	䯢
mekm	䯣
mejo	䯥
ykpk	䯧
ykmd	䯨
ykll	䯬
dcev	䰀
dcem	䰅
dcel	䰐
hggn	䰗
hgge	䰘
gkmc	䰙
xgkx	䰜
rqch	䰠
rqcs	䰢
gjic	䰤
akgc	䰥
iwec	䰪
rqcq	䰫
fdmc	䰰
qosh	䰳
qobg	䰵
qodh	䰷
qown	䰼
qocn	䰾
qoxe	䱂
qorw	䱃
qory	䱄
qogs	䱅
qobb	䱆
qoeg	䱉
qoah	䱌
qogu	䱏
qoeb	䱐
qorr	䱑
qokc	䱒
qowt	䱔
qotx	䱕
tjqo	䱘
qoaj	䱜
qorf	䱝
qond	䱟
qoaa	䱠
qoyf	䱣
rmho	䱥
qoub	䱧
qomn	䱩
qoge	䱪
qodd	䱮
qoyh	䱱
qodf	䱳
qomu	䱺
qome	䱻
qolv	䱾
qolr	䱿
qovs	䲃
qoar	䲉
qobe	䲊
qofw	䲌
teuo	䲍
qooe	䲏
qohe	䲐
qouy	䲑
qoqg	䲒
qots	䲗
qgwb	䲝
qgig	䲤
awvo	䲨
bywo	䲯
wcwo	䲲
ywwo	䲳
owvo	䲴
itwo	䲵
wjwo	䲸
yxwo	䲻
tgwo	䲼
agno	䲾
nxwo	䲿
xwvo	䳇
dcyo	䳊
jwvo	䳋
cewo	䳌
ewvo	䳎
ffwo	䳏
fwvy	䳒
ftxo	䳓
ebwo	䳕
mgno	䳙
jfwo	䳚
jvwo	䳛
wgso	䳜
ukwo	䳝
tfao	䳠
fqxo	䳣
pgjo	䳦
rgwo	䳨
svwo	䳩
mdmo	䳪
vcbo	䳭
eyno	䳮
bmfo	䳳
liwo	䳴
lrwo	䳻
ujfo	䴀
pjmo	䴁
qkeo	䴂
fffo	䴃
epqo	䴄
famo	䴅
tmoo	䴈
lgko	䴉
ugto	䴊
pgro	䴐
fkko	䴒
hloe	䴛
hloy	䴞
godx	䴡
onjv	䴧
swwr	䴯
swwd	䵂
myaw	䵊
amwe	䵋
amww	䵌
amwb	䵍
amwj	䵎
amwl	䵐
twiy	䵑
twig	䵓
twid	䵕
twiq	䵙
twie	䵚
twif	䵛
gdlo	䵡
galo	䵤
lfoc	䵥
flfy	䵧
tjlo	䵩
lfor	䵮
lfos	䵲
thdo	䵵
qkxg	䵶
ffxg	䵷
toxf	䵸
hndv	䵻
yuhv	䶒
hbbn	䶔
hbcn	䶕
hbwn	䶖
hbsk	䶗
hbug	䶘
gqjb	䶛
hbtk	䶜
hbdw	䶝
hbaw	䶞
hbqe	䶟
dgkb	䶠
hbmj	䶡
hbdy	䶢
hbmu	䶣
hbme	䶤
hbhg	䶥
hbgm	䶦
hbfq	䶧
hbww	䶨
hbyj	䶩
hbfy	䶪
hbkt	䶫
ffud	䶬
dxyg	䶭
vtxg	䶯
oqwa	䶴
