DGGG	三
GHNN	丏
GHNV	丐
VYGF	丒
DHGF	丕
GKGD	丗
UXGF	丠
GMMK	両
GJAN	丣
HHLL	丨
UYGH	丬
NJHG	丱
KKJK	丳
YYLL	丶
FJYI	丼
TTLL	丿
THFF	乍
TUFK	乎
RGYU	乓
RFMH	乕
TFUX	乖
TGAI	乗
NNLL	乙
GHNB	乤
TUNB	乥
UFNB	乧
CKNN	乨
HKNN	乩
EKNB	乫
ANNB	乬
TUFN	乯
EBNN	乳
RRNB	乴
UFNN	乵
GEHN	乶
IITN	乷
RNRN	乺
YWUN	乻
IYGN	乼
FJFN	乾
EXIN	乿
QJJN	亀
OQAN	亃
CNHJ	予
GUVH	亊
GHNG	亙
HXFF	些
GKJG	亜
CCCF	亝
GFGD	亞
YWRU	交
YNTW	亥
YKBJ	亨
YOYU	亪
YKBF	享
YKPS	亭
YKPW	亮
YKJF	亯
YJIU	亰
YWJG	亱
YKPA	亳
YKPV	亴
YLKG	亶
UTVO	亷
YKBL	亸
YEMG	亹
WWWW	人
WTAN	仛
WVYY	仞
WTFH	仟
WTNN	仡
WQYY	仢
WAYY	代
NYWY	以
HGWU	仧
WHGG	仩
WTCY	仫
WRCY	仮
WITT	仯
WWYN	仱
WXXN	仳
WTGH	件
WTDY	仸
WDHH	仹
WAGF	仺
WTFG	任
WWVT	份
WGXG	仾
WWCY	伀
WGMH	伂
WCNH	伃
WXHH	伄
WGBN	伅
WQRT	伆
WBYY	伋
WDBN	伌
WFCY	伎
WDYY	伏
WDHY	伓
WPWN	伔
WFWY	伕
WDCY	伖
WVFH	伜
WAHT	伢
WMQN	伣
WQUG	伨
WNYY	伬
WVCY	伮
WWIY	伱
WNXN	伲
WANN	伳
WUGH	伴
WEGG	伹
WNGK	伺
WGUF	伻
WNYW	似
WDHG	伾
WKWY	伿
WHNN	佀
WCKG	佁
WGHG	佂
WAFG	佄
WFIY	佅
WJGG	但
WPSH	佇
WDMH	佈
WHCY	佊
WVKG	佋
WHXN	佌
WMDY	佒
WNTT	佖
WPXN	佗
WRWY	佚
WQKG	佝
WFVG	佞
WTUY	佟
WWMH	佡
WANG	佢
WGNY	佤
WHGH	佧
WQNN	佨
WLKG	佪
WTKG	佫
WFTX	佬
WTAH	佭
WWGK	佮
WDJG	佰
WFHF	佱
WFFG	佳
WUAH	併
WFKG	佶
WVEY	佷
WTDG	佸
WQDB	佹
WWGG	佺
WQIY	佻
WYWR	佼
WUQW	佽
WGKR	使
WGAJ	侀
WTFQ	侁
WOTA	侂
WKKN	侃
WGXW	侇
WQQY	侈
WDFN	侉
WIGQ	侊
WYNC	侌
WFFY	侍
WRIY	侏
WTLG	侐
WDEG	侑
WPVG	侒
WVGH	侓
WCTG	侔
WDMJ	侕
WGMA	侖
WMGK	侗
WPTA	侘
WAAY	侙
WQJG	侚
WAWY	供
WTEY	侜
WDHB	侟
WGMF	侢
WFTN	侤
WYNV	侫
WNYU	侭
WNTD	侯
WVTK	侰
WKGG	侱
WDFE	侲
WGNJ	侴
WVPC	侵
WKTK	侶
WNNK	侷
WTFP	侹
WMWN	侺
WUKQ	侻
WFPB	侼
WLET	侽
WFTB	侾
WEVG	俀
WKND	俁
WTXI	係
WTRY	俄
WGIY	俅
WWGS	俆
WQTG	俇
WTFK	俈
WGKG	俉
WKCN	俋
WGEY	俌
WWEG	俎
WTJH	俐
WCEH	俑
WPFQ	俒
WGVA	俓
WHQN	俔
WPSY	俕
WDHK	俖
WWWK	俗
WRDH	俙
WJFG	俚
WQKQ	俛
WMGN	俜
WGEJ	俞
WCTD	俟
WDWW	俠
WTET	俢
WUXT	俤
WFNY	俧
WGUS	俫
WHWY	俱
WYWE	俲
WHDD	俳
WHGC	俶
WECN	俷
WDWG	俸
WGFG	俹
WYCE	俼
WRQW	俽
WRTF	俾
WHAW	俿
WDEY	倀
WTGF	倂
WTHK	倃
WRDE	倄
WYWF	倅
WPQB	倇
WSWW	倈
WYVK	倉
WWCN	倊
WPHN	倌
WMAW	倎
WHTO	倐
WOOY	倓
WFUF	倖
WEEG	倗
WDSK	倚
WADW	倛
WMFK	倜
FJFW	倝
WYKI	倞
WWYG	倠
WJJG	倡
WGVH	倢
WYTY	倣
WFHN	値
WPWA	倥
WPFI	倧
WNDG	倨
WGEG	倩
WEQN	倪
WWGA	倫
WHJF	倬
WTVG	倭
WJSY	倮
WSWC	倯
WFWT	倰
WJXX	倱
WGJI	倲
WGKH	倳
WDFA	倴
WFHY	倵
WHGW	倶
WDFI	倷
WESY	倸
WBBH	倻
WWFK	倽
WUVG	倿
WAMD	偀
WEMF	偁
WUEJ	偂
WDMD	偄
WDWJ	偆
WJQN	偈
WNKH	偉
WTKY	偊
WNUA	偋
WADK	偌
WJGH	偍
WLGE	偎
WYNA	偏
WUTE	偐
WWTJ	偑
WJGR	偒
WNGF	偓
WFTJ	偖
WITH	偗
WKKK	偘
WYUH	偙
WTFE	偛
WUXE	偝
WANS	偞
WRGG	偟
WSVG	偠
WADN	偡
WTOY	偢
WUJG	偣
WUSG	偤
WNHE	偦
WDQQ	偧
WHXS	偨
WQMY	偩
WTFF	偫
WKBG	偮
WYKE	偯
WDHD	偰
WRFH	偱
WLNY	偲
WMDJ	偳
WWGJ	偷
WWGB	偸
WHTL	偹
WTHJ	偺
WHVH	偼
WYTO	偽
WEHC	傁
WRHW	傂
WGXI	傃
WDUH	傄
WDRI	傆
WABG	傇
WDFF	傉
WKMY	傊
WAMF	傋
WCOY	傌
WYUY	傍
WFHW	傎
WOVK	傏
WYKK	傐
WEXD	傒
WYNN	傓
WUVO	傔
WPWY	傕
WWYK	傖
WYXL	傗
WWWF	傘
WYWT	傚
WPWK	傛
WERM	傜
WJNG	傝
WUGA	傞
WYFY	傠
WUUG	傡
WDWI	傣
WFLY	傤
WMEG	傦
WCCE	傪
WLXI	傫
WMWY	催
WGMJ	傮
WTLN	傯
WMEE	傰
WTWH	傱
WGQT	傲
WAKK	傴
WGMY	債
WTJR	傷
WDRR	傸
WUJQ	傹
WWFI	傺
WTLT	傻
WAKW	傼
WXDM	傾
WGHO	傿
WAQH	僀
WTON	僁
WLVG	僂
WSFI	僄
WAKG	僅
WLPY	僆
WNWE	僇
WJLC	僈
WSDN	僊
WWYM	僋
WLTY	僌
WTGE	働
WNNW	僎
WUGK	僐
WTDK	僑
WKHM	僓
WUSF	僔
WFKK	僖
WOOE	僗
WIMT	僘
WAMW	僙
WDUI	僚
WWGU	僜
WNBB	僝
WETO	僞
WXXY	僟
WTOL	僠
WGJN	僡
WEPH	僢
WFWJ	僣
WKKL	僤
WYKY	僦
WFAM	僨
WUEG	僩
WCNK	僪
WGFN	僫
WWYO	僬
WAQJ	僭
WUJF	僮
WOQH	僯
GMIW	僰
WYNY	僱
WSQH	僲
WSOY	僳
WGLG	僵
WAAS	僷
WSSI	僸
WKKS	僺
WNKF	僻
WMAU	僼
WEPT	僾
WPAF	僿
WMAE	儂
WYLG	儃
WIPL	儅
WAQT	儆
WWGW	儉
WSSH	儊
WQDY	儋
WRYT	儌
WOBT	儍
WHQO	儏
WPGM	儐
WJXO	儑
WFKF	儓
WFNF	儔
WYUJ	儕
WAHL	儖
WXTH	儗
WVHL	儘
WKHP	儙
WALQ	儚
WRLH	儛
WPNS	儜
WOOS	儝
WGWR	儞
WVLN	儠
WLLL	儡
WHAN	儢
WOAW	儣
WJAI	儤
WFLM	儥
WONO	儦
WFWM	儧
WRRM	儨
WMJR	儩
WDET	優
WUSQ	儭
WDTH	儮
WUDO	儯
WAEO	儰
WUED	儱
WYFJ	儲
WQKY	儳
WMWK	儶
WGMX	儷
WLXY	儸
WAKY	儺
WIPO	儻
WLLI	儽
WGKE	儾
TFQB	先
WCQB	兊
TKQY	兎
DHGQ	兏
HJQB	児
AQAQ	兓
HNMQ	兕
FQCK	兘
DQFK	兙
DQTF	兛
DQWV	兝
DQTN	兞
TFQQ	兟
RUXQ	兠
DQDJ	兡
DQDF	兣
IGQW	兤
TYNV	兦
GMHY	兩
WGEB	兪
WGNB	兮
WVKX	兺
ULAW	兾
URVC	兿
MHGD	円
MNMB	冎
MWKD	冏
JKGF	冔
PRXB	冟
PFEU	冡
PBCU	冣
PQKY	冤
PJYW	冥
PSSU	冧
PAJH	冪
UAHT	冴
UWYC	冷
UUGH	冸
UDCY	冹
UNNA	冺
UTFQ	冼
UGQJ	冽
UVGH	冿
UQKQ	凂
UWGS	凃
ULDG	凅
USWC	凇
UEVH	凈
UFWT	凌
UGJI	凍
USFG	凐
UMGU	凒
USSY	凓
UPJW	凕
UWYF	凖
UMWY	凗
UADR	凘
ULFF	凙
UYLT	凜
UXTH	凝
UTAO	凞
UFLM	凟
WMHK	凧
WFCI	凨
WGJD	凬
WDJD	凮
WRGD	凰
WGKW	凳
UCOW	凴
HGHG	凸
BKCB	凾
TNJH	刉
TDJH	刋
QRJH	刎
RNJH	刏
MYJH	刐
FQJH	刓
NWJH	刔
VVVR	刕
GQJH	列
XJJH	刜
PUVT	初
EGJH	刞
VKJH	刟
NNAJ	刡
WYCJ	刢
CKJH	刣
FCJH	刦
FCVT	刧
FXYJ	刬
GJGJ	刯
GCFJ	到
FJVW	刱
FFJH	刲
DFNJ	刳
BSJH	刴
YNTJ	刻
FCVY	刼
GUDJ	刾
WSJH	剁
UXHJ	剃
GVAJ	剄
GKUJ	剅
YVCJ	剆
KEJH	剈
WWFJ	剉
DQJK	剋
GKIJ	剌
UEJJ	前
UAVY	剏
AJJH	剒
TQTV	剓
JQRJ	剔
AAJH	剗
ADWJ	剘
UAVW	剙
GKVJ	剚
PQBJ	剜
XGIJ	剝
DSKJ	剞
CCCJ	剟
YKIJ	剠
OOJH	剡
GEYJ	剢
YJJH	剤
DJNJ	剦
DHDJ	剨
OACJ	剫
NGCJ	剭
MNMJ	剮
WGKY	剱
MGKJ	剴
UTTJ	剷
GJHJ	剸
NWEJ	剹
MEEJ	剻
AKKJ	剾
WYOJ	劁
DUBJ	劂
TWGJ	劄
LQJJ	劅
OUVJ	劆
HAGJ	劇
NKUV	劈
KKKJ	劋
HDGJ	劌
WGKJ	劍
WGKV	劎
YUHJ	劑
RRMJ	劕
QKXJ	劖
TFQJ	劗
OSSJ	劘
EEER	劦
QKET	劬
VKET	劭
RWET	劮
IPER	労
UDER	劵
UGET	劷
FFET	劸
YWRE	効
CTGE	劺
AGET	劻
FKET	劼
YNTE	劾
DQET	勀
TFKE	勂
TXET	勄
GKIE	勅
CEHE	勇
DQEE	勊
UDBE	勌
YKIE	勍
UKET	勏
BLET	勐
SWWE	勑
AKFE	勒
XXRE	勓
DMJE	勔
JEGE	勗
CNHE	務
ANME	勚
KMET	勛
WCNE	勜
OOPE	勞
NWEE	勠
SFIE	勡
FWFE	勢
GMET	勣
XKJE	勥
VJSE	勦
RWYE	勧
QKEE	勨
TDKE	勪
TOLE	勫
UDXE	勬
HAGE	勮
YLKE	勯
EEEN	勰
AJME	勱
TGJO	勲
TGLE	勳
TYCE	勶
QWNV	匃
QYNV	匄
QGUF	匉
QRMK	匋
QDJN	匎
DFNN	匏
QGKL	匐
QTMX	匑
QAWK	匒
QVCC	匓
QTMK	匔
XVTR	匘
JGHX	匙
AQYI	匛
AMHK	匝
AYWV	匟
AQRE	匢
AGYI	匤
ACAK	匥
ABHG	匩
AQRJ	匫
ALVV	匭
AIWY	匯
AKKL	匰
AKHM	匱
ADKK	匲
ATHA	匴
AFLM	匵
AAWE	匶
AHHY	匷
AWGK	匼
AJVD	匽
AYNA	匾
AKKK	區
AGHH	卄
NHGH	卍
YWWF	卒
FEEE	協
FGEF	博
YXXF	卛
HMNG	卣
HLRY	卥
FFHY	卦
HMNK	卨
RGBV	卮
QTBH	卯
QDBB	危
QQBH	卶
RHBH	卸
TLBH	卹
WWKB	卻
GQQB	卼
RXBH	卽
QTVB	卿
SWIB	厀
WGSB	厁
DTAV	厇
DDXY	厐
DKXV	厑
DRMK	厒
DFFD	厓
DGCF	厔
DDNY	厖
DUFK	厗
DKRK	厛
DTFG	厜
DAJD	厝
DHDD	厞
DRII	原
DMJK	厠
DTTI	厤
DUBW	厥
DFHW	厧
DAKG	厪
DGQT	厫
DJTK	厬
DSSY	厯
DIMT	厰
DWGW	厱
IDNT	厳
DJEL	厴
CCCU	厽
NFCI	厾
GMCU	叀
CCCD	叄
FCEC	叆
FCVP	叇
CCCC	又
NHCY	収
NHCU	叏
TDCI	叐
GKHC	叓
HGIC	叔
NHFC	叚
POCU	叜
FCBC	叝
NFIC	叞
EHCU	叟
HPGC	叡
KKKK	口
KTYY	叺
KNGG	叼
KTFH	吀
YNKF	吂
GKRI	吏
KTAN	吒
KUHH	吖
KVTT	吚
KNHF	吜
GDKF	吞
KDYY	吠
KXXN	吡
KWJH	吤
KWVT	吩
KWXN	吪
WYNK	含
KDCY	吰
KFCY	吱
KXHH	吲
KMTY	吶
KNWY	吷
KWCY	吺
KQRT	吻
KTGH	吽
TGKF	吿
KAHT	呀
KQUG	呁
KDBN	呃
KNGW	呉
TFKF	告
KFWY	呋
KUFH	呌
KNYY	呎
KTAH	呏
TDKF	呑
KYNN	呝
KNGK	呞
KYXY	呟
KSGG	呠
KNNA	呡
KMFG	呥
KXET	呦
KQAY	呧
KKQN	呪
KHKG	呫
KANN	呭
KKWY	呮
KGUF	呯
HXKF	呰
KRCY	呱
KHXN	呲
KFIY	味
KQKG	呴
KVCY	呶
KDHG	呸
KRWY	呹
KKGN	呺
KJGG	呾
KAFG	咁
KAMH	咂
KWBN	咃
KNTT	咇
KXJH	咈
KMDY	咉
KTHF	咋
KCKG	咍
THKF	咎
KWFY	咐
KRSH	咑
KGNY	咓
KHGH	咔
KDAG	咗
KDMH	咘
KTUY	咚
KPXN	咜
KXXG	咝
KGAH	咞
KDJG	咟
KKFN	咢
KIGQ	咣
KPTA	咤
KGCF	咥
KGXW	咦
KGQJ	咧
KUGH	咩
KFKG	咭
KRIY	咮
KTKG	咯
KQJG	咰
KUDY	咲
KDOY	咴
KDFN	咵
KTDG	咶
KQIY	咷
KPVG	咹
KGJG	咺
KWSY	咻
MNMK	咼
KFTX	咾
KKKF	品
KMGK	哃
KQRB	哅
KFFG	哇
KWGK	哈
FKXY	哉
KDEG	哊
KFBN	哋
KREY	哌
KVEY	哏
KAGG	哐
KRHF	哖
KTGS	哘
KXWV	哛
KCTG	哞
KTFK	哠
KGKU	哣
KDNY	哤
SKSK	哥
KTRY	哦
KFOY	哧
KJFG	哩
KKHY	哫
KWSK	哬
KPTG	哰
KFPB	哱
RRKF	哲
KRRH	哳
KYVE	哴
KKEJ	哵
KHGF	哶
KEFY	哷
KEVG	哸
KEBG	哹
KGEY	哺
KJFH	哻
KYKB	哼
KUKQ	哾
EKSK	哿
KTBT	唀
KWWK	唂
KQEH	唃
KKCN	唈
KDWW	唊
KWGS	唋
KTHP	唌
KPFQ	唍
KTJH	唎
KRDH	唏
KWWF	唑
KGKG	唔
KRFH	唕
KFHY	唗
DCKF	唘
KQTO	唙
KVPC	唚
GSKX	唜
KAMY	唝
KRUF	唞
FCKX	唟
KGMW	唡
KRAN	唣
KUWC	唥
KIIT	唦
KVCB	唧
KBEG	唨
KTVG	唩
KDWG	唪
KHAW	唬
KADW	唭
KNMJ	唰
KEQN	唲
KYNY	唳
KUFQ	唴
KDJN	唵
KAJG	唶
KYCE	唷
KWYN	唸
KYWU	唹
KMAW	唺
KSWW	唻
KUVG	唼
KSRH	唽
KQRN	唿
KMFK	啁
KEBN	啂
KHEG	啃
YUMD	啇
KFUF	啈
KSSY	啉
KBSK	啊
KESY	啋
KPWA	啌
TFGK	啎
KYWF	啐
KGVH	啑
KNBM	啒
YNTK	啓
YNAK	啔
KQRM	啕
KQEG	啗
KPQB	啘
HXKK	啙
KFLK	啚
KGVV	啛
YNKT	啟
KHDD	啡
KRHB	啣
KWFK	啥
KRUG	啦
KGEG	啨
KFFH	啩
KRRG	啪
KLGY	啯
KLQY	啰
KMDG	啱
KRQY	啲
KUDB	啳
KULH	啴
KIHC	啵
KPGH	啶
KYVB	啷
KNDG	啹
KJGR	啺
YUPK	啻
KWGA	啽
KTOY	啾
KADN	啿
KJMY	喁
KFMF	喃
UGUK	善
KJUG	喅
FKFK	喆
KXXR	喈
KDGY	喊
KKYH	喌
KHXS	喍
KMNK	喎
KADK	喏
KDEB	喐
KUJG	喑
KTHJ	喒
KSVG	喓
KNGF	喔
KDMD	喕
KSDG	喖
KPLH	喗
KXGE	喙
KEGC	喛
FKUK	喜
KRXB	喞
KLEG	喟
KTGF	喠
KNKH	喡
KTFE	喢
KQKO	喣
KRGG	喤
KOAC	喥
KYKW	喨
KWGB	喩
KDHD	喫
TDKK	喬
KUTE	喭
KDFA	喯
KWYE	喰
KDJF	喱
KXQY	喲
KSJG	喳
KALG	喵
IPKK	営
GEHX	喸
KDFF	喹
KWTI	喺
KWGJ	喻
KQVN	喼
KKKS	喿
KRHW	嗁
KERM	嗂
KYKK	嗃
KDHT	嗄
KWYK	嗆
FWWK	嗇
KVKC	嗈
KGXI	嗉
KEEE	嗋
KUWL	嗌
KUBE	嗍
KCOY	嗎
KAWS	嗏
KPDK	嗐
KFCL	嗑
KFHW	嗔
KEHC	嗖
KMEG	嗗
KEXD	嗘
KYUY	嗙
KUVO	嗛
KFTJ	嗜
KGKH	嗝
KUXX	嗞
KUGA	嗟
EBTK	嗠
KWCN	嗡
KJLG	嗢
KRDF	嗥
KFPI	嗦
EKWA	嗧
KITX	嗨
KDWT	嗪
KAWK	嗬
FHKX	嗭
KJSG	嗮
KLDN	嗯
KWLD	嗰
KWGR	嗱
KWRQ	嗲
KUFC	嗴
KCEP	嗵
KJAF	嗶
KGQT	嗷
GQTK	嗸
KLPY	嗹
KMWY	嗺
KOAO	嗻
KAJD	嗼
KGKW	嗽
KYTD	嗾
KWYM	嗿
KDHY	嘁
KKNK	嘂
KOVH	嘃
KWVS	嘄
KVCQ	嘅
KCCE	嘇
KMDF	嘊
KFTT	嘋
KSFI	嘌
KLVG	嘍
KDHA	嘎
DNHC	嘏
KNWE	嘐
KHAF	嘑
KDHV	嘒
KLAG	嘓
KAKK	嘔
KGHO	嘕
KGMY	嘖
IPKJ	嘗
KIHV	嘙
KTJF	嘚
KOSS	嘛
KSWQ	嘜
KQEF	嘝
KAKE	嘞
KFTB	嘟
KDEA	嘠
KIPF	嘡
KMEE	嘣
KWSV	嘦
KPNM	嘧
KVOJ	嘨
KLMY	嘪
KQDO	嘫
KJBC	嘬
KFKE	嘭
KVFJ	嘯
KXXY	嘰
KFJE	嘲
KKHM	嘳
KFFQ	嘵
KADR	嘶
KRLO	嘸
KTDK	嘺
KKLK	嘼
KKKL	嘽
KSJF	嘾
KLFO	嘿
KNNW	噀
KGFN	噁
KUSF	噂
KTOL	噃
KDHI	噄
KETO	噅
KAQJ	噆
KUJF	噇
KYKY	噈
KNBT	噉
KCNK	噊
KYKT	噋
KULJ	噌
KWYO	噍
KFPU	噎
KWGN	噏
KKAK	噐
KRIF	噑
KOQH	噒
KHAG	噓
KWGU	噔
ETNK	噕
KGGN	噖
KOGW	噗
KDUW	噘
KWYC	噙
KVAF	噚
KHOB	噛
KXXI	噝
KWGW	噞
OWWK	噟
KFUP	噠
KQDY	噡
KTMD	噢
KLQJ	噣
KSSI	噤
KMAE	噥
KAJY	噧
KKDK	器
GKKK	噩
KUJN	噫
KTAW	噬
KRYT	噭
KLGE	噮
KEPT	噯
KHAE	噱
KHAD	噳
UTHK	噵
KUJW	噷
KGBM	噸
KIPL	噹
KUSR	噺
KPAF	噻
KNKF	噼
FKUG	噽
KPWJ	噾
KNYF	噿
KPNS	嚀
KAHL	嚂
KLIP	嚃
KAWC	嚄
KFDJ	嚅
KAYK	嚆
KFOO	嚇
KDJY	嚈
KOGF	嚉
KFNF	嚋
KYUJ	嚌
KVHL	嚍
KFPH	嚏
KIPJ	嚐
KTGO	嚑
KOSX	嚒
KPWI	嚓
KQOJ	嚕
KDHN	嚖
KJAI	嚗
KDET	嚘
KHBH	嚙
KRXS	嚛
KLFF	嚜
KOAW	嚝
KTQI	嚟
KQYJ	嚠
KAKF	嚡
KOSR	嚤
KAKO	嚥
KDTH	嚦
KHAL	嚧
KUED	嚨
KXGF	嚩
KUQE	嚪
KUSQ	嚫
KHHM	嚬
XTYK	嚮
KOSD	嚰
ERRK	嚳
KKDT	嚴
KQKY	嚵
KMMV	嚶
KYKE	嚷
KLFK	嚸
KRMF	嚹
KLUP	嚺
KELF	嚼
KGQM	嚽
KAKY	嚾
KAWE	嚿
KLGF	囀
KBBB	囁
KYWY	囃
KYRY	囄
KKLE	囅
KAJJ	囆
KGMX	囇
KAFC	囈
KLXY	囉
GKHE	囊
KTFM	囋
KAQT	囌
KMUJ	囎
AKFK	囏
KAUI	囒
KDHB	囓
KGKE	囔
KAHQ	囕
KTLY	囖
MNGD	囙
LHNG	四
TLRI	囟
LGBN	囤
LYWV	囥
MWMG	囧
LDHI	囨
LFCI	囩
TLRY	囪
MJDD	囬
LWXV	囮
LFJK	囲
LURI	図
LWFD	囶
LGHD	囸
LWYC	囹
LNNA	囻
LCKD	囼
LDED	囿
LWYE	圀
LGEI	圂
LGKD	圄
CLUF	圅
LGED	圊
LAKG	國
LMDJ	圌
LNKH	圍
LCMI	圎
LUDN	圏
LLYE	圐
LGEF	圑
LFKE	園
LFCL	圔
LVFJ	圕
LCFD	圗
LWDD	圙
LKHM	圚
LLFF	圛
LLGE	圜
LYXX	圝
LYXS	圞
FFFF	土
FTYY	圦
DHFD	在
FGFH	圩
FTNN	圪
FTAN	圫
TDFG	圱
FTFH	圲
FQYY	圴
FHGG	圵
FQRT	圽
FBYY	圾
FWJH	圿
FQAN	坁
FRCY	坂
FFQN	坃
FWCY	坄
FQUG	均
FPWN	坈
FGBN	坉
FWVT	坋
WVFF	坌
WWFD	坐
FYWN	坑
XXFF	坒
RHYF	坕
FQFF	坖
FGXG	坘
GVFF	坙
FUGH	坢
IPFF	坣
FJHH	坤
FEGG	坥
FPXN	坨
FAFG	坩
FGUF	坪
FHKG	坫
FNXN	坭
FCKG	坮
FDHG	坯
FMKG	坰
FMDY	坱
FXJH	坲
FXET	坳
FWFF	坴
FRGG	坵
FSKG	坷
FQKG	坸
FPWY	坹
FDCY	坺
FQAY	坻
FRYY	坼
FPSH	坾
FWFY	坿
FTUF	垀
FTDY	垁
TFAG	垂
FDXY	垅
FHNG	垇
WAYF	垈
FQNN	垉
FNNA	垊
FMGK	垌
FTHG	垍
FTKG	垎
FVGH	垏
UQWF	垐
FQQY	垑
FYNW	垓
RGKF	垕
FWNN	垖
FQIY	垗
FWDY	垘
FIGQ	垙
FWSY	垛
FBSY	垜
FQDB	垝
FPTA	垞
FVEY	垠
WAFF	垡
FRGK	垢
FGJG	垣
FGCF	垤
FWGK	垥
FPFY	垨
FUAH	垪
FAWY	垬
FDFN	垮
FDPY	垯
FHGH	垰
FIVG	垱
FTGS	垳
FYRB	垴
FPVG	垵
FUFH	垶
FHQN	垷
FPFQ	垸
FDTB	垹
FEBG	垺
TWCF	垼
IRFF	垽
FOCH	垿
TFUF	埀
FMWN	埁
FGJR	埂
FTDH	埄
BYFF	埅
FQEH	埆
FCEH	埇
FCWT	埈
FDWW	埉
MIFF	埊
FJFG	埋
FYVE	埌
FKEG	埍
FDNY	城
FTHP	埏
FVPC	埐
RRFF	埑
FEFY	埒
FGEY	埔
FKGG	埕
FAWX	埖
FHHT	埗
FMWK	埛
SSFF	埜
FWYN	埝
FPGH	埞
FAKG	域
FWNF	埠
FGFG	埡
FUDB	埢
FYWF	埣
FRTF	埤
FGEG	埥
FPQB	埦
FHWY	埧
FWGA	埨
FQVH	埩
FPWA	埪
FIMK	埫
FGJI	埬
FVIY	埭
FOOY	埮
FDJN	埯
FESY	埰
FHGC	埱
FDWG	埲
FQEG	埳
FFHG	埴
FTFG	埵
FUFY	執
FJQR	埸
ADWF	基
FYKB	埻
FDSK	埼
FVPH	埽
BCFF	埾
INXF	埿
FNBM	堀
FJSY	堁
IPKF	堂
YYFF	堃
FEQN	堄
FWYG	堆
AKGF	堇
FMUM	堈
FYCE	堉
GFGF	堊
FEEG	堋
FLDG	堌
FQKY	堍
FFWT	堎
SYFF	堏
FDFF	堐
FJXX	堒
FMDF	堓
FPWS	堔
FVTR	堖
FUDF	堘
FSFG	堙
FPLH	堚
FGKL	堛
FGLI	堜
FMNK	堝
FANS	堞
FXGE	堟
FWND	堠
WKSF	堡
FWKS	堢
FJMY	堣
CNHF	堥
FXXR	堦
FDMD	堧
FJQN	堨
FNGG	堩
FADN	堪
FRBT	堫
FWGJ	堬
FKKN	堮
FFFQ	堯
FAJV	堰
FNHG	堳
FFTJ	堵
FDAE	堶
FUJG	堷
FWTJ	堸
FTGF	堹
FLWJ	堺
IVGF	堻
FLGH	堽
FDWJ	堾
FDGY	堿
FNUA	塀
LIFF	塁
FAWN	塂
FAYK	塃
FLYT	塄
FWDC	塅
FYOX	塆
FPGG	塇
VCAF	塈
FIWE	塉
OOPF	塋
EUDF	塍
FPWK	塎
FMGU	塏
FGXI	塐
UBTF	塑
FPJW	塓
FAWK	塔
FWCN	塕
FTUX	塖
IWGF	塗
FYKK	塙
FPGY	塚
FSSY	塛
FPFE	塜
FYUY	塝
AGQF	塟
FWNP	塠
FXHW	塡
FWNO	塢
IKGF	塣
FKMY	塤
FGKH	塥
BLFF	塦
FUWL	塧
FTKL	塩
FDRI	塬
FJLG	塭
FTMF	塮
ITXF	塰
YVCF	塱
FTJR	塲
FTDP	塳
FMEE	塴
ONJF	塵
FONX	塶
FHLO	塷
FAKK	塸
LRFF	塹
OSSF	塺
FAJD	塻
FGJF	塼
FDRR	塽
FLVG	塿
FNIG	墀
FJLC	墁
FSFI	墂
FDHY	墄
JFCF	墅
FAQH	墆
FUJF	墇
FADE	墈
FOVH	墉
FUFF	墊
FCCE	墋
FOAO	墌
RXAF	墍
AJDF	墓
FMWY	墔
FGHO	墕
FWGL	墖
FFJN	墘
FIVS	墚
FNFF	墛
BUEF	墜
FULJ	增
FHAG	墟
FKKL	墠
FUGK	墡
FWXC	墢
FOGW	墣
FKHM	墤
FTOL	墦
FTDK	墧
LFOF	墨
FYKT	墩
FUSF	墫
BXGF	墬
FDNL	墭
NDAF	墯
FSJF	墰
FWGU	墱
FRLO	墲
FAMW	墴
FFFC	墵
FFUP	墶
FAGF	墷
FAFJ	墸
FTMD	墺
FFWK	墻
LBWF	墼
FRYT	墽
FLFF	墿
NAWF	壂
FGLG	壃
SCNF	壄
YXTF	壅
ERRF	壆
FYLT	壈
FHAE	壉
FFLE	壊
FIPL	壋
FYWE	壌
ILRF	壍
FTGO	壎
FAHL	壏
GWMF	壐
HPGF	壑
FAFL	壒
DJEF	壓
FFNF	壔
FFDJ	壖
FVHL	壗
LLLF	壘
FOAW	壙
FHAL	壚
FUQE	壛
FJFC	壜
FKHP	壝
FUED	壠
FBXG	壣
FYKE	壤
FDLF	壥
FAKY	壦
FKKT	壧
FYXX	壪
FPXB	壱
FPKG	壷
FPGU	壹
FNHE	壻
FKUN	壾
FLLD	夁
TTNY	夂
TAHJ	夅
TDHJ	夆
YOTU	変
CWTU	夋
FWTU	夌
WWFT	夎
DHTU	夏
QMWT	夐
YOOT	夑
DHHT	夒
EDHT	夓
UTHT	夔
QTNY	夕
WGQI	夙
YWTY	夜
QHKX	夞
QQFK	夡
YCLQ	夣
QPGW	夤
JSQQ	夥
ADWQ	夦
DDDD	大
GNYI	夨
GXWI	夷
DFCU	夽
DHDU	奀
DJNB	奄
DQTB	奅
DANF	奆
DWGJ	奉
FFGY	奊
HKDU	奌
UDJJ	奍
DFFF	奎
DWGD	奏
QMWD	奐
DHVD	契
DYNW	奒
DQQU	奓
DFAJ	奔
YODU	奕
CDJN	奙
DEEF	奟
USGD	奠
DFTJ	奢
GDJE	奣
DDMD	奤
CNHD	奦
TMTD	奧
UEFD	奨
DAKK	奩
DWYF	奪
DIJG	奫
DDJJ	奭
DHDY	奯
LLLD	奰
YXXD	奱
DFTL	奲
VVVV	女
VTFH	奷
VTAN	奼
VYVD	奿
VQYY	妁
YNVF	妄
VPQN	妉
VTFG	妊
VFWY	妋
VFJH	妌
VGAH	妍
VWJH	妎
VWCY	妐
VYNT	妒
VFCY	妓
VYWN	妔
VKHH	妕
VWYN	妗
VDHY	妚
BHGV	妛
VNWY	妜
NHDV	妝
VNHF	妞
VMWY	妠
VWVT	妢
VXXN	妣
VCNH	妤
VDHH	妦
VFQN	妧
VDCY	妭
VNXN	妮
VTHF	妰
VVKG	妱
VJGG	妲
VQIY	妳
QBVF	妴
VYGG	妵
VYXY	妶
VRWY	妷
VSKG	妸
VGSY	妺
VNTT	妼
VJHH	妽
EKVF	妿
VQKG	姁
VTPY	姂
VGHG	姃
VNNA	姄
VUGH	姅
WFVF	姇
VWYC	姈
VGMH	姉
VMFG	姌
VMAH	姍
VMDY	姎
VAFG	姏
VNYW	姒
HXVF	姕
VANG	姖
VWTF	姙
VMGK	姛
VRIY	姝
VFKG	姞
VYNW	姟
VTMK	姠
VTDG	姡
VCEG	姢
VYWR	姣
VRGK	姤
VVVF	姦
VVFH	姧
VGXW	姨
VRHF	姩
VAHH	姬
EEEV	姭
VGJG	姮
VIGQ	姯
VQJG	姰
VDFN	姱
VPVG	姲
GQJV	姴
VWGH	姵
VWGK	姶
VDEG	姷
VGDF	姸
VTFQ	姺
VQQY	姼
VQDB	姽
VWGG	姾
VADT	娀
VAWY	娂
VFFG	娃
VMGN	娉
VHQN	娊
VIEG	娋
VJFG	娌
VDNY	娍
RRVF	娎
VEBG	娐
IITV	娑
VTXY	娒
VDQN	娔
VGKI	娕
VKHY	娖
VTFP	娗
VGVA	娙
VLET	娚
VNGB	娜
VDHK	娝
VEVG	娞
VKEG	娟
VDFE	娠
VFNY	娡
VWYK	娢
VUXT	娣
VTRY	娥
VRGW	娦
VUKQ	娧
VJFH	娨
VQKQ	娩
VGKG	娪
VTHP	娫
VFHY	娬
VCTD	娭
VKNW	娯
VWNW	娰
VTJH	娳
VBCY	娵
VADW	娸
VXYX	娹
VCCC	娺
VGJI	娻
VVIY	娽
VDFF	娾
BSKV	娿
VBSK	婀
VRMH	婂
VPFI	婃
VUKG	婄
VQOY	婅
VESY	婇
VFWT	婈
VGEY	婊
VHAW	婋
VHGC	婌
VDSK	婍
VWYG	婎
VQKY	婏
VJSY	婐
VTVG	婑
VOOY	婒
HDHV	婓
VHDD	婔
VGVH	婕
VGDN	婖
VEQN	婗
VUDB	婘
VQVH	婙
VYKI	婛
AHNV	婜
VPGH	婝
VFUF	婞
VLDG	婟
VPHN	婠
VSWW	婡
VRTF	婢
VMFK	婤
VHJF	婥
VGEG	婧
VWGA	婨
VMDF	婩
SSVF	婪
VJXX	婫
VETF	婬
VGFG	婭
VNDG	婮
GMYV	婯
VMAW	婰
XYXV	婱
VAWX	婲
VGLB	婳
VYKS	婷
VJGR	婸
VSVG	婹
CNHV	婺
VFMF	婻
VADK	婼
VNHC	婽
VWGB	婾
VNHE	婿
VJMY	媀
VNKH	媁
VYUH	媂
VCNS	媃
VUGD	媄
VADN	媅
VDMD	媆
VPLH	媈
VNGF	媉
VUEJ	媊
VDWJ	媋
VALG	媌
VQMY	媍
VFTJ	媎
VMDJ	媏
AHKV	媐
VTGF	媑
VRGG	媓
VAMD	媖
VPGG	媗
VXXR	媘
VDGY	媙
VEGC	媛
VHMY	媜
TOVF	媝
VJGH	媞
VANS	媟
VDAE	媠
VGLI	媡
VJHG	媢
VIVS	媣
VLNY	媤
VYNA	媥
VLEG	媦
VMNK	媧
VUSG	媨
VHVH	媫
VWKS	媬
EDMV	媭
VWGJ	媮
VYTO	媯
VQBT	媰
VERM	媱
VFKE	媴
EUDV	媵
VABG	媶
VBHJ	媸
VQYL	媹
VMGT	媺
TEWV	媻
VLWL	媼
VAMF	媾
VRQC	媿
VDWT	嫀
VFHW	嫃
VDRI	嫄
VUGA	嫅
VPWK	嫆
VPJW	嫇
OOPV	嫈
VGXI	嫊
VXUU	嫋
VEEG	嫍
VYUY	嫎
VYVB	嫏
VLEV	嫐
DHSV	嫑
VQMX	嫓
VATN	嫕
VAKK	嫗
VLXI	嫘
VYTH	嫙
VJLC	嫚
ATDV	嫛
VUJF	嫜
VOVI	嫝
VOVH	嫞
VAAK	嫟
FITV	嫠
FWHV	嫢
VGHO	嫣
VAKG	嫤
VGJF	嫥
VGMY	嫧
VAKW	嫨
VNWE	嫪
VAJD	嫫
VOAO	嫬
VHAF	嫭
VFFN	嫮
GQTV	嫯
VGKW	嫰
VOSS	嫲
UMIV	嫳
VDUF	嫴
VRLO	嫵
VWYO	嫶
VBDE	嫷
VUGK	嫸
VAMW	嫹
VUEG	嫺
VUSY	嫻
VLFO	嫼
VDUI	嫽
VOQH	嫾
VVFG	嫿
VETO	嬀
VWGU	嬁
VUJY	嬂
VFPU	嬄
VAGF	嬅
VWGN	嬆
VKHM	嬇
VFFQ	嬈
AKUV	嬊
VKKL	嬋
VTOL	嬏
VWGW	嬐
VUJN	嬑
VRYT	嬓
VLFF	嬕
VYLG	嬗
VUEP	嬘
VFWK	嬙
VOUO	嬚
VLGE	嬛
UJQV	嬜
VWVE	嬝
VATF	嬞
VUGY	嬟
VKKS	嬠
VEPT	嬡
VYWE	嬢
VPNS	嬣
VOSX	嬤
VFNF	嬦
VVHL	嬧
VUXN	嬨
VEGW	嬩
VPGM	嬪
VOOS	嬫
VFDJ	嬬
VGWR	嬭
DJEV	嬮
VFKF	嬯
ILRV	嬱
LEVE	嬲
VAWC	嬳
VXRH	嬵
VTHJ	嬶
VEMW	嬹
VAAN	嬺
VFLM	嬻
VQYJ	嬼
VLHD	嬽
VGKM	嬾
VAKO	嬿
VFSH	孀
FKKV	孁
VTVL	孂
VYKE	孃
VUGI	孄
VWWG	孅
VMMV	孆
VMWK	孈
VAKY	孉
VOSD	孊
VGMX	孋
YXXV	孌
VKKT	孍
VNIJ	孎
VAUI	孏
BNHG	孑
FPBF	孛
NGKB	孠
BCKG	孡
BQNN	孢
BRCY	孤
VCBF	孥
XEBF	孧
BYNW	孩
BPFI	孮
AHNB	孯
YKBY	孰
BGFG	孲
BBBJ	孴
QYTB	孵
YXYB	孶
FITB	孷
NKUB	孹
BFDJ	孺
BVHL	孻
BTWB	孼
BMMV	孾
YXXB	孿
PYYN	宀
PGFJ	宇
PDYU	宊
PYWU	宍
PTDU	宎
PHNG	宐
PFJJ	宑
PTFN	宒
PNTR	宓
PYGF	宔
PXCU	宖
PHNN	官
PEGF	宜
PDWU	実
PGJG	宣
PDEF	宥
PAHH	宦
PQIU	宨
PDNY	宬
PVTK	宭
PFTB	宯
PUFJ	宰
PKSU	宲
PDHK	害
PTOU	宷
PDFE	宸
PWWK	容
PKGK	宺
PCUM	宻
PFQV	宼
PESU	寀
PGVH	寁
PFQC	寇
PGEF	寈
PWYF	寉
PHMU	寊
PAWB	寋
PGKL	富
PNLF	寍
PNHW	寎
PQMD	寏
PNHI	寐
PWVC	寑
PJGH	寔
PDLS	寕
PIVC	寖
PNTF	寗
PFHW	寘
PRCY	寙
PAHQ	寛
PNLH	寜
PAJD	寞
PLVF	寠
PNHY	寣
PNHK	寤
PETO	寪
PEQO	寫
PGJN	寭
PDUI	寮
PWYM	寯
PNHS	寱
PXTH	寲
PGQM	寳
PUSQ	寴
PUED	寵
PGRM	寶
PMDU	寷
FFFY	封
GMFU	専
GEHF	尃
TMDF	射
DQFI	尅
NHDF	將
USGF	尊
OGUF	對
UTHF	導
HGIU	尗
IMKF	尚
IDIU	尜
DUJI	尞
JGHT	尟
IGQX	尡
DNQY	尥
DNEY	尨
WQGD	尩
DNGD	尪
GQGD	尫
DNWJ	尬
FAQB	尭
DNBS	尮
DNQB	尯
DNTF	尰
YKIY	就
DNUO	尲
DNME	尳
DNKM	尵
GQAL	尶
NTFN	尾
NPWI	屄
NGCF	屋
NKMH	屌
NTFC	屐
NIED	屑
NDFE	屒
RGNX	屔
NUFK	屖
NTFF	屗
NTFB	屘
NBSK	屙
NTGF	屛
NTAN	屜
NHDD	屝
NANS	屟
NFTJ	屠
NTHH	屣
NULJ	層
NTTT	履
NTAS	屧
NTLV	屨
NTTK	屩
NPDI	屪
NNHK	屫
NILJ	屬
NMMM	屭
UBTR	屰
MMMM	山
TYMJ	屳
MTNN	屹
MVYY	屻
MGQN	屼
MVYU	岃
MTDY	岆
MQBJ	岇
MAHT	岈
MQRT	岉
MBYY	岋
MGAH	岍
MWVT	岎
MFQN	岏
MFCY	岐
MWYN	岑
MWJJ	岕
TDMJ	岙
MTHF	岝
MMDY	岟
MANG	岠
MQKG	岣
MPWY	岤
MHCY	岥
MVKF	岧
MEGG	岨
MXJJ	岪
MPXN	岮
MDHG	岯
MXET	岰
MRGG	岴
MVKG	岹
MWYC	岺
MQAY	岻
MGUF	岼
MQTB	峁
MTUY	峂
IPMJ	峃
MCAH	峅
MWGK	峆
MTKF	峉
WNNM	峊
MQJG	峋
MGCF	峌
MVGH	峍
MVEU	峎
MWGF	峑
MMGK	峒
MGXW	峓
MFTX	峔
MYJF	峕
MPVG	峖
MQDB	峗
MGJG	峘
MFFY	峙
MGQJ	峛
MWHF	峜
MDEF	峟
MHGH	峠
MATQ	峣
MYWR	峧
MTRY	峨
MAHB	峫
MGEY	峬
MVTK	峮
MTDH	峰
QTNM	峱
MTJJ	峲
MWHT	峳
MHQN	峴
MPDC	峵
WVGM	島
MUFJ	峷
WGSM	峹
MGJR	峺
MCWT	峻
MTFK	峼
MDWW	峽
IRMJ	峾
MGKG	峿
MYVE	崀
MFQW	崁
MWGG	崄
MQEH	崅
MPWA	崆
MPFI	崇
PFIM	崈
MIJG	崉
MSSY	崊
MGAF	崋
MNDG	崌
MSWW	崍
MDSK	崎
MQAJ	崏
MJXX	崑
MYWF	崒
MLDG	崓
MWYF	崔
MDFF	崖
MMUM	崗
MWGA	崙
MFWT	崚
MNBM	崛
MTFG	崜
MGEG	崝
MYKB	崞
MGJI	崠
MBIB	崡
MTVF	崣
MRDE	崤
MRTF	崥
MDJN	崦
MSWC	崧
MGVH	崨
MLDF	崮
MVLG	崰
MMJJ	崱
MWGJ	崳
MDGY	崴
MJGR	崵
MFFF	崶
MUSG	崷
MDMY	崸
MYUH	崹
MYTB	崺
MTFF	崻
MJGH	崼
MLNU	崽
MSVG	崾
MKKN	崿
MSYG	嵀
MADN	嵁
MTVG	嵂
MUTE	嵃
MUGD	嵄
TDNM	嵇
MEGC	嵈
MYKS	嵉
MTUX	嵊
MNHG	嵋
MJMY	嵎
MRBT	嵏
MJQN	嵑
KKKM	嵒
MKKK	嵓
MLGE	嵔
MSJG	嵖
MTUF	嵙
MQQW	嵚
MUKH	嵜
MDWY	嵟
MEXD	嵠
MWCN	嵡
MWYK	嵢
MOVK	嵣
OOPM	嵤
MQAS	嵥
MMGU	嵦
MQYL	嵧
MWNO	嵨
MYKK	嵩
MUXX	嵫
MRQC	嵬
MYUY	嵭
MFHW	嵮
MUGA	嵯
MPWK	嵱
MTHS	嵲
MIWE	嵴
MJFF	嵵
MXUU	嵶
MTWH	嵷
MXKJ	嵹
MNWE	嵺
MOVI	嵻
MUTG	嵼
MAQH	嵽
MCCE	嵾
MSDM	嵿
MFFN	嶀
MLVG	嶁
MUJF	嶂
MLRH	嶃
MGMJ	嶆
MAKK	嶇
MNHF	嶈
MKWY	嶉
MRWY	嶊
MWVO	嶋
MNRG	嶍
MNFF	嶎
MDSN	嶏
MBTG	嶐
MQKE	嶑
MTOL	嶓
MWYO	嶕
MWGN	嶖
MSAA	嶘
MOQH	嶙
MDUI	嶚
MAQJ	嶜
MWGU	嶝
BDAM	嶞
MUSF	嶟
MTDK	嶠
MDUW	嶡
MFFQ	嶢
MLFF	嶧
ERRM	嶨
MMAE	嶩
MOGI	嶪
MUGY	嶬
MWNF	嶭
MWGW	嶮
MKBY	嶯
MQEG	嶰
MAJN	嶱
TMOM	嶴
MLHD	嶵
MTMT	嶶
MXTH	嶷
MOOS	嶸
MFNF	嶹
MWYM	嶺
MFWY	嶻
MEGW	嶼
MQTY	嶽
MEAN	嶾
MFDJ	嶿
MIWA	巀
MDAY	巁
MUED	巃
MOOK	巆
MHAA	巇
MAKO	巈
MQKY	巉
MMMV	巊
MIDT	巌
MDHT	巎
MAKY	巏
MYKA	巐
MTFM	巑
YXXM	巒
MXHM	巓
MFHM	巔
MUWV	巕
MKKT	巖
MHAY	巘
MUTT	巙
VNNN	巛
KTHH	川
YTYH	州
YNKB	巟
GVAF	巠
IJSU	巣
VLRN	巤
AAAA	工
AGNN	巧
AWFW	巬
AEFW	巭
GVAK	巰
NNGN	己
CNHN	巴
RGCV	巵
VKNN	巶
AWNB	巷
AHKN	巸
BIGN	巹
NNGW	巺
UDNB	巻
CKXB	巼
NNAW	巽
GMHK	巿
MHSH	帄
MHWY	帆
VMHK	帇
MHWV	帉
MHCN	帊
QAMH	帋
RDMH	希
YNMH	帍
MHPQ	帎
VCMH	帑
WAYH	帒
MHGS	帓
MHHC	帔
MHRG	帕
MHHK	帖
MHDY	帗
MHRW	帙
VPMH	帚
RMHJ	帛
MHDJ	帞
YOMH	帟
EMHJ	帠
MHUA	帡
MHWK	帢
UDMH	帣
VKMH	帤
MHUQ	帨
MHIE	帩
WNNH	師
VTKH	帬
GKGH	帯
YTVH	帰
MHTF	帲
MHDE	帳
MHPB	帵
AQPH	帶
IPKH	常
MHUV	帹
MHAW	帺
MHFJ	帾
MHWD	帿
MHHM	幀
MHDM	幁
MHNH	幃
MHNF	幄
MHJN	幆
MHNA	幈
MHAS	幉
MHAM	幊
TEWH	幋
MHJQ	幌
MHEE	幍
MHPW	幎
MHPE	幏
EUDH	幐
TMTT	幑
MHTN	幒
MHCE	幓
MHJC	幔
AJDH	幕
MHSI	幖
MHLG	幗
MHGM	幘
MHAD	幙
MHJI	幜
MHKL	幝
MHOW	幞
MHUY	幟
MHRO	幠
MHTL	幡
MHUF	幢
UMIH	幣
IMKH	幤
MHIR	幥
NKUH	幦
MHKS	幧
MHQY	幨
MHFM	幩
MHAE	幪
FFFH	幫
MHFF	幬
MHOF	幮
MHTB	幯
MHPN	幰
MHUI	幱
GUFK	平
RHFK	年
GDFH	幵
TGDF	幷
FJFF	幹
XXXX	幺
OTCI	庅
OWYN	庈
OGBN	庉
OFCI	庋
OAHT	庌
OWJK	庎
OCNH	序
OFYI	庒
OQAY	底
OQNV	庖
OVWI	庚
OHXV	庛
OTUI	庝
OUGK	庠
OYEI	庡
OGCF	庢
OQII	庣
OFFI	庤
OWSI	庥
OWWF	座
OFTB	庨
OWGS	庩
ORFC	庪
ODNY	庬
OTFP	庭
OSGD	庮
OGEY	庯
OUAK	庰
OFWT	庱
OSWW	庲
ORTF	庳
OAOI	庶
OANY	庹
OWCS	庺
OAWW	庻
OXDM	庼
OJMY	庽
OEWI	庾
OALD	庿
OPOC	廀
OSHD	廂
OWFQ	廃
OVCC	廄
OFCL	廅
ORQC	廆
OUVO	廉
OEHC	廋
OUKB	廍
ORXC	廏
ORXQ	廐
OAKG	廑
OGQT	廒
OYKB	廓
OLVD	廔
OBWC	廕
ONWE	廖
OAQH	廗
OONX	廘
OJFF	廛
ONFJ	廜
OADR	廝
OQQW	廞
ORLO	廡
OAMW	廣
OLKX	廤
ONKF	廦
OFWK	廧
OQEG	廨
OYLT	廩
OENE	廫
OTGM	廭
OMMV	廮
OQOG	廯
OBFN	廰
OVKY	廱
OGMX	廲
TFPD	廷
VGPK	建
MJDP	廽
AGTH	廾
AGHG	廿
WVAJ	弅
FCAJ	弆
WGKA	弇
YOAJ	弈
AFYI	弍
ADYI	弎
FFNY	弐
RSYY	弒
XQWY	弞
XANG	弡
XBHC	弢
XWFY	弣
XQAY	弤
VCXB	弩
XAHH	弫
UDXB	弮
XYKB	弴
XYKI	弶
XGMX	弻
XDJX	弼
XANS	弽
XILH	弾
PAWX	弿
XSKK	彁
OGXD	彂
XJAF	彃
XAKK	彄
XUEV	彅
UMIX	彆
XKKL	彈
XAMW	彉
XGLG	彊
XGWR	彌
XHHC	彏
VNGG	彐
XGIU	彔
XGEU	彖
XGTX	彘
XGPS	彙
VPJS	彚
VOWA	彛
XGOA	彝
VOXA	彞
VFAC	彟
VAKC	彠
ETTT	彡
MYET	彤
YDER	彥
GKGY	彧
GMYE	彨
HAWE	彪
MFKE	彫
FKUE	彭
PWWE	彮
UJFE	彰
JYKE	影
TTTH	彳
TQYY	彴
TBYY	彶
TWCY	役
THCY	彼
TWYC	彾
TXJH	彿
TGHG	征
TQJG	徇
TUGH	徉
TVGH	律
TFFG	徍
THHT	徏
TWGS	徐
TGVA	徑
TFHY	徒
TUHY	従
TAPY	徔
TPFI	徖
TJGF	得
THHY	徙
TGLI	徚
TIMK	徜
TFHG	徝
TWWH	從
TSWW	徠
TGVH	徢
TAJG	徣
TJGH	徥
TNHC	徦
TRGG	徨
TTJT	復
TNKH	徫
TYUY	徬
TERM	徭
TMGT	微
TEXD	徯
TGHH	徰
TSFI	徱
TNIG	徲
TUMT	徶
TFLN	德
TFFQ	徺
TRYT	徼
TMYT	徾
TJBI	忁
NYNY	心
NYYH	忄
TFNU	忎
HGNU	忐
GHNU	忑
ANYI	忒
NTNN	忔
YNNU	忘
NWYY	忛
GDNU	忝
KHNU	忠
NKHH	忡
NBYY	忣
NTFH	忤
RNNU	忥
NFQN	忨
WCNU	忩
NWCY	忪
NNWY	快
NCNH	忬
NYHY	忭
NQAN	忯
NVFH	忰
NPQN	忱
NDYY	忲
NGBN	忳
NWYN	忴
NRBH	忷
NNHF	忸
NQWY	忺
NYWN	忼
QRNU	忽
WVNU	忿
NANG	怇
NANN	怈
NQNN	怉
NVKG	怊
NNNA	怋
NDHG	怌
NTHF	怍
THFN	怎
NMDY	怏
NQKG	怐
NUGH	怑
NVCY	怓
NDMH	怖
NHKG	怗
NEGG	怚
NJGG	怛
NQAY	怟
NCKG	怡
NRWY	怢
RWNU	怣
WFNU	怤
QVNU	急
NGUF	怦
NTGG	性
NNXN	怩
NXJH	怫
NNTT	怭
NXET	怮
NFCY	怯
NYXY	怰
QRYN	怱
NGMW	怲
NKQN	怳
NGNY	怴
NSYY	怵
FQYN	怷
SYNU	怸
WBNU	怹
NYNI	怺
NFIY	怽
NKWY	怾
NQQY	恀
WTFN	恁
NQJG	恂
NFKG	恄
NFTX	恅
NGHG	恆
NAGG	恇
NCTG	恈
NXJG	恉
NEEE	恊
NQIY	恌
VBNU	恏
AWYN	恐
NQDB	恑
NYWR	恔
TLRN	恖
NDFN	恗
NWSY	恘
UGNU	恙
FFNU	恚
NLKG	恛
NAAY	恜
DHVN	恝
NGXW	恞
NQRB	恟
NDHF	恠
NRDC	恡
UQWN	恣
NTMK	恦
DMJN	恧
LDNU	恩
NTDG	恬
AWNU	恭
NWGG	恮
NWCQ	恱
NUAH	恲
YJNU	恴
GMNU	恵
WSNU	恷
NAYN	恾
CEHN	恿
NCEH	悀
NKEG	悁
NXXF	悂
NLSY	悃
WGSN	悆
NWGS	悇
NAAH	悈
TONU	悉
RRNU	悊
NYKG	悋
NUXT	悌
NTFK	悎
NDWW	悏
QTON	悐
NGEY	悑
NKCN	悒
NHQN	悓
NTXY	悔
NRDH	悕
NFPB	悖
NQKQ	悗
NYKB	悙
NGKI	悚
NCWT	悛
NKGG	悜
NJFG	悝
NKND	悞
WHTN	悠
TJNU	悡
NYVE	悢
TLQN	悤
NTJH	悧
NIRB	悩
GKJN	悪
NKGD	悮
NPFI	悰
HDHN	悲
FHNN	悳
NDEY	悵
NTBG	悸
NPHN	悺
NFUF	悻
NGVV	悽
NPWA	悾
NGDN	悿
NWGA	惀
SRNU	惁
NJXX	惃
HGIN	惄
NJSY	惈
IHKN	惉
PQBN	惌
NAKG	惐
AKGN	惑
TKNU	惒
NUDB	惓
NOOY	惔
NJQR	惕
JQRN	惖
NMUN	惘
NCCC	惙
NQRN	惚
NQAJ	惛
NIMK	惝
NRQW	惞
NNNU	惢
TQRN	惣
NXYX	惤
EWNU	惥
FHNU	惪
NDAE	惰
NPLH	惲
NMDJ	惴
DWJN	惷
NQJB	惸
NJTG	惺
NMJH	惻
NYNA	惼
NNNJ	惽
NRBT	惾
NJGH	惿
NTOY	愀
FPBN	愂
NPGG	愃
NLGE	愄
NAKF	愅
TIGN	愆
NNKH	愇
NWGJ	愉
NGKL	愊
NEGC	愋
NQMD	愌
NATN	愍
NTJT	愎
NDMD	愐
NCEE	愑
NJQN	愒
NJGR	愓
NUJG	愔
NKKN	愕
NADN	愖
NPTK	愘
PTKN	愙
NADW	愜
NAJV	愝
DGKN	感
NLNY	愢
NLYT	愣
NAMD	愥
NRQC	愧
NAMY	愩
NKMY	愪
NGXI	愫
UBTN	愬
NERM	愮
NWYC	愯
NJIQ	愰
NUTD	愱
NMEG	愲
HHNU	愳
NWYK	愴
NXUU	愵
NMGU	愷
SWWN	愸
NPWK	愹
NAJF	愺
BTXN	愻
NXHW	愼
NGEF	愽
NRNO	愾
NEXD	慀
LGEN	慁
ICEN	慂
NWCN	慃
NSSY	慄
NCYJ	慅
NEEG	慆
RVNN	慇
UXXN	慈
NYXL	慉
NUVO	慊
NLWL	慍
NPJW	慏
AMNU	慐
NGMJ	慒
NSFI	慓
NAJD	慔
NLAG	慖
GKIN	慗
LRNU	慙
NMWY	慛
TXTN	慜
NTGE	慟
NGQT	慠
NDRR	慡
NTFP	慥
GIYN	慦
DHDN	慧
NLPY	慩
NAKK	慪
TWWN	慫
GUSN	慭
HALN	慮
NTJR	慯
NGJF	慱
NAHF	慳
NNRG	慴
ONJT	慶
AQPN	慸
FUFN	慹
NLVG	慺
NUDH	慻
DHGN	慼
NDHY	慽
WWKN	慾
UCAN	慿
NNWE	憀
NTLN	憁
DWEN	憃
TFHN	憄
NIPF	憆
NHAG	憈
NFKE	憉
WATN	憊
UMIN	憋
QQUN	憌
NTDK	憍
NWFI	憏
NKHM	憒
NGJN	憓
NWYO	憔
NWGU	憕
NFKK	憘
NKKL	憚
NSJF	憛
NBDE	憜
YKBN	憝
NYKT	憞
NSOY	憟
DUBN	憠
NTGI	憡
NFFQ	憢
NTOL	憣
OOPN	憥
NOOE	憦
NUJF	憧
TDTN	憩
NUEG	憪
NUYY	憫
NJYI	憬
NDUI	憭
NRLO	憮
NAQJ	憯
NCNK	憰
NYKY	憱
NVAF	憳
NKUN	憵
NSSH	憷
NWGW	憸
NMAE	憹
NQDY	憺
NYLG	憻
AQKN	憼
NAQN	憽
NRYT	憿
NAKE	懄
NHAE	懅
NKKS	懆
EVEN	懇
NQEG	懈
SCNN	懋
NLFF	懌
NYLT	懍
NFWK	懎
NWYM	懏
NEPT	懓
DJEN	懕
QTDN	懖
NFOO	懗
IAQN	懘
NEGW	懙
NEAN	懚
NFKF	懛
NALQ	懜
NXTH	懝
NAPE	懞
OGUN	懟
NYUJ	懠
NOSC	懡
NAHL	懢
IAMN	懣
NFNF	懤
NFPH	懥
NFDJ	懦
NPNS	懧
NDJY	懨
NUFE	懩
NJAI	懪
NRRM	懫
OAMN	懬
NOAW	懭
NDET	懮
NQYJ	懰
NALY	懱
NDHN	懳
NFHY	懴
NALH	懵
NYLE	懷
HITN	懸
NYKE	懹
NUXW	懻
NAKY	懽
NBBB	懾
FPGN	懿
YXXN	戀
AKFN	戁
NOSD	戂
NIPO	戃
NHHC	戄
UJFN	戇
AGNY	戈
GNXY	戉
DXYI	戊
DGXY	戌
DNXY	成
NHDA	戕
AKGD	或
MGKA	戙
DHAU	戛
DEPA	戞
FJFA	戟
UJXY	戠
ADWA	戡
KBXY	戢
WGDA	戣
BCLA	戤
JTGA	戥
ILAY	戦
WYVA	戧
SKSA	戨
GCCA	戩
FWYY	截
DEAG	戫
PGMA	戭
HAOA	戯
HAJA	戱
HAGA	戲
HHWA	戵
YNNV	戹
YNNN	戺
YNDI	戻
NAGN	戼
YNUF	戽
YNDY	戾
YNYE	房
YNMA	扁
YNHK	扂
YNMK	扃
YNQQ	扅
YNND	扇
YNKC	扈
YNOO	扊
RTGH	手
RGHG	扌
RTYY	扖
RDYY	扙
RGFH	扜
RFNN	扝
RNFH	扟
RCYY	扠
RTNN	扢
RGQN	扤
RTAN	扥
RTFH	扦
RVYY	扨
RNHF	扭
RBYY	扱
RWYN	扲
RRCY	扳
RWJH	扴
RWUY	扵
RFWY	扶
RTDY	扷
RTHN	扸
RQAN	扺
RQWY	扻
RDBN	扼
RGBN	扽
RFCY	技
RCQN	抁
RYHY	抃
RITT	抄
RNWY	抉
RPQN	抌
RTAH	抍
RFQN	抏
RDHY	抔
RXNN	抝
RNYY	択
RQUG	抣
RGMW	抦
RKWY	抧
RGUF	抨
RMFG	抩
REGG	抯
RMDY	抰
RQNN	抱
RSKG	抲
RNXN	抳
RANN	抴
RRWY	抶
RDHG	抷
RTPY	抸
RGSY	抹
RFIY	抺
RJHH	抻
RNAN	抿
RKQN	拀
REKG	拁
RTHF	拃
RYGG	拄
RRYY	拆
RWFY	拊
RUGH	拌
VCRJ	拏
RAFG	拑
RDCY	拔
RPXN	拕
RTBN	拖
RXET	拗
RDFH	拜
RRGG	拞
RTWN	拠
ROCY	拡
RHGH	拤
RVEY	拫
RTDG	括
RFKG	拮
RWTF	拰
RAWY	拱
AWRJ	拲
RWGG	拴
RDHB	拵
RVQY	拶
RQQY	拸
REEE	拹
RGMI	拺
RDOY	拻
RUAH	拼
RJXT	拽
RWGK	拾
RREY	挀
RGCF	挃
RIGQ	挄
RBSY	挅
RWSY	挆
RXJG	指
DHVR	挈
RAHH	挋
RTKG	挌
RDFN	挎
RMGK	挏
VKRJ	挐
RQIY	挑
RGQJ	挒
RPTA	挓
RYEY	挔
RPWN	挖
RGXW	挗
RITE	挘
IGWR	挙
RGOG	挜
RVFY	挦
RWKQ	挩
RWWF	挫
RFPB	挬
RGJR	挭
RUXT	挮
RKGG	挰
RIIT	挱
IITR	挲
RGVA	挳
RTXY	挴
RGAH	挵
RNNK	挶
RDTB	挷
RHQN	挸
RKCN	挹
RTHP	挻
REVG	挼
RDWW	挾
RTDH	捀
RVTK	捃
RGIY	捄
RFOY	捇
RWGS	捈
REBG	捊
REFY	捋
RKEJ	捌
RJFG	捏
RKEG	捐
RJGY	捑
RGKI	捒
RAHB	捓
RQEH	捔
RGEY	捕
RHHT	捗
RCWT	捘
RKKG	捛
RJHC	捜
RUKQ	捝
RRGW	捠
RNTN	捤
RPQB	捥
RDWG	捧
RWFK	捨
RYNY	捩
RQAJ	捪
ROWF	捬
RRTF	捭
RGCJ	捯
RJSY	捰
RDFF	捱
RUDB	捲
RRGM	捳
RWCN	捴
RMAW	捵
RVIY	捸
RDFA	捹
RDFI	捺
RTVG	捼
RYWF	捽
RPHN	捾
RGVV	捿
RDEY	掁
RWGA	掄
RGEG	掅
RMUM	掆
RCCC	掇
RUKG	掊
ROQY	掋
IPKR	掌
RJXX	掍
RDSK	掎
RQEG	掐
RADW	掑
RHDD	排
RHGC	掓
AHNR	掔
RFWT	掕
RYWY	掖
RGFG	掗
RGMY	掚
RFFH	掛
REQN	掜
RAKG	掝
ROOY	掞
RPGH	掟
RESY	採
REEG	掤
RJQR	掦
RPWA	控
RWYG	推
RBCY	掫
RQOY	掬
RGDN	掭
RYNE	掮
RHEG	掯
RWVR	掰
RRRJ	掱
RJQX	掲
RWGB	掵
ROVW	掶
RBLG	掹
RCJY	掻
RUOG	掽
RXGE	掾
RADK	掿
RGLI	揀
RHMY	揁
RUSG	揂
RUEJ	揃
RWGJ	揄
DGAR	揅
RWGD	揆
RFMF	揇
RQYG	揈
RGKL	揊
RLNY	揌
RDWD	揍
RPGG	揎
RALG	描
REAG	揑
RTFE	插
RYTB	揓
RQRN	揔
RADN	揕
RKBG	揖
RRFH	揗
RYNA	揙
RQMD	換
RUJG	揞
RNHE	揟
RAJV	揠
RPTK	揢
RVCB	揤
RYUH	揥
RGKJ	揦
GKIR	揧
RYKS	揨
TORJ	揫
RPWY	揬
RJQN	揭
RTGF	揰
IEJR	揱
RANS	揲
RDHD	揳
RVGP	揵
RBBH	揶
RSJG	揸
RUXE	揹
REFB	揺
RDGY	揻
RDIY	揼
RJLG	揾
RUKN	搃
RAMF	搆
RPWK	搈
RQBT	搊
RRHW	搋
RNAE	搌
RBTI	搎
RYXL	搐
RABG	搑
RYUY	搒
RUGA	搓
RCYJ	搔
RFCL	搕
RQRM	搖
RFTJ	搘
RUVO	搛
RTHY	搝
RYKK	搞
RLFH	搟
RUBE	搠
RCCS	搡
RGOJ	搢
RUWL	搤
RWNP	搥
RXUU	搦
RYNN	搧
RJNG	搨
RQAS	搩
TEWR	搫
RTEC	搬
RSSY	搮
RMEG	搰
RNUF	搱
RPDK	搳
PAWR	搴
RLWL	搵
RWYK	搶
RFHW	搷
RDWT	搸
RGKH	搹
RUDR	搼
RAWS	搽
RPWF	搾
RWGR	搿
RWNO	摀
RLDN	摁
RBIY	摂
RAMY	摃
RPWQ	摉
RRSC	摋
RUTG	摌
RPWJ	摍
RNWE	摎
RDWE	摏
RTWH	摐
RLAG	摑
RTDP	摓
RAQH	摕
RWFI	摖
RGKW	摗
RYUD	摘
RLPY	摙
RIPF	摚
RYRC	摛
RXFM	摜
RONX	摝
RLXI	摞
RTLN	摠
RVCQ	摡
RHAF	摢
RHAG	摣
RDRR	摤
RTJR	摥
RDFY	摦
RMWY	摧
RNIG	摨
RFWQ	摫
RUJQ	摬
ROAO	摭
FWFR	摰
RJLC	摱
RLRH	摲
RAKK	摳
RFFN	摴
RGJF	摶
RVJS	摷
AJDR	摹
RNRG	摺
RAHF	摼
RSFI	摽
RXKJ	摾
RWUJ	摿
FNWR	撀
RYXG	撁
LWCR	撃
RDUW	撅
UMIR	撆
ROOE	撈
YKBR	撉
RUEG	撊
RUGG	撋
RKHM	撌
RAQJ	撍
RFPU	撎
RVAF	撏
RFFQ	撓
RJYI	撔
RADR	撕
RNBT	撖
RAMW	撗
RTWK	撘
RUSF	撙
RQDO	撚
ROQH	撛
RWGU	撜
RETO	撝
RTDK	撟
RFJA	撠
RCCN	撡
RSJF	撢
RXQC	撧
RWYO	撨
RDUI	撩
RCDL	撪
RTFN	撬
RTOL	播
RJBC	撮
RBDE	撱
RQQW	撳
RYKT	撴
RAGF	撶
RIPQ	撹
RFUP	撻
RDGN	撼
RRYT	撽
RMNP	撾
RWGW	撿
RYXY	擁
RFLG	擂
RMAE	擃
RYLG	擅
RAFJ	擆
RLFF	擇
ROGI	擈
RLQJ	擉
LBWR	擊
RTDW	擌
RKKS	操
AQKR	擎
RAQT	擏
RLGE	擐
RKBY	擑
RWYC	擒
RAIY	擓
RWYM	擕
RAJN	擖
RNKF	擗
NKUR	擘
RTMD	擙
RHAE	據
RAAS	擛
RFMY	擜
RJEL	擝
RGWR	擟
RYUJ	擠
RFKF	擡
RFNF	擣
RTHJ	擤
EGNR	擧
RFDJ	擩
DJER	擪
RDJY	擫
RAWC	擭
RUTK	擱
RTVB	擳
ROSR	擵
RTUJ	擶
RFKM	擷
RVLN	擸
RAKW	擹
RLVT	擻
RQOJ	擼
RRXS	擽
RYUP	擿
SRRR	攀
RUFE	攁
RLLL	攂
RAWI	攃
RHAN	攄
RFWM	攅
RPDN	攇
RONT	攈
RDTH	攊
RGKM	攋
RLLE	攌
RHAL	攎
RUED	攏
RPAE	攐
RPAH	攓
RUGI	攔
RWWG	攕
RMMV	攖
RONO	攗
RYKE	攘
ROOK	攚
RLXY	攞
ROSD	攠
RYRY	攡
RTFM	攢
RAKY	攤
RTHI	攥
RGMX	攦
RFHM	攧
RIPO	攩
RHHC	攫
RXGJ	攭
RGKE	攮
FCEE	攰
UFCY	攱
DSKC	攲
FCVF	攳
TTGY	攵
NHTY	收
GNTY	攷
WHTY	攸
NNTY	攺
WVTY	攽
GHTY	政
HKHC	敁
QKTY	敂
NNAT	敃
WGKC	敆
GMIT	敇
TKTY	敋
WGSC	敍
RDBT	敎
TXTY	敏
DFET	敐
GIYT	救
WJHT	敒
WKQT	敓
GKTY	敔
GKIT	敕
GQTY	敖
WGST	敘
UKQT	敚
WYNT	敜
UMIT	敝
MAWT	敟
JQRC	敡
JSHC	敤
OOHC	敥
UKTY	敨
IPBT	敩
CCCT	敪
RYTY	敫
AQKT	敬
JGQT	敭
TFEC	敮
NNAC	敯
MGKC	敱
YKMC	敲
MGKT	敳
BGJT	敶
HPTT	敹
TDKC	敽
UGUT	敾
TDKT	敿
LQJC	斀
LFUT	斁
WGKT	斂
FITW	斄
ERRC	斅
ERRT	斆
YFHY	斌
YHQB	斍
YJFI	斎
YYVE	斏
HDHY	斐
GYGG	斑
YJEW	斔
OUFH	料
CCPF	斚
QEHF	斛
WGSF	斜
KKPF	斝
EWUF	斞
AMWF	斢
LQJF	斣
RTTH	斤
NHDR	斨
QKRH	斪
AJRH	斮
ADWR	斯
USRH	新
NNGR	斲
AKGR	斳
OQAR	斴
QYVR	斵
XXGR	斷
NILR	斸
YWJH	斺
YTWN	斻
YTBN	施
YTMH	斾
YTBG	斿
YCIY	旀
YTRH	旂
YTMY	旃
YTTN	旄
YRMH	旆
YTHC	旇
YYCK	旈
YRNY	旊
YTNH	旋
YTTG	旌
YTWC	旍
YTNX	旎
YTQI	旐
YDSK	旑
YTYK	旒
YTIE	旓
YVGP	旔
YWUX	旕
YTDK	旖
YTOL	旙
YTSI	旚
YTTL	旛
YTYG	旜
YTWJ	旝
YTUP	旞
YTEW	旟
RXAQ	旣
MNMQ	旤
JQYY	旳
JGFH	旴
JNRT	旸
JGBN	旽
GBNJ	旾
JTFH	旿
JQUG	昀
JGMH	昁
JDWU	昃
JRCY	昄
JBYY	昅
JTAJ	昇
JYNT	昈
JGDU	昊
GDJF	昋
QAJF	昏
JWVT	昐
JWYN	昑
JQRT	昒
JYWU	昗
DUJF	昚
JANG	昛
JGQR	昜
THJF	昝
JGMW	昞
JTGF	星
JYXY	昡
JBMH	昢
JWET	昣
DWJF	春
JDJJ	昦
JFIY	昧
JTHF	昨
JGSY	昩
JCAJ	昪
JQKG	昫
JVKG	昭
JAER	昮
JGHF	昰
JXJH	昲
JRWY	昳
JQTB	昴
YNIJ	昶
JTUY	昸
JYNI	昹
JABJ	昻
JDXY	昽
JOCY	昿
JQIY	晀
JQIU	晁
JIGQ	晃
JGJG	晅
JDFN	晇
JTMK	晌
JMGK	晍
JAWY	晎
JPVF	晏
JYNW	晐
JWYK	晗
JJFH	晘
JCWT	晙
JQKQ	晚
JUXT	晜
JRDH	晞
JDNY	晟
JGEY	晡
RRJF	晢
JRRH	晣
JGKG	晤
JPFQ	晥
JTXY	晦
JTFK	晧
JDFE	晨
JMAW	晪
JHJF	晫
JYWF	晬
JYKI	景
JSRH	晰
JOOY	晱
JEQN	晲
SRJF	晳
JGEG	晴
JTHK	晷
JDJN	晻
JSSY	晽
JJJG	晿
JTYG	暀
JFAQ	暁
JHDD	暃
JPGG	暄
JNGG	暅
JPLH	暉
JDMY	暊
JWGD	暌
JJQN	暍
JAMD	暎
JNKH	暐
JFTJ	暑
JJTG	暒
JGLI	暕
JJGR	暘
JERM	暚
JUGA	暛
JTHS	暞
JMGU	暟
JYKK	暠
JWCN	暡
JRNO	暣
JRDF	暤
JJPV	暥
DSSJ	暦
VCAG	暨
JWFI	暩
JAMY	暪
LRJF	暫
JRIF	暭
AJDJ	暮
JTWH	暰
JAAK	暱
JDHV	暳
JAKW	暵
JYTH	暶
JDUI	暸
JWYP	暹
JJYI	暻
UMIJ	暼
JOQH	暽
JYKT	暾
JFKK	暿
JFPU	曀
RXAG	曁
JVIP	曃
JAGF	曄
JAGG	曅
DTTJ	曆
JFFQ	曉
JXJM	曊
JSJF	曋
JEPA	曌
JLFF	曎
JXTB	曏
JJJE	曑
JRYT	曒
JBMF	曓
JAQT	曔
JOGI	曗
JTGO	曛
JNWY	曜
JJAI	曝
JPDI	曢
JAKO	曣
JHAL	曥
JGKJ	曧
JUED	曨
JLXY	曪
JGMX	曬
JIPO	曭
JKKT	曮
JNIJ	曯
JHNG	曰
JXYI	曵
QRJF	曶
JQWN	曷
GMJF	曺
JQAH	曻
ULJF	曾
FWFJ	替
JBER	朂
WGLJ	會
JHGI	朄
FCJN	朅
ULJR	朆
WGLF	朇
EEEE	月
EFQN	朊
EWVT	朌
EWYC	朎
EBMH	朏
EQKG	朐
MUAN	朑
EMWW	朒
EQIY	朓
EYVE	朖
YVCE	朗
ECWT	朘
MWME	朙
YNJE	朚
EYKB	朜
ADWE	期
EAMD	朠
ERBT	朡
AHNG	朢
EUJF	朣
MUOE	朥
EUED	朧
SSSS	木
SGHY	朩
FQYI	朮
SNHH	朻
STYY	杁
SFNN	杇
SCYY	杈
SWYY	杋
SGQN	杌
SFTT	材
SVYY	杒
SQYY	杓
STAN	杔
SDYY	杖
YNSU	杗
SAYY	杙
STNN	杚
GKII	束
SGQT	杤
SYNN	杧
SITT	杪
SFQN	杬
SGMH	杮
GJII	東
SQWY	杴
STFH	杵
SWCY	杸
SWXN	杹
SNHF	杻
SCNH	杼
WCSU	枀
SQUG	枃
SGAH	枅
SXXN	枇
XXSU	枈
SQBH	枊
SWVT	枌
SWGN	枍
SFWY	枎
SMFG	枏
SGXG	枑
SAHT	枒
SWYN	枔
STDY	枖
SMWY	枘
SDBN	枙
SRHY	枛
SFCY	枝
SVFH	枠
STAH	枡
SYNT	枦
SMQN	枧
SWCU	枩
SMYG	枬
SHKG	枮
SGUF	枰
SCKG	枱
CKSU	枲
SKWY	枳
SKVT	枴
SKGN	枵
SQKG	枸
SQNN	枹
SGSY	枺
SANN	枻
ANSU	枼
FASU	枽
SFJG	枾
SFAH	枿
SHCY	柀
SPXN	柁
STBN	柂
SWYC	柃
SGMW	柄
SNXN	柅
SUGH	柈
STPY	柉
STUY	柊
WAYS	柋
SNGK	柌
SMDY	柍
SWFY	柎
IASU	柒
CNHS	柔
SCNT	柕
SVKG	柖
SWKG	柗
SJHH	柛
SRYY	柝
STHF	柞
SQAY	柢
SRWY	柣
SJGF	查
SJGG	柦
SRCY	柧
SDMH	柨
SAQY	柩
SXET	柪
SXJH	柫
SDCY	柭
SBMH	柮
SSKG	柯
SNTT	柲
HXSU	柴
SKQN	柷
SDHG	柸
STNT	柹
SKET	柺
SEGF	査
SYMH	柿
SRGQ	栃
IPSU	栄
GKHU	栆
STGG	栍
SYNI	栐
SQJG	栒
DHVS	栔
SAHH	栕
SQQY	栘
SUDY	栚
SEEE	栛
SGMI	栜
STDG	栝
GDFS	栞
SUAH	栟
WTFS	栠
SDJG	栢
SWTF	栣
SUIY	栤
UQWS	栥
SYTH	栦
SJXT	栧
SUQW	栨
SRIY	株
SDHB	栫
SQCN	栬
SDMJ	栭
SDEG	栯
SWAY	栰
SAWY	栱
SFTN	栲
SFTX	栳
STMY	栴
SGQJ	栵
SLDY	栶
SXJG	栺
SWDY	栿
QAHS	桀
STGS	桁
SIGQ	桄
SQDB	桅
VKSU	桇
SPVG	桉
UDSU	桊
SGXW	桋
SDFN	桍
SABH	桏
CCCS	桑
SFKG	桔
STLG	桖
SBSY	桗
SWNN	桘
SCTG	桙
SVQY	桚
SHGH	桛
SIVG	桜
SQAH	桝
SDXY	桟
SVFY	桪
SIIT	桫
IITS	桬
SDFE	桭
SDHK	桮
SKGG	桯
SQAK	桰
SGVA	桱
SFPB	桲
SCDF	桳
SEBG	桴
SEVG	桵
SCEH	桶
SQEH	桷
SRDH	桸
SYVE	桹
SGJN	桺
STDH	桻
SWIU	桼
SWWF	桽
SVTK	桾
SJFH	桿
SGKI	梀
SGIY	梂
STFP	梃
SSGG	梄
STXY	梅
SDTB	梆
RRSU	梊
SKEG	梋
SWGS	梌
SRXN	梍
STFK	梏
SXXF	梐
SQTO	梑
SUFH	梓
SRGC	梔
SVYN	梕
SHQN	梘
SKKH	梙
SQKQ	梚
SNGB	梛
SDWW	梜
SNNY	梞
WVGS	梟
SKKG	梠
SPFQ	梡
SIEG	梢
SMWN	梣
SMWV	梤
PWCS	梥
SGKG	梧
SJFG	梩
SGKU	梪
SVPC	梫
SMGN	梬
SCWT	梭
SNNK	梮
SAAH	械
SLSY	梱
SWKQ	梲
STHP	梴
SSWY	梵
SNTN	梶
HKCS	梷
STJH	梸
SRGW	梹
SSGH	梺
SWXJ	梻
SDTF	梼
SFNY	梽
SGUS	梾
SLPY	梿
SUKQ	棁
TQTS	棃
STGI	棅
SWGA	棆
SWCN	棇
SGEG	棈
ADWS	棊
SESY	棌
SPWS	棎
HDHS	棐
SHDD	棑
SUKG	棓
SQAJ	棔
SDEY	棖
GMII	棗
SYNY	棙
SEEG	棚
SYCE	棛
SYWU	棜
SLDG	棝
SLTY	棞
SGJI	棟
IPKS	棠
SMUM	棡
SMUN	棢
SVIY	棣
SAJG	棤
SRRS	棥
SQVH	棦
SAAY	棧
YNTS	棨
SOOY	棪
SUDB	棬
SYWY	棭
SSSU	森
STFG	棰
SCCC	棳
SEBC	棴
SJSY	棵
SSWW	棶
SBCY	棷
BCSU	棸
AWVS	棻
SSWV	棼
SSWN	棽
SSPW	棾
SEQN	棿
SPQB	椀
SHAW	椃
SUVG	椄
SMFK	椆
SHWY	椇
SQOY	椈
YQAS	椉
SYWF	椊
SYKI	椋
SPWA	椌
SWYG	椎
SGFG	椏
SNDG	椐
SRTF	椑
SHGC	椒
SGEY	椓
SVLG	椔
SWVS	椕
SPGH	椗
SSPU	椘
SJJG	椙
SAWX	椛
FWMS	椝
SRSU	椞
SGCJ	椡
SLGY	椢
SMAW	椣
SUDE	椦
SWGB	椧
SOWF	椨
SOVW	椩
SUOG	椪
SULH	椫
SPEG	椬
SCDE	椮
SMDJ	椯
SBBH	椰
STJT	椱
SNKH	椲
SLGE	椳
SWDC	椴
SNHC	椵
SRBT	椶
SDGY	椷
SYTB	椸
SADN	椹
SWKS	椺
SAJV	椻
STIS	椼
SUEJ	椾
SDWJ	椿
STKY	楀
SPTK	楁
SSJG	楂
SNGF	楃
SYNA	楄
SGKL	楅
SSVG	楆
SMNK	楇
SNHE	楈
SADK	楉
SGKJ	楋
SUTE	楌
SPLH	楎
SDFF	楏
SLWJ	楐
SWGD	楑
SLNY	楒
SWTJ	楓
SDHD	楔
SDAE	楕
SVCB	楖
SVGP	楗
SCNS	楙
SADG	楛
SGLI	楝
SLYT	楞
SYKS	楟
SFMF	楠
SUSG	楢
SNHG	楣
SQRN	楤
SEGC	楥
SPGG	楦
SAMD	楧
SHMY	楨
SWGR	楩
SANS	楪
SKBG	楫
SJQN	楬
OGUI	業
SFTJ	楮
SRFH	楯
SEWY	楰
SDWD	楱
SAFS	楳
SYUH	楴
SBKG	極
STOY	楸
SBCL	楹
SRGG	楻
RISU	楽
STJG	楿
SKKK	榀
SPGF	榁
SSLF	榃
SJLG	榅
SWGJ	榆
SPYH	榊
SVVV	榋
SNUH	榌
SNIE	榍
SDHT	榎
SUWL	榏
SNAE	榐
SXUU	榒
SNTL	榓
SYVB	榔
SGOJ	榗
TDAS	榘
SAWK	榙
SUGO	榚
SDWT	榛
SRSC	榝
SDRI	榞
SPUF	榟
SPJW	榠
SGXI	榡
SPGE	榢
SERM	榣
SQAS	榤
SJIQ	榥
FJFS	榦
SAHD	榧
SHAY	榩
SCOY	榪
SWYF	榫
SFKE	榬
STMF	榭
OOPS	榮
SJFF	榯
SYKE	榱
SLWL	榲
SOTP	榳
SABG	榵
SOVK	榶
SPWY	榷
SFJF	榸
SRHW	榹
EUDS	榺
SJNG	榻
SFCL	榼
SEXD	榽
SMEG	榾
SMGU	榿
YKMS	槀
SBTI	槂
TEWS	槃
SGKH	槅
SAQJ	槆
SXHW	槇
SUTD	槉
UBTS	槊
SAMF	構
SWNP	槌
SWYK	槍
SUGA	槎
SUVO	槏
KKSS	槑
SYXL	槒
SAMY	槓
SRDF	槔
SHJS	槕
FPDS	槖
SDKK	槗
SFHW	槙
SSMY	槚
SWYB	槜
SWVM	槝
SUJN	槞
SCCS	槡
SNRG	槢
SPDK	槣
SDHV	槥
SOVH	槦
LRSU	槧
SYKB	槨
RXAS	槩
SRXQ	槪
SGJF	槫
SDFY	槬
SDHY	槭
SCCE	槮
STDP	槰
SSGO	槱
SQEF	槲
NHDS	槳
SYNC	槴
SKKN	槵
SLAG	槶
FWFS	槷
SRIF	槹
SOVI	槺
SFWQ	槻
FWHS	槼
SGMJ	槽
SJLC	槾
SAKG	槿
SYUD	樀
SBGI	樄
SYRC	樆
SWHE	樇
SUJQ	樈
SDRR	樉
SRRD	樊
SCEP	樋
SXFM	樌
SGMY	樍
SPWJ	樎
SLXI	樏
SHLO	樐
SIVS	樑
SPNM	樒
SVJS	樔
SGKW	樕
WGKK	樖
SFFN	樗
SIPF	樘
SSFI	標
SONX	樚
SNWE	樛
SOAO	樜
SHAG	樝
SAKK	樞
SUJF	樟
SWVO	樢
SUGI	樣
SWHS	樤
SATH	樥
STYG	樦
SNIG	樨
SAHF	樫
STLN	樬
SADF	樭
SSOY	樮
SFVG	樰
SAFY	樲
SVAF	樳
SUJY	樴
SWYO	樵
SJBC	樶
SSBC	樷
SKHM	樻
SNBB	樼
SUSF	樽
SFHY	樾
SKKL	樿
SYCL	橀
STQJ	橁
SUSD	橂
SWXC	橃
SRLO	橅
RLGS	橆
STFN	橇
SFFQ	橈
SOQH	橉
SGJL	橊
STDK	橋
SUEG	橌
SUGG	橍
STOL	橎
SUGK	橏
GKHS	橐
SDUI	橑
SFFC	橒
SEPH	橓
SYKT	橔
SIPT	橕
SIPS	橖
SAJE	橗
SWGU	橙
SVFJ	橚
SDUW	橛
DUBS	橜
SSJF	橝
SYQE	橠
SPNH	橣
NNNS	橤
SULJ	橧
SFAM	橨
SOOF	橩
SQDO	橪
SDUF	橭
SQYM	橮
SOOE	橯
SEUE	橳
SHXI	橴
SAET	橵
SFJA	橶
SRUQ	橷
SJJJ	橸
SUJG	橺
SFUP	橽
SKKS	橾
SGLG	橿
SYLG	檀
SYLT	檁
SMAE	檂
BEAS	檃
SHDY	檅
SOOK	檆
SWYM	檇
SAWL	檋
SLHD	檌
SOGI	檏
SFLG	檑
SSWJ	檒
SEAC	檓
LBWS	檕
SUEP	檖
NKUS	檗
SNKF	檘
SHNN	檙
SSSH	檚
SMNP	檛
SKBY	檝
SQEG	檞
AQKS	檠
SLFF	檡
SWGW	檢
SFWK	檣
SUTP	檤
SUGY	檥
SSFJ	檦
SAQN	檧
SUGW	檨
SRIS	檪
SPWI	檫
SAPE	檬
SQVE	檭
SFNF	檮
SFKF	檯
SXRH	檰
STAW	檱
SLGF	檲
SPGM	檳
SAWC	檴
SDAK	檶
SGWR	檷
SPNS	檸
SYTK	檹
SAHL	檻
SEAN	檼
SFDJ	檽
DJES	檿
SADI	櫀
SPNJ	櫁
SNWY	櫂
STGO	櫄
SYUJ	櫅
SRQF	櫆
SHCM	櫇
SUTK	櫊
STHY	櫋
SDET	櫌
SRRM	櫍
SOAW	櫎
SSDP	櫏
LLLS	櫐
SLLL	櫑
SAWI	櫒
SQOJ	櫓
SDAY	櫔
SFWM	櫕
SHAN	櫖
SALY	櫗
SDHN	櫘
SAAK	櫙
SUKK	櫚
STVB	櫛
SFLM	櫝
SXXE	櫞
SRXS	櫟
SOWC	櫠
STFJ	櫡
SLVT	櫢
SALP	櫣
STUJ	櫤
SONT	櫦
SYFJ	櫧
SHAL	櫨
SUQE	櫩
SDTH	櫪
GEFS	櫫
SUSQ	櫬
SVCG	櫭
SGKK	櫮
SQOT	櫯
SYLE	櫰
BTWS	櫱
SCNE	櫲
SUED	櫳
SGKM	櫴
SAWO	櫵
SPDN	櫶
STXG	櫷
SEGG	櫸
SAVJ	櫹
SFKK	櫺
SMMV	櫻
SWWG	櫼
SERI	櫾
SMAS	欁
SAIF	欂
SQKY	欃
SEGR	欅
SBBB	欇
SMWK	欈
SOGC	欉
SAKY	權
SHHY	欋
SADY	欌
SAWE	欍
SLXY	欏
SGMX	欐
STFM	欑
SIPO	欓
SHHC	欔
SKKT	欕
SAHQ	欖
SAUI	欗
SNIJ	欘
SLLI	欙
SXGJ	欚
SFAE	欛
SGKE	欜
SFKW	欞
SAKQ	欟
UQWY	次
JQWY	欥
QKQW	欨
VKQW	欩
BMQW	欪
RHQW	欫
LDQW	欭
UBTW	欮
FKQW	欯
TLQW	欰
HMAW	欳
YVCW	欴
XTDW	欵
GKIW	欶
RDMW	欷
CTDW	欸
DSKW	欹
ADWW	欺
OOQW	欻
CCCW	欼
QQWY	欽
QEQW	欿
SFIW	歀
MDMW	歂
TFEW	歃
MNMW	歄
SFQW	歅
UJQW	歆
JQWW	歇
WGEW	歈
YKMW	歊
RHAW	歋
WNGW	歍
AKFW	歎
AKGW	歏
YUMW	歒
RWYW	歓
HAOW	歔
FKUW	歖
VFJW	歗
OOOW	歘
UGUW	歚
LQJW	歜
LFUW	歝
JXXW	歞
AKKW	歡
FHNY	武
HFCY	歧
HITR	歩
DHGH	歪
HANG	歫
HTEU	歬
HFFY	歭
HHHF	歮
HOBJ	歯
VYVH	歰
HTGF	歱
HDGY	歲
HGMY	歵
HXJY	歶
DTTH	歷
GQRH	歽
GQQR	歾
GQQC	歿
GQTD	殀
GQEG	殂
GQMD	殃
GQWE	殄
GQTG	殅
GQTL	殈
GQQJ	殉
GQGA	殌
GQEB	殍
GQDW	殎
GQGY	殏
GQGI	殐
GQDQ	殑
GQVI	殔
GQUK	殕
GQDN	殗
GQBG	殛
GQAS	殜
GQDT	殝
GQKM	殞
GQJL	殟
GQAH	殢
GQAG	殣
GQTR	殤
GQPW	殥
GQWO	殦
GQHO	殩
GQFU	殪
GQKL	殫
GQLF	殬
GQGG	殭
GQWW	殮
GQFM	殰
GQFY	殱
GQWG	殲
WDWC	段
YGWC	殶
FNWC	殸
ATDC	殹
FPWC	殻
RDEC	殽
FTJC	殾
NAWC	殿
LKWC	毄
AKKC	毆
EOWC	毇
QYTC	毈
ATDW	毉
FNWK	毊
XNNY	母
TXFJ	毎
FXDF	毐
TXYK	毓
XXNT	毖
LXXB	毘
QKXY	毚
TFNI	毜
TFNE	毝
XXTN	毞
ITTN	毟
EKTN	毠
TFNS	毢
WCQN	毤
BTFN	毦
TFNQ	毨
TFNG	毪
YKPN	毫
TFNY	毬
GKUN	毭
RITN	毮
TFNO	毯
TFNK	毰
TFNN	毳
TFND	毴
JHTN	毷
WGEN	毹
DAEN	毻
TFNP	毽
JNTN	毾
CCCN	毿
LVTN	氀
FITN	氂
IMKN	氅
TFNJ	氆
YLKN	氈
KKKN	氉
APFN	氋
HHWN	氍
LLLN	氎
QAYI	氐
QAFJ	氒
YNNA	氓
RNTR	氕
RNBR	氖
RNRI	気
RNJJ	氘
RNMJ	氙
RNKJ	氚
RNJD	氜
RNMW	氝
RNGW	氞
RNXJ	氟
RNTU	氡
RNLD	氤
RNSF	氥
RNYW	氦
RNPV	氨
RNDQ	氪
RNGG	氬
RNGI	氭
RNVI	氯
RNGE	氰
RNJR	氱
RNLL	氳
IIII	水
IYYG	氵
IHYY	氺
IGNN	汅
TYIU	汆
INGG	汈
ICYY	汊
IQYY	汋
IVYY	汍
IWYY	汎
ITAN	汑
IYNN	汒
ITNN	汔
ITFH	汘
IGFH	汙
IFNN	汚
IQAN	汦
IGAH	汧
IFJH	汫
FJIU	汬
IMWY	汭
IQUG	汮
IDCY	汯
IDYY	汰
IRCY	汳
IYHY	汴
IWYN	汵
INWY	決
ITGH	汼
IWVT	汾
ICNH	汿
IFQN	沅
ICQN	沇
IPQN	沈
PQII	沊
IDNY	沋
IGBN	沌
IGXG	沍
IWXN	沎
IAVT	沏
INHF	沑
IGHN	沔
IQRT	沕
GDIU	沗
IXXN	沘
IITT	沙
IGMH	沛
ITHN	沜
IRHY	沠
INYY	沢
IWRY	沨
IGSY	沫
IFIY	沬
IPXN	沱
ITBN	沲
IWET	沴
IVKG	沼
INGK	泀
IMKG	泂
IQKG	泃
ILWY	泅
IRWY	泆
IEKG	泇
ITUY	泈
IFAH	泋
IBMH	泏
IBET	泐
IXET	泑
IXCY	泓
IFCY	法
IQTB	泖
ITUF	泘
IGUF	泙
IHXN	泚
IQAY	泜
IRYY	泝
IGHG	泟
IWYC	泠
INYW	泤
INVN	泦
IGNY	泧
ITGG	泩
IYXY	泫
IPWY	泬
IWFY	泭
INAN	泯
IMDY	泱
ITNT	泲
IYNI	泳
IVEY	泿
ITEY	洀
IYOY	洂
IDOY	洃
ILKG	洄
IGMF	洅
IBIG	洆
ILDY	洇
IQDB	洈
IRGK	洉
IDHB	洊
IUGH	洋
IGQJ	洌
IAHH	洍
ITHG	洎
IDMJ	洏
ITGS	洐
IWDY	洑
IGMI	洓
IFFY	洔
IWEG	洕
IKGD	洖
ITFQ	洗
IFTN	洘
IRIY	洙
ITAH	洚
TKIU	洜
IPVG	洝
IMGK	洞
IGXW	洟
ICTG	洠
IDIY	洡
IWGG	洤
IDJG	洦
IYWR	洨
IAWY	洪
ITLG	洫
IWGQ	洬
IAGG	洭
IQIY	洮
DHVI	洯
IANG	洰
IYTH	洲
IUAH	洴
IQJG	洵
IGCF	洷
IIGQ	洸
IGJG	洹
IDFN	洿
IMAG	浀
IUDY	浂
IQVH	浄
IJGH	浉
IWAY	浌
IUTT	浐
INYU	浕
IEFY	浖
IGIY	浗
INTN	浘
IRGW	浜
IKHY	浞
IWHT	浟
IFPB	浡
IGKU	浢
IPFQ	浣
IPDC	浤
IKCN	浥
IGEY	浦
IKGG	浧
IPSY	浨
IPWF	浫
IJFG	浬
IGJR	浭
IGKG	浯
ITJH	浰
IDFE	浱
ITDH	浲
IAYE	浳
IWWK	浴
IMYE	浵
IPTG	浶
ITXY	海
IDWW	浹
INKH	浺
IMWK	浻
IQKQ	浼
IEVG	浽
IFOY	浾
IHQN	涀
ISET	涁
ILSY	涃
IMGN	涄
IJFH	涆
IVYN	涊
IPDY	涋
IFTB	涍
ITHP	涎
ITFP	涏
ITRY	涐
IGKI	涑
IVTK	涒
IKEG	涓
IMWN	涔
IUXT	涕
IWUG	涖
IWKQ	涗
ICTD	涘
IYND	涙
IUKQ	涚
IFPQ	涜
IKMY	涢
IPHN	涫
IFUF	涬
IEPC	涭
INMJ	涮
IDFF	涯
ICCC	涰
IDEY	涱
IPWA	涳
IPQB	涴
ITFG	涶
IGJI	涷
ILDG	涸
INDG	涺
IWFK	涻
IQAJ	涽
IIJG	涾
IUVG	淁
IJGF	淂
IUDB	淃
IRDE	淆
IADW	淇
INBM	淈
IJSY	淉
IQEG	淊
ISSY	淋
IIMK	淌
IMFK	淍
IDWG	淎
IJGD	淏
IJJG	淐
IAYT	淓
IFHG	淔
IFWF	淕
IHJF	淖
IPFI	淙
IYNY	淚
IECN	淝
ISWC	淞
IMAW	淟
ILGJ	淠
IOOY	淡
IAKG	淢
IEQN	淣
IYWU	淤
IXGI	淥
IPNT	淧
IFWT	淩
IWGA	淪
IYNS	淭
IYCE	淯
IHAW	淲
IYKB	淳
IQRN	淴
IJGG	淵
ISWW	淶
IGMG	淸
IIIU	淼
IAHG	淽
IRMH	淿
IDFA	渀
IIIY	渁
IJYY	渂
IADK	渃
IHDD	渄
IUAJ	渆
IJQX	渇
IYJG	済
IHIY	渋
IDSK	渏
IRTF	渒
IEFW	渓
IUDJ	渕
ICNS	渘
IFTJ	渚
IDGY	減
IWGJ	渝
IUTH	渞
IYKS	渟
IANS	渠
IWTJ	渢
ISJG	渣
IYUH	渧
ITKY	渪
IASK	渮
IJAG	渱
IXBG	渳
IALG	渵
IAMD	渶
IYWQ	渷
IQYG	渹
IHIT	渺
IITH	渻
IUGD	渼
IFKY	渽
IWGD	湀
IRWK	湁
IRDF	湃
INHG	湄
IGLI	湅
IUEG	湇
IAFS	湈
INTD	湉
IWYE	湌
IMDJ	湍
IDMD	湎
IDMY	湏
ISRG	湐
INHE	湑
IKBG	湒
IWVL	湓
IUEJ	湔
IVGP	湕
IDEG	湖
IFFF	湗
IYOD	湙
ITXN	湚
IXXR	湝
IHMY	湞
IRGG	湟
IMDO	湠
IJMY	湡
IGKL	湢
INNJ	湣
IYTB	湤
IJTG	湦
ICEE	湧
IHDY	湨
ITGF	湩
IXGE	湪
ITOY	湫
TOIU	湬
IUSG	湭
IDHD	湱
IEGC	湲
IFMF	湳
IUOG	湴
IUGY	湵
IDWJ	湷
IYKW	湸
IDJF	湹
IWKS	湺
IYKJ	湻
IEAG	湼
IGVL	湽
IAMM	満
IAPS	溁
IGKJ	溂
IMTG	溄
IOVG	溇
IYTO	溈
IVCQ	溉
INHC	溊
IBCL	溋
IWFQ	溌
IGOJ	溍
ISFF	溎
IOVK	溏
IDRI	源
IIMY	溑
IUVO	溓
IUGO	溔
IPFE	溕
IWYF	準
ITUX	溗
IFCL	溘
IDWI	溙
IAWK	溚
IAMF	溝
ICYJ	溞
IPJW	溟
IUGA	溠
IJFF	溡
IWWA	溣
ICOY	溤
IGEF	溥
IMGT	溦
IFSY	溨
IWNO	溩
IUFC	溬
ILWT	溭
IWNH	溮
IMGU	溰
IDWT	溱
IEHC	溲
ITHY	溴
IRVC	溵
IPWK	溶
ILGE	溷
IGXI	溸
IFPI	溹
IJNG	溻
IGXF	溼
IRQC	溾
ILUG	溿
IYXL	滀
IWCN	滃
IWYK	滄
IGKH	滆
IYKK	滈
IJIQ	滉
IRNO	滊
IWHS	滌
IBHJ	滍
IWRU	滏
IQAS	滐
IMEG	滑
ISKK	滒
IPUF	滓
IEEG	滔
EUDI	滕
IERM	滛
IUJN	滝
IDFK	滣
IYWT	滧
ICNM	滪
IWHE	滫
IJAF	滭
IHAE	滮
IAQH	滯
IUJQ	滰
IPFC	滱
IYUK	滳
IPNM	滵
IGQT	滶
IHLO	滷
IYTF	滸
IHAF	滹
IWHN	滺
IUTG	滻
IOVH	滽
IAMY	滿
FNWI	漀
IQOY	漁
ISFI	漂
IPHC	漃
IMDF	漄
IVJS	漅
ITHH	漇
IWFI	漈
IONX	漉
ILVG	漊
IBTG	漋
ILAG	漍
ITWH	漎
INFY	漏
IRXQ	漑
IXKJ	漒
IGMJ	漕
IFTT	漖
ITLN	漗
IGJF	漙
IAKK	漚
IUDI	漛
ISSF	漜
INRG	漝
IEHQ	漞
IIPF	漟
ITJR	漡
ILPY	漣
ISSV	漤
FITI	漦
ITDP	漨
IQTK	漪
IJLC	漫
IGMY	漬
IADA	漭
IOVI	漮
IMEE	漰
IGKW	漱
IMPI	漴
IKKN	漶
IGHO	漹
IDRR	漺
INWE	漻
INIG	漽
XIDM	潁
IMUG	潂
ITTE	潃
IGKT	潄
ITLE	潈
IMJX	潉
IWGC	潊
IUMT	潎
ICNK	潏
IWYO	潐
IQKE	潒
IGJN	潓
IRLO	潕
IGGC	潖
IWYS	潗
ITOL	潘
IETO	潙
IVFJ	潚
IWGN	潝
IEQO	潟
INNW	潠
IYKT	潡
IUYY	潣
ISOY	潥
IDUI	潦
IULJ	潧
ITLI	潨
ILAW	潩
ITDJ	潪
IKKL	潬
ISJF	潭
IVAF	潯
IFPU	潱
ITIE	潲
INFJ	潳
IAET	潵
ILFO	潶
ITVG	潷
ISSE	潸
ISSS	潹
INBB	潺
ITWI	潻
IUJF	潼
IUOJ	潽
IOQH	潾
ILNH	潿
IVYH	澀
IHHH	澁
EDMI	澃
IVFG	澅
IYCT	澈
INBT	澉
IUSF	澊
IJYI	澋
IADR	澌
IFKF	澍
IFKE	澎
IKKM	澏
IFFC	澐
IGJL	澑
IADM	澒
ITTT	澓
IRTK	澔
IAGF	澕
IUSY	澖
IUJG	澗
ISSJ	澘
IEGO	澙
ITMN	澚
IQGJ	澛
IPNH	澝
IHAD	澞
IYLT	澟
IKKS	澡
IIPL	澢
IFJF	澣
ITAW	澨
ERRI	澩
IFWC	澪
IAJY	澫
IUQM	澬
IHQO	澯
IWGW	澰
IOGI	澲
ITMD	澳
IUSR	澵
IYLG	澶
IJLY	澷
IDGN	澸
IQDY	澹
IUEP	澻
INKF	澼
IFUP	澾
ISSI	澿
IRYT	激
ILQJ	濁
IOUO	濂
IMNP	濄
IPVC	濅
IFAM	濆
IFWK	濇
IKBY	濈
IHWY	濉
ISSH	濋
TGJJ	濌
IHNN	濎
IGGT	濏
IJFJ	濐
IUTO	濓
ILFJ	濖
IAJH	濗
IPNS	濘
IOOO	濙
IOOS	濚
IAPE	濛
IVHL	濜
IADI	濝
ITHJ	濞
IYUJ	濟
IYKE	濠
IFDJ	濡
INYF	濢
IFNF	濤
IQPW	濥
IEAN	濦
IOGF	濧
IUXN	濨
IAWC	濩
IGEC	濪
IHPH	濬
IAFL	濭
IPGM	濱
IFPC	濲
ITFJ	濳
IUTD	濶
IIAY	濷
IMAA	濺
IBKM	濻
IRXS	濼
IFWM	濽
IHAN	濾
IDAY	濿
IDET	瀀
IUFE	瀁
IQOJ	瀂
IMJR	瀃
ITVB	瀄
IOAW	瀇
INPL	瀈
IPEO	瀉
ITEL	瀊
IPTL	瀋
IONO	瀌
IOJF	瀍
IALY	瀎
IFHY	瀐
ISWK	瀒
ITMT	瀓
IFWY	瀖
IPDN	瀗
IUSQ	瀙
IFJN	瀚
IGEH	瀞
IOOI	瀠
IBDP	瀡
IKHP	瀢
IHQG	瀣
IYLE	瀤
INYK	瀥
IGEJ	瀦
IUED	瀧
IGKM	瀨
ITWM	瀩
ILWJ	瀭
IFSS	瀮
IOOK	瀯
IXGR	瀰
ILDJ	瀱
IWGT	瀲
IAOO	瀳
IMMV	瀴
IOLW	瀵
IAHK	瀶
INLW	瀷
IWWG	瀸
IQKY	瀺
IFLY	瀻
IPAH	瀽
IUGI	瀾
ITXI	瀿
IFSH	灀
IURI	灁
IELF	灂
IMDU	灃
IBBB	灄
ILLF	灅
IAAL	灆
IOGC	灇
IHHY	灈
IVKY	灉
IONC	灋
IAKY	灌
IUUW	灍
IMAL	灎
IOOQ	灐
IGMX	灑
ITFM	灒
YXXI	灓
IMAC	灔
IYRY	灕
IOSD	灖
IJYG	灗
IIPO	灙
IERQ	灚
IUKL	灛
IJYM	灝
IFAE	灞
INIJ	灟
IAHQ	灠
IAUI	灡
IGKE	灢
IYXX	灣
RIRI	灥
IJXM	灦
IMDC	灧
IUJM	灨
IMDL	灩
ISRE	灪
OOOO	火
OYYY	灬
QYOU	灸
OTAN	灹
OWCY	炂
WVOU	炃
ONHF	炄
ODHY	炋
OWJH	炌
ORCY	炍
ODHH	炐
OITT	炒
ONWY	炔
OYWN	炕
OWXB	炛
OYHY	炞
OJGG	炟
OGHG	炡
OSYY	炢
OSKG	炣
OVKG	炤
OXJH	炥
ODCY	炦
OTBN	炧
OPXN	炨
OWYC	炩
OBMH	炪
OANG	炬
MDOU	炭
QNOU	炰
CKOU	炱
OCKG	炲
OMDY	炴
OTUY	炵
OYGG	炷
OTHF	炸
OKQN	炾
OTMY	炿
OTUF	烀
OYWR	烄
OTLG	烅
OTGS	烆
OWGG	烇
GQJO	烈
QMWO	烉
OUGH	烊
WSOU	烋
OWSY	烌
OTFQ	烍
GAOU	烎
WNGO	烏
OTEY	烐
OQIY	烑
OAAY	烒
OFFG	烓
OMGK	烔
DGOY	烕
FOXY	烖
OYNW	烗
OAWY	烘
OWGK	烚
OGJG	烜
BIGO	烝
OSHY	烞
OAWU	烡
OPTA	烢
ODOY	烣
OAHH	烥
OUDY	烪
ORDH	烯
OEBG	烰
OMWK	烱
RROU	烲
OGVA	烴
OAQY	烵
OPFQ	烷
OTXY	烸
OYVE	烺
OTHP	烻
OOFF	烾
OMYE	烿
KQWO	焁
OFOY	焃
VTKO	焄
OTFK	焅
OKEG	焆
OIEG	焇
YNNO	焈
NHDO	焋
OCWT	焌
OUXT	焍
BKCO	焏
OGKG	焐
OLSY	焑
OKKG	焒
OWYK	焓
OQHJ	焔
ONNK	焗
SSOU	焚
OJXX	焜
OQAJ	焝
OAJG	焟
RLGO	無
OPWA	焢
BCOU	焣
OWFO	焤
OPQB	焥
WYOU	焦
OWCN	焧
OJEG	焨
OEEG	焩
OPWX	焪
OJQR	焬
OOPW	焭
ORQW	焮
OHJF	焯
OOOU	焱
OYWY	焲
OWYG	焳
OYCE	焴
OMUM	焵
QDYO	然
JJOU	焸
OMUN	焹
OJTA	焺
OJJG	焻
OFAQ	焼
JEOU	焽
OOVW	焿
ONBM	煀
OADN	煁
OAKF	煂
ODFF	煃
OTGF	煄
OWDC	煅
ONHC	煆
OPLH	煇
OWTJ	煈
OPGG	煊
OJTG	煋
ORGG	煌
OTOY	煍
OGKL	煏
OAMD	煐
ONKH	煒
OMDJ	煓
OOHK	煔
AHHO	煕
OEGC	煖
ODMD	煗
ODGY	煘
JANO	煚
HHOU	煛
OJUG	煜
ONHG	煝
OLEG	煟
OANS	煠
OVGP	煡
JQKO	煦
OLGE	煨
ODMY	煩
OUSG	煪
OUEY	煫
OJGR	煬
VGQO	煭
FTJO	煮
OXXR	煯
OKKK	煰
OMNK	煱
WKSO	煲
OJLG	煴
OFMF	煵
OJGH	煶
OYKW	煷
OYNA	煸
OAMF	煹
OVEP	煺
OQBT	煼
OLDN	煾
OGEF	煿
OJIQ	熀
OEEE	熁
ORNO	熂
OLWL	熅
OYKK	熇
TAHO	熈
OKMY	熉
CEXO	熊
OUWY	熌
OPKK	熍
OERM	熎
OPJW	熐
OOPO	熒
OWNO	熓
OAMY	熕
OQYL	熘
OJAF	熚
OSFI	熛
OTLN	熜
OAHF	熞
YKBO	熟
ONRG	熠
OLVG	熡
OTDP	熢
OMWY	熣
ONUG	熤
OCEP	熥
OIWY	熦
TWWO	熧
NFIO	熨
OYNC	熩
OTQQ	熪
OOAO	熫
GQTO	熬
DHDO	熭
OAKW	熯
OAKK	熰
FWFO	熱
XODM	熲
OJLC	熳
OMJX	熴
OYUK	熵
OJBC	熶
OULJ	熷
OAQJ	熸
FKUO	熹
OFKK	熺
OWGN	熻
OVFJ	熽
OKKL	燀
OAGF	燁
OSJF	燂
QEOO	燄
OTDK	燆
OUSF	燇
OYKT	燉
OOOS	燊
OWYO	燋
OFAM	燌
OCNK	燏
OOQH	燐
OUJF	燑
SRRO	燓
OTOL	燔
AKUO	燕
OVAF	燖
OUEG	燗
OUYY	燘
IJGO	燙
NHAO	燛
OUNY	燜
OJYI	燝
WYQO	燞
OTMD	燠
OLFF	燡
OAJY	燤
OUEP	燧
OUGY	燨
ORYT	燩
OAQN	燪
OOUO	燫
OEAC	燬
YOOC	燮
OFWC	燯
OEPT	燰
OUJN	燱
OEEM	燲
OJVO	燳
OWGJ	燴
OFUP	燵
OMAE	燶
OYLI	燷
GEGO	燹
OYKS	燺
OTGO	燻
OVHL	燼
OFNF	燽
FNAO	燾
OFOO	爀
OAHL	爁
AFWO	爇
OHAN	爈
OVLN	爉
OONO	爊
OOAW	爌
ORXS	爍
OPDI	爎
ODTH	爏
OHAL	爐
OAWO	爑
QODI	爒
OUQE	爓
YOOO	爕
OHQE	爘
OYKE	爙
OWGA	爚
OOGC	爜
OELF	爝
OJJJ	爞
OAKY	爟
OHHY	爠
OAJJ	爡
OIPO	爣
OAUI	爤
ONIJ	爥
OAHQ	爦
OFKW	爧
EMGO	爨
OSRE	爩
RHYI	爪
RHYC	爬
RHYN	爮
EMFF	爯
EGDC	爰
ETNO	爲
ETNB	爳
LAKY	爴
WRBB	爺
RREG	爼
NHDH	牅
NHDK	牆
THGN	片
THGG	牉
THGK	牊
THGA	牋
THGF	牌
THGJ	牏
THGE	牐
THGS	牒
THGY	牖
THGH	牗
THGM	牘
AHTE	牙
IPKT	牚
PTGJ	牢
TVYY	牣
TYNN	牤
TTFN	牦
TYWN	牨
TTGH	牪
WAYG	牮
TSKG	牱
TTGG	牲
TQAY	牴
UDTG	牶
TWGG	牷
TPBG	牸
TFFY	特
TDNY	牻
TGKG	牾
TTFK	牿
TQTG	犂
TUKG	犃
TDSK	犄
TMUM	犅
TGTG	犇
TUDB	犈
TYKB	犉
THWY	犋
TVGP	犍
FFFG	犎
TTUF	犐
TQBT	犓
TRNO	犔
TATH	犕
OOPG	犖
TPDK	犗
OSSG	犘
TCCE	犙
NFIG	犚
FITG	犛
TYKT	犜
TTDK	犞
XKJG	犟
TDAY	犡
TFLM	犢
TVLN	犣
TLCX	犤
TONO	犥
TJAI	犦
TUGY	犧
WYWG	犨
TVRG	犩
TUTT	犪
QTTT	犭
DCYI	犮
QTBN	犯
QTVY	犱
QTFT	犲
QTQY	犳
QTFH	犴
QTTN	犵
QTCG	犸
QTYW	犺
QTGH	犻
QTAT	犽
QTDY	犾
QTYH	犿
NHDY	狀
QTCQ	狁
QTGG	狂
QTNF	狃
QTOY	狄
QTTF	狅
QTKH	狆
QTSY	狇
QTDG	狉
HDYU	狊
QTFI	狋
QTTG	狌
QTQN	狍
QTLH	狎
QTTB	狏
QTRY	狐
QTWC	狑
QTXJ	狒
QTHC	狓
QTNX	狔
QTXE	狕
QTPW	狖
QTGY	狘
QTRG	狛
QTQI	狝
QTTK	狢
QTQJ	狥
QTMF	狦
QTTD	狧
QTAD	狨
QTFX	狫
QTWS	狳
QTXF	狴
QTRH	狶
QTKE	狷
QTDW	狹
QTYG	狺
QTCT	狻
QTYE	狼
QTMY	狽
QTRR	狾
QTTP	狿
QTIT	猀
QTTJ	猁
QTJF	猂
QTYI	猄
QTHD	猅
QTHW	猇
QTRF	猈
QTAW	猉
QTEQ	猊
DYDY	猋
SWWY	猌
QTSW	猍
QTJX	猑
JEDY	猒
QTJS	猓
QTPI	猔
QTDK	猗
QTRJ	猘
QTWY	猚
QTYF	猝
QTWK	猞
QTIG	猟
QTMW	猠
QTDE	猢
QTRT	猣
QTLE	猥
QTEC	猨
QTJG	猩
QTMJ	猯
QTDD	猰
QTCS	猱
QTJN	猲
QTNC	猳
QTWD	猴
QTYA	猵
QTUG	猶
USGY	猷
QTNH	猸
QTSG	猹
QTEM	猺
QTBI	猻
QTME	猾
QTFE	猿
QTCO	獁
MGKY	獃
QTYY	獄
QTWH	獅
QTUC	獇
QTUL	獈
QTDT	獉
QTJC	獌
QTUQ	獍
QTUF	獐
QTLR	獑
QTGT	獓
UMIY	獘
QTUT	獙
QTOH	獜
QTCK	獝
QTDI	獠
QTEO	獡
ILGY	獣
QTYT	獤
QTAN	獦
QTHY	獩
QTWJ	獪
QTWW	獫
QTQG	獬
QTGR	獮
QTTO	獯
QTPM	獱
QTFJ	獳
QTAE	獴
QTVN	獵
QTOW	獷
QTHL	獹
QTGM	獺
HAGY	獻
QTXR	獼
QTAY	獾
QTLY	玀
QTKT	玁
QTAR	玂
YXIT	玅
YXYX	玆
GGGG	王
GQYY	玖
GGFH	玗
GGNG	玙
GNRT	玚
GWCY	玜
GTFH	玝
GFWY	玞
GWJH	玠
GAHT	玡
GWVT	玢
GYHY	玣
GDHH	玤
GNWY	玦
GCQN	玧
GWYN	玪
GMYG	玬
GXXN	玭
GWBN	玱
GWAY	玳
GANN	玴
GAFG	玵
GGUF	玶
GQNN	玸
GYXY	玹
GHCY	玻
GHXN	玼
GQKG	玽
GVKG	玿
GGNY	珁
GSKG	珂
GMFG	珃
GTGG	珄
GJHH	珅
GCKG	珆
GEGG	珇
GEKG	珈
GNAN	珉
GNTT	珌
GVGH	珒
GYWR	珓
GDHB	珔
GEEE	珕
GIGQ	珖
GTFQ	珗
GTEY	珘
GAWY	珙
GLDY	珚
GUGH	珜
GWGQ	珟
GRIY	珠
GGWU	珡
GVEY	珢
GQJG	珣
GRMH	珤
GTMK	珦
GQIY	珧
GWGK	珨
GTGS	珩
GFFG	珪
GYCQ	珫
GDGY	珬
GWGH	珮
GFTX	珯
GIVG	珰
GYET	珳
GTRY	珴
GKGG	珵
GUXT	珶
GFHY	珷
GGKG	珸
GDNY	珹
GVTK	珺
GTXY	珻
GTFP	珽
GHQN	現
GKHY	珿
GWYK	琀
GTNH	琁
GKEG	琄
GTBT	琇
GEBG	琈
GYCK	琉
GAHB	琊
GRDH	琋
GMWN	琌
GTJH	琍
GFJP	琎
GIEG	琑
GTDH	琒
GPFQ	琓
GPGH	琔
GRTF	琕
GAAY	琖
GYWF	琗
GQAJ	琘
GNDG	琚
GPWS	琛
GSWW	琜
GJYY	琝
JEGY	琞
GWYG	琟
GMAW	琠
GHGC	琡
GUKG	琣
GQVH	琤
GDSK	琦
GFGY	琧
GJXX	琨
GJJG	琩
GADW	琪
GDWG	琫
GPQB	琬
GVIY	琭
GPFI	琮
GPHN	琯
GOOY	琰
GMFK	琱
GHDD	琲
GSSY	琳
GGXX	琵
GGCB	琶
GUFQ	琷
GHJF	琸
GGSU	琹
GIFC	琺
GFTJ	琽
GLWJ	琾
GTKY	瑀
GJHG	瑁
GNHG	瑂
GDWJ	瑃
GPGG	瑄
GJGH	瑅
GJTG	瑆
GGXY	瑇
GCNS	瑈
GNNJ	瑉
GNKH	瑋
GDMD	瑌
GXXR	瑎
GPWT	瑏
GUEJ	瑐
GXGE	瑑
GJGR	瑒
GGLI	瑓
GNHC	瑕
GWDC	瑖
GEGC	瑗
GBBH	瑘
GVTR	瑙
GDEG	瑚
GAMD	瑛
GWGJ	瑜
GRGG	瑝
GGNT	瑟
GQYL	瑠
GWNH	瑡
GPWK	瑢
GQRM	瑤
GJLG	瑥
GWNO	瑦
GDWT	瑧
GGOJ	瑨
OOPY	瑩
GEEG	瑫
IYCY	瑬
GOVK	瑭
GYVB	瑯
GFHW	瑱
GUGA	瑳
GCYJ	瑵
GPRW	瑸
GAWS	瑹
GIPH	瑺
GXFM	瑻
GGJF	瑼
GTWH	瑽
GAKG	瑾
ATDY	瑿
GMWY	璀
GTLN	璁
GADF	璂
GYRC	璃
GUJQ	璄
GVJS	璅
GNWE	璆
GGQT	璈
GLPY	璉
GAMY	璊
GUJF	璋
GPGW	璌
GAGF	璍
GXGX	璏
GKHK	璐
GRLO	璑
GWGU	璒
GATB	璓
GULJ	璔
GIAS	璖
IJGY	璗
GOQH	璘
GDUI	璙
GCNK	璚
GVFJ	璛
GAMW	璜
GKHM	璝
GOGW	璞
GJYI	璟
GTOL	璠
GWYP	璡
GGJL	璢
GXXY	璣
GGJN	璤
GAQT	璥
GEPT	璦
GHQO	璨
GHAE	璩
GKKS	璪
GIPL	璫
GRYT	璬
GPLP	璭
GYLG	璮
GGGT	璱
GUEP	璲
GRIM	璳
GSSH	璴
GEGW	璵
GVHL	璶
GGET	璷
GPGM	璸
GFNF	璹
EMGY	璺
GNYF	璻
GAHL	璼
GWMY	璽
GYUJ	璾
GHPH	璿
GFDJ	瓀
GAWC	瓁
GAFL	瓂
GLLL	瓃
GFLM	瓄
GRXS	瓅
GRRM	瓆
GDET	瓇
GTQI	瓈
GFWM	瓉
GYUP	瓋
GYLE	瓌
GBDP	瓍
GGKM	瓎
GUED	瓏
GHAL	瓐
GDTH	瓑
GUGI	瓓
GMMV	瓔
XGWY	瓕
GYKE	瓖
GMWK	瓗
GAKY	瓘
GFNO	瓙
GTFM	瓚
GHAY	瓛
RCYW	瓞
RCYN	瓟
DFNY	瓠
SFIY	瓢
UDRF	瓣
YKKY	瓤
GNNF	瓧
GNNC	瓪
WVGY	瓫
YGNY	瓬
PQGY	瓭
GNNV	瓰
GNNN	瓱
DGNY	瓳
WYCY	瓴
CKGY	瓵
KEGY	瓹
DCGY	瓺
IPKY	瓽
TVGY	瓾
UKGY	瓿
TFAY	甀
TGDY	甁
YNMY	甂
TOGY	甃
UXXY	甆
THSY	甈
UVOY	甉
LVGY	甊
YUMY	甋
AKKY	甌
ALPY	甍
GJHY	甎
FKUY	甏
ULJY	甑
RLGY	甒
MMGY	甖
AAFY	甙
ADWN	甚
AFTD	甛
HAWF	甝
JTGG	甠
YDTG	產
UTTG	産
GETG	甤
GJRG	甦
TGTE	甧
TEHK	甪
GEHY	甫
DHEH	甭
QREH	甮
PNEH	甯
LLLL	田
LHNH	甲
MHFD	甴
MGNB	甹
LYNN	甿
LGJJ	畀
MGJJ	畁
LQYY	畂
JHQY	畃
YLCY	畆
LQUG	畇
LRCY	畈
LFWY	畉
LFJH	畊
LWJH	畍
LDYY	畎
GKLF	畐
YLWY	畒
LUGH	畔
YKLF	畗
LMFG	畘
CDLF	畚
YXLF	畜
FLQY	畞
LWTU	畟
LYNW	畡
JAFK	畢
LFFY	畤
LTKG	略
LFFG	畦
LTKF	畧
LYEY	畩
LWGS	畭
LTXY	畮
LCWT	畯
GJAL	畱
LPEG	畳
VFLB	畵
LDSK	畸
LPQB	畹
GLGG	畺
LUDF	畻
LJGR	畼
LTGF	畽
XXAL	畿
VLGH	疀
LNWE	疁
LIPG	疂
LUJF	疃
LGLG	疅
LFNF	疇
GKLL	疈
LLLG	疊
GVHI	疌
NHJG	疍
NHGI	疎
NHYK	疏
XTDH	疑
UYGG	疒
UTNV	疙
UQYI	疚
UGHI	疜
UFNV	疞
UDNY	疣
UWJK	疥
UNWI	疦
UQAV	疧
UVFK	疩
UXXV	疪
UDEE	疬
UWWI	疭
UYGD	疰
UAFD	疳
USKD	疴
UANV	疶
UQAY	疷
UJGD	疸
UWEE	疹
UTPI	疺
UKWI	疻
UXJK	疿
UQKD	痀
UHKD	痁
UEKD	痂
UYXI	痃
UGMW	病
UNXV	痆
UWGD	痊
UMGK	痌
UGXW	痍
UDED	痏
ULKD	痐
UQQI	痑
UGCF	痓
UFFI	痔
UVEI	痕
UGOG	痖
UTXI	痗
UGKU	痘
UFTB	痚
UTWV	痜
UIED	痟
UCWT	痠
UTJK	痢
UFNI	痣
UWWF	痤
UUKQ	痥
UGKD	痦
UIIT	痧
UJHC	痩
UJQR	痬
UEED	痭
UDEI	痮
UPHN	痯
UOOI	痰
USFQ	痲
USSI	痳
UTBD	痵
UMAW	痶
URMJ	痸
URTF	痺
UWYD	痽
UBSK	痾
UTVD	痿
UYWU	瘀
UYWF	瘁
UGFG	瘂
UGEY	瘃
UCDE	瘆
UTGF	瘇
UDHD	瘈
UWGJ	瘉
UWND	瘊
UWTJ	瘋
UGKJ	瘌
UJGR	瘍
UADN	瘎
UFTJ	瘏
UEWI	瘐
UMNK	瘑
UPLK	瘒
UQMD	瘓
UADD	瘔
UNHC	瘕
UUJD	瘖
UCYJ	瘙
UDHN	瘛
UTHN	瘜
ULII	瘝
UDWF	瘞
UIWE	瘠
UWYK	瘡
UTEC	瘢
URQC	瘣
UQYL	瘤
UUGA	瘥
UHAG	瘧
UAWK	瘩
UXDE	瘬
USFI	瘭
UCCE	瘮
UYTD	瘯
ULXI	瘰
UDWN	瘱
UTWH	瘲
UNWE	瘳
UUJF	瘴
UWFI	瘵
UGKW	瘶
UGKT	瘷
UEKW	瘸
UQQY	瘹
UNFI	瘺
ULVD	瘻
UAJD	瘼
UAMW	癀
UTTT	癁
UBTG	癃
UWYO	癄
UGJL	癅
UOOE	癆
UUED	癇
UWXC	癈
UBWC	癊
UGFN	癋
UGYG	癍
ULGE	癏
UMAE	癑
UWGN	癒
UUJN	癔
UYXY	癕
UFLD	癗
UAJY	癘
UENN	癙
UQDY	癚
UNAC	癜
UYLI	癝
UTHA	癟
UYUJ	癠
UUFE	癢
UTVB	癤
UTMT	癥
UDTH	癧
UFWY	癨
UGKM	癩
UTGM	癪
UQOG	癬
UMMV	癭
UBEN	癮
UHHY	癯
UVKY	癰
ULLI	癳
UYXR	癴
UYXW	癵
WGDU	癸
WWCU	癹
WFQB	発
WGKU	登
RRRR	白
RQYY	的
RHXN	皉
RDFJ	皋
RXBJ	皍
RYWR	皎
RIFJ	皐
RTRY	皒
RTFK	皓
RJFH	皔
DJDJ	皕
RPFQ	皖
RMFK	皗
SRRF	皙
RMGU	皚
RRRF	皛
RGIQ	皝
RRDF	皞
RRIF	皡
REPT	皧
RGJQ	皩
RELF	皭
HCFH	皯
HCQN	皰
GIYC	皳
CWTC	皴
AJHC	皵
SJGC	皶
PLHC	皸
HCPL	皹
HAEC	皻
YLKC	皽
FLMC	皾
XHLF	盄
KHLF	盅
DYLF	盇
DCYL	盋
QBLF	盌
FCLF	盍
WGKL	盒
IGFL	盓
IWYL	盕
GEHL	盙
GIYL	盚
VILF	盝
AALF	盞
JELF	盟
XGEL	盠
VHGL	盡
LDYL	盢
TEWL	盤
WYNL	盦
EDML	盨
FUFL	盩
IJGL	盪
XFUL	盭
HHHH	目
HYNN	盳
HTNN	盵
HFQN	盶
HQUG	盷
HGBN	盹
HWGN	盻
HDHH	盽
ITHF	省
HQAN	眂
HGHN	眄
HRCY	眅
HITT	眇
HPQN	眈
HTFN	眊
HNIU	県
HARY	眍
HFIY	眎
HMDY	眏
HXET	眑
HJHH	眒
HGNY	眓
HWET	眕
HKQN	眖
HQKG	眗
DUHF	眘
HCKG	眙
TGHF	眚
HGSY	眜
HPSH	眝
XHNW	眞
FHWU	真
HNAN	眠
HQAY	眡
QBHF	眢
HRWY	眣
HNXN	眤
HXHF	眥
HVKG	眧
HYXY	眩
HGMW	眪
HUGH	眫
HDXY	眬
HFFG	眭
HMGK	眮
HGCF	眰
HGXW	眱
HQJG	眴
HQQY	眵
HAGG	眶
HCTG	眸
HUDY	眹
HREY	眽
HYNI	眿
WWHH	睂
HIEG	睄
HJFH	睅
HPFQ	睆
HUXT	睇
HKGG	睈
HWWF	睉
HKEG	睊
HTRY	睋
HQKQ	睌
HHQN	睍
HRDH	睎
HLSY	睏
HOOY	睒
HWGA	睔
HPQB	睕
HFWT	睖
HJQR	睗
LGKE	睘
HYNY	睙
HDFF	睚
HGEG	睛
TQTH	睝
HSWW	睞
HYWF	睟
HUDB	睠
HWYG	睢
HLGJ	睤
HRTF	睥
HFWF	睦
HQAJ	睧
HEQN	睨
HVIY	睩
LFUF	睪
HGVH	睫
HESY	睬
HMFK	睭
HWGJ	睮
NNAH	睯
HADK	睰
HNHC	睱
HJTG	睲
HPLH	睴
HFKY	睵
HDWJ	睶
HVGP	睷
HNHG	睸
HFTJ	睹
HWND	睺
HPGG	睻
HJGH	睼
HWGD	睽
HPGH	睿
CNHH	瞀
HHDY	瞁
RFHY	瞂
HRFH	瞃
HALG	瞄
HKHM	瞆
HOPY	瞇
HWCN	瞈
HOVK	瞊
HFHW	瞋
HEHC	瞍
HPJW	瞑
HYKH	瞓
ATDH	瞖
HWVO	瞗
HAKK	瞘
HAJD	瞙
HPGW	瞚
HTWH	瞛
HLVG	瞜
HYRC	瞝
HSFI	瞟
HFWQ	瞡
ALPH	瞢
HKKN	瞣
HUGG	瞤
HFKK	瞦
HOGW	瞨
HSJF	瞫
HDUI	瞭
HYCT	瞮
HUEG	瞯
HNBT	瞰
HAGF	瞱
HCNK	瞲
HUJF	瞳
HRLO	瞴
HOQH	瞵
HUJG	瞷
HAAS	瞸
HEPT	瞹
HWGW	瞼
FKUH	瞽
HHPA	瞾
HHWY	瞿
HTMT	矀
HTON	矁
HKKS	矂
HPNS	矃
HTGO	矄
HNWY	矅
HAWC	矆
HAPE	矇
HRPY	矈
HPGM	矉
HXRH	矊
HDAY	矋
HOAW	矌
HHWC	矍
HQMT	矎
HTHY	矏
HFWY	矐
HHAL	矑
HALH	矒
HUED	矓
HAKY	矔
YXXH	矕
HGMX	矖
FHFH	矗
HIPO	矘
HUNT	矙
CNHT	矛
CNHC	矝
CNHK	矞
CTDU	矣
XTDY	矤
TDKG	知
QDTD	矦
TDXH	矧
TDTD	矨
TDAN	矩
TDTE	矪
TDWF	矬
TDTK	矯
TDUJ	矰
TDAC	矱
TDLX	矲
DGTG	石
DGQN	矹
DTAN	矺
DTNN	矻
DITT	砂
DMYG	砃
DNWY	砄
DFWY	砆
DDBN	砈
DHDF	砉
DYWN	砊
DAVT	砌
DQWY	砍
DWJH	砎
DWVT	砏
DBYY	砐
DAHT	砑
DXXN	砒
DWCY	砓
DGAH	研
DVFH	砕
DGBN	砘
DWYN	砛
DWRY	砜
DGSY	砞
DTHF	砟
DEGG	砠
DGYY	砡
DSKG	砢
DPXN	砣
DTBN	砤
DQAY	砥
HXDF	砦
DHKG	砧
DYNN	砨
DXJH	砩
DYGG	砫
DTPY	砭
VCDF	砮
DYIY	砯
DGUF	砰
DWYC	砱
DQNN	砲
DSGG	砵
DJHH	砷
DARY	砹
DWAG	砼
DEHH	砽
DOCY	砿
DCAG	硁
DWGG	硂
DRIY	硃
DIGQ	硄
DFFG	硅
DWGK	硆
DTLR	硇
DFKG	硈
DVGH	硉
DQDB	硊
DTKG	硌
DVEY	硍
DGAJ	硎
DGDF	硏
DMGK	硐
DUAH	硑
DFTX	硓
DAWY	硔
DLKG	硘
DMNN	硙
DTDJ	硚
DYOY	硛
DGVA	硜
DIEG	硝
DTFK	硞
DTHP	硟
DYVE	硠
DPDC	硡
DWGS	硢
DFTB	硣
DDWW	硤
DCEH	硧
DTRY	硪
DYCK	硫
DAYN	硭
IITD	硰
DLSY	硱
DWWK	硲
DFOY	硳
DAWX	硴
DHLR	硵
DMWN	硶
DMDF	硸
DSWC	硹
DGEY	硺
AHND	硻
DEEG	硼
DDJN	硽
DPWA	硿
DQVH	碀
ADWD	碁
DPFI	碂
DGEG	碃
DLTY	碅
IHCD	碆
DPGH	碇
DQAJ	碈
DMFK	碉
DAAY	碊
DMSK	碋
DAJG	碏
DFWT	碐
DRTF	碑
DWYG	碓
DFHY	碔
DDSK	碕
DWGA	碖
DPQB	碗
DMAW	碘
DMUM	碙
DUKG	碚
KKKD	碞
DANS	碟
DYKS	碠
DMNK	碢
DJQN	碣
DAMD	碤
DYNA	碥
DPTK	碦
DLGE	碨
DADN	碪
DWDC	碫
DJGH	碮
DVTR	碯
DYUH	碲
DMDO	碳
DSJG	碴
DHMY	碵
DDHD	碶
DRFH	碷
DWTJ	碸
DPGG	碹
DPWY	確
DYKK	碻
DAMY	碽
DNAE	碾
DNIE	碿
DUBP	磀
DQYL	磂
DRHW	磃
DOVK	磄
DYUY	磅
DMEG	磆
DTLX	磇
DRQC	磈
DCCS	磉
DDDF	磊
DPDK	磍
DEXD	磎
DUVO	磏
DMGU	磑
DKMY	磒
DWNP	磓
DQAS	磔
DFCL	磕
DNRG	磖
DGEF	磗
DERM	磘
DYWE	磙
DGJF	磚
LRDF	磛
DWFI	磜
DMEE	磞
DNWE	磟
DHLO	磠
DADE	磡
DDRR	磢
DCCE	磣
DRVC	磤
DLXI	磥
DSFI	磦
DGMY	磧
OSSD	磨
DDHY	磩
DMWY	磪
DTWH	磫
FNWD	磬
DDFE	磭
DMWA	磮
DXXY	磯
DUGK	磰
DOOE	磱
DIAS	磲
DULJ	磳
DUJG	磵
DEQO	磶
DUSD	磸
DSJF	磹
DTOL	磻
DWYS	磼
DFFQ	磽
DKKL	磾
DTTD	磿
DUEG	礀
DWYO	礁
DFKK	礂
DIPR	礃
DTDK	礄
DYKT	礅
DTMD	礇
DUEP	礈
DRYT	礉
LBWD	礊
DLFF	礋
DFLG	礌
DAJN	礍
DSSH	礎
DOGI	礏
ERRD	礐
DIPL	礑
DUGY	礒
DGLG	礓
DNKF	礔
NKUD	礕
DEGW	礖
DPGM	礗
DJXO	礘
DAFL	礚
DAHL	礛
EGND	礜
DFDJ	礝
DAPE	礞
DCOR	礟
DUXN	礠
DAGF	礡
DUFE	礢
DALY	礣
DAWI	礤
DAHM	礥
DLLL	礧
DRRM	礩
DDAY	礪
DOOI	礯
DDTH	礰
DUED	礲
DOSD	礳
DFSH	礵
DAKY	礶
DAAL	礷
DTFM	礸
DKKT	礹
PYYY	礻
PYBT	礽
PYNN	祀
PYBN	祂
PYCG	祃
PYWJ	祄
PYTD	祅
PYQA	祇
PYHG	祉
PYYT	祊
PYWC	祋
PYKH	祌
PYFH	祎
PYDK	祐
PYRW	祑
PYVK	祒
PYDY	祓
PYWF	祔
PYNT	祕
PYQY	祗
FIFI	祘
PYFI	祙
PYTF	祚
PYFC	祛
PYDG	祜
PYJH	神
BMFI	祟
HXFI	祡
PYTE	祣
PYNG	祤
PYUG	祥
PYKD	祦
PYQI	祧
SFIU	票
PYRI	祩
PYQB	祪
PYWK	祫
WFIU	祭
PYTK	祰
PYUQ	祱
PYVC	祲
PYDE	祳
PYAA	祴
PYLS	祵
PYUT	祶
PYQM	祹
PYAW	祺
PYLD	祻
PYJS	祼
PYYF	祽
PYFT	祾
PYRF	禆
PYFJ	禇
PYPL	禈
PYDD	禊
PYSF	禋
PYUX	禌
PYMK	禍
PYHM	禎
PYEC	禐
PYJY	禑
PYXE	禒
PYJR	禓
PYNH	禕
PYAS	禖
PYLN	禗
PYYH	禘
PYUE	禙
PYUO	禚
PYFW	禛
PYLT	禝
PYYK	禞
PYOK	禟
PYCO	禡
PYJN	禢
PYAF	禥
PYFK	禧
PYXY	禨
PYLW	禩
PYUP	禭
PYME	禯
PYGR	禰
PYFF	禱
PYYE	禳
PYWA	禴
PYJM	禵
PYTM	禶
PYOM	禷
TKMY	禹
JMHY	禺
HLRC	禼
TTTT	禾
TTAN	秅
TTFJ	秊
TWVT	秎
TFCY	秐
TUFH	科
TXXN	秕
TQAN	秖
TTDY	秗
TNXN	秜
TEGG	租
TDHG	秠
TDCY	秡
TGSY	秣
TGUF	秤
THKG	秥
DWTU	秦
TMDY	秧
TRWY	秩
TSYY	秫
TANG	秬
TTNT	秭
TCKG	秮
TTDG	秳
UQWT	秶
TGCF	秷
TFKG	秸
TWTF	秹
TPTA	秺
TRIY	秼
TPEY	秾
TGEY	秿
YKPT	稁
TYVE	稂
TEBG	稃
TCWT	稄
TKKG	稆
TLSY	稇
TJFH	稈
TUXT	稊
TKGG	程
TWFI	稌
TIEG	稍
TGFG	稏
TFWF	稑
TLDG	稒
TWYN	稔
TLTY	稛
TFWT	稜
TJSY	稞
YLKT	稟
TMFK	稠
TYWF	稡
TAKG	稢
TYKI	稤
TOJF	稥
TDHD	稧
TLEG	稩
TGKL	稫
TDMD	稬
TTGF	種
TRBT	稯
TNHE	稰
TEHJ	稲
TUVO	稴
TUXX	稵
TGKY	稶
TLWT	稷
TYXL	稸
TFHW	稹
TNUF	稺
TEEG	稻
TPGE	稼
YKMT	稾
TYKK	稿
FPGC	穀
TABG	穁
TGMN	穂
TPWK	穃
TOVI	穅
TRIE	穆
OSST	穈
TVCQ	穊
TNWE	穋
QOTY	穌
TGMY	積
XTDM	穎
TEVN	穏
TQJN	穐
TWVO	穒
TLAW	穓
TWYS	穕
TXXY	穖
TGJN	穗
TOGW	穙
TWYO	穛
TJBC	穝
TQGJ	穞
TUEP	穟
TMAE	穠
TFWK	穡
TYWE	穣
TFDJ	穤
TEGW	穥
TPGM	穦
TYUJ	穧
TWKM	穨
TGWR	穪
TAWC	穫
TOAW	穬
TQOJ	穭
TFKK	穯
TELF	穱
TGMX	穲
TTFM	穳
PWNB	穵
PWQU	穸
PWSU	穼
PWTD	穾
PWGN	窀
PWDY	突
PWTG	窂
PWTF	窄
PWHF	窅
PWTP	窆
PWQN	窇
PWGW	窉
PWBM	窋
PWQB	窌
PWQG	窎
PWFF	窐
PWGF	窒
PWCN	窓
PWYR	窔
PWQI	窕
PWTK	窖
PWFB	窙
PWFV	窛
PWQE	窞
PWJS	窠
PWCC	窡
PWAG	窢
PWJX	窤
PWUJ	窨
PWMK	窩
PWIF	窪
PWDD	窫
PWWJ	窬
PWTX	窮
PWEM	窰
PWWS	窱
PWOF	窲
PWRY	窳
PWFW	窴
PWWO	窵
PWLV	窶
PWBB	窷
PWTN	窸
PWNK	窹
PWVS	窼
PWXW	窽
PWBG	窿
PWGQ	竀
PWDI	竂
PWFN	竃
PWRT	竅
PWFM	竇
PWFX	竈
PWUD	竉
UUUU	立
UTFH	竏
UWCY	竐
UKHJ	竒
UTFN	竓
UTAH	竔
UWVT	竕
UITT	竗
UQKG	竘
UPSH	竚
UJNB	竜
UDJG	竡
UCTD	竢
UPDC	竤
UGKI	竦
UHJF	竨
UPEG	竩
UQVH	竫
UTKY	竬
UJQN	竭
UNUA	竮
UDJF	竰
UGJF	竱
UULJ	竲
UWGU	竳
UUSF	竴
UGKH	竵
UJFT	竷
UJQQ	竸
THTH	竹
TWYU	竼
TGFJ	竽
TYNB	笀
TVYU	笂
TGAJ	笄
TRRU	笅
TYHU	笇
TBYU	笈
TQUF	笉
TRHY	笊
TAHT	笌
TMWU	笍
TQRR	笏
TYWB	笐
TTDU	笑
TXXB	笓
TNYW	笖
TTUU	笗
TBMJ	笜
TLCU	笝
TCKF	笞
TRCY	笟
TEGF	笡
TNNA	笢
TQNB	笣
TVKF	笤
TNGK	笥
TWFU	符
TMMG	笧
TWAY	笩
TTHF	笮
TVCU	笯
TXJJ	笰
TQKF	笱
TCAJ	笲
TEKF	笳
TSKF	笴
TIBB	笵
TQTB	笷
TAKF	笸
TANB	笹
TABJ	笻
TTKF	笿
TFFF	筀
TMAF	筁
TLDU	筃
TQIU	筄
TTFQ	筅
TTDF	筈
TFFU	等
TYWR	筊
TWGF	筌
TQJF	筍
TWAU	筏
TAGF	筐
TMGK	筒
TWGK	答
TGMI	策
TWKH	筗
TRKF	筘
TDIU	筙
TIVF	筜
TPSU	筞
TEBF	筟
TRCB	筢
TTJJ	筣
TKKF	筥
TPFQ	筦
THQB	筧
TWYK	筨
TCEH	筩
TALJ	筪
TAWW	筮
TEGE	筯
TIEF	筲
TTFP	筳
TDWW	筴
TTHP	筵
TNNW	筷
TJFJ	筸
TAGY	筺
TGJR	筻
TKMU	筼
TKGD	筽
TTSU	筿
TUKF	箁
TBCU	箃
TRTF	箄
TMWX	箆
TLDF	箇
TICK	箈
TRKE	箉
TYWU	箊
TAAU	箋
TGCJ	箌
TRAH	箍
THAW	箎
TEVH	箏
TGEF	箐
TVPH	箒
TVIU	箓
TIRF	箔
TADW	箕
THAJ	算
TLTU	箘
TEBC	箙
TBRY	箛
TPWA	箜
TRAF	箝
TJXX	箟
TTFG	箠
TPQB	箢
TGMJ	箣
TIHC	箥
TADK	箬
TPGG	箮
TWGR	箯
TQJB	箰
TSHF	箱
TITQ	箲
TNUA	箳
TITH	箵
TDEF	箶
TYTB	箷
TFTJ	箸
TXQY	箹
TDWJ	箺
TTVG	箻
TNGF	箼
TIEJ	箾
TKBF	箿
TRGF	篁
TJTG	篂
TNHF	篃
TMDJ	篅
TYNA	篇
TAWS	築
TIAW	篊
TWND	篌
TTOU	篍
THIT	篎
TAFW	篏
TSAH	篐
TWYE	篒
TFCL	篕
TOVK	篖
TAHD	篚
TXUU	篛
TBIO	篜
TIJF	篞
TWGE	篟
TWHS	篠
THDC	篡
TAMU	篢
TSSU	篥
TTLX	篦
TPWY	篧
TBWI	篨
TWNH	篩
TRHW	篪
TAWR	篫
TUJN	篭
TQFY	篯
TUKB	篰
TDHV	篲
TJAF	篳
TGEP	篴
TTWH	篵
TGHO	篶
THDB	篹
TRRF	篺
TRQQ	篼
TTRB	篽
TLDY	篾
TGMU	簀
TTHH	簁
TLAG	簂
TTQQ	簃
TYNC	簄
TUTG	簅
TPFC	簆
TYTD	簇
TNTF	簈
TADF	簊
TVEL	簋
TLVF	簍
TRAJ	簎
TONX	簏
TYKE	簑
TMFE	簓
TYGE	簔
TAKE	簕
TIVS	簗
TVOJ	簘
TFGF	簙
TLGY	簚
TADR	簛
TIJR	簜
TDUI	簝
TKKL	簞
TSJF	簟
TGEL	簠
TUJF	簡
TUYU	簢
TKHM	簣
TLMU	簤
TWGU	簦
TAMW	簧
TOOE	簩
TAQJ	簪
TVFJ	簫
TKHK	簬
TAWK	簭
TFWJ	簮
TSAW	簯
TYAW	簱
TERF	簲
TFJF	簳
TLTK	簵
TPYI	簶
TQDY	簷
TIPL	簹
TPAF	簺
TMNP	簻
TWGW	簽
TOUO	簾
TIGF	簿
TRQL	籀
TWYH	籂
TAKM	籄
TSFY	籈
TNWY	籊
TFNF	籌
TXTH	籎
TYTW	籏
TEUI	籐
THDE	籑
TRGL	籒
TITL	籓
TLVT	籔
TSQL	籕
TFWY	籗
TQVI	籙
THAL	籚
TQAA	籛
TRLF	籜
TYNY	籝
TTRI	籞
TGKM	籟
TUED	籠
TRWW	籡
TWGT	籢
TUGI	籣
TWWY	籤
TWGA	籥
TQTF	籦
THAP	籧
TXXR	籪
TYRY	籬
TLXY	籮
THHC	籰
TWGM	籲
ONFH	籸
OTNN	籺
OVYY	籾
ODYY	粀
OTFH	粁
OXXN	粃
OQRT	粅
XXOU	粊
OVFH	粋
OXHH	粌
OTFN	粍
ONYY	粎
OYNT	粐
OAFG	粓
OGSY	粖
OHKG	粘
VOJK	粛
UQWO	粢
OMMG	粣
XOXN	粥
OQAH	粦
OOFG	粧
ODJG	粨
OFTX	粩
ODMJ	粫
OMAG	粬
OHQN	粯
IVWO	粱
HQCO	粲
OGJR	粳
OJFG	粴
TMTN	粵
OVIY	粶
OQOY	粷
OADW	粸
OYWF	粹
ODEY	粻
OPFI	粽
OGEG	精
OJSY	粿
OAWX	糀
OCNS	糅
OWND	糇
ONHE	糈
ORBT	糉
ODEG	糊
OUEJ	糋
OTHJ	糌
OUXX	糍
ODJF	糎
ONIE	糏
OXUU	糑
OATH	糒
OCYJ	糔
OUGO	糕
OOVK	糖
OTHY	糗
OPGE	糘
OANF	糚
OIPF	糛
OSSO	糜
OCCE	糝
OLAW	糞
OGMJ	糟
OOVI	糠
OUJQ	糡
OAJD	糢
OAET	糤
OXKJ	糨
NKUO	糪
OLFJ	糬
OOBT	糭
OFDJ	糯
OLGF	糰
BTWO	糱
ODAY	糲
OGUO	糳
TYOY	糴
AWNO	糵
BMOY	糶
XCYY	紁
XQYY	約
XGFH	紆
XTNN	紇
XVYY	紉
XDNY	紌
XMWY	納
XDYY	紎
XUFH	紏
XDHY	紑
XWJH	紒
XCNH	紓
XGBN	純
XXHH	紖
XFCY	紜
XPQN	紞
XWYN	紟
XVFH	紣
RNXI	紥
XRWY	紩
XHXN	紪
XXCY	紭
XDCY	紱
XANN	紲
XHCY	紴
XPSH	紵
XWYC	紷
XYGG	紸
XVKG	紹
XAFG	紺
XMDY	紻
XXJH	紼
XPXN	紽
XWET	紾
XCKG	紿
XBMH	絀
XTBN	絁
XTUY	終
XYXY	絃
XMKG	絅
XUGH	絆
XQKG	絇
XSYY	絉
XSGG	絊
XOCY	絋
XCFG	経
XWTF	絍
XTGS	絎
XJXT	絏
XYTH	絒
XFFG	絓
XDJG	絔
XIGQ	絖
XLKG	絗
XUQW	絘
XGJG	絙
XGHG	絚
WHTI	絛
XWGG	絟
XDEG	絠
XQJG	絢
XUAH	絣
XWDY	絥
XWGK	給
XMGK	絧
XQIY	絩
XLDY	絪
CCCI	絫
UDXI	絭
XYNW	絯
XGCF	絰
XXIY	絲
XTAH	絳
XWFC	絵
XQCN	絶
XHQN	絸
XKEG	絹
XRDH	絺
XQKQ	絻
XKKG	絽
XGIY	絿
XGKI	綀
XYKQ	綂
XIEG	綃
XPFQ	綄
XVPC	綅
XGJR	綆
XUXT	綈
XTBT	綉
XDWW	綊
XPDC	綋
XWWK	綌
XFPB	綍
XTFP	綎
XEVG	綏
XUKQ	綐
XLSY	綑
XEBG	綒
XGVA	經
DFNI	綔
XFNY	綕
XTHP	綖
XMWK	綗
XONN	継
XFPQ	続
XVYN	綛
XPFI	綜
XSSY	綝
XTFG	綞
XYNY	綟
XUDB	綣
VKBI	綤
XLGJ	綥
ADWI	綦
XADW	綨
XPQB	綩
XGEG	綪
XAAY	綫
XEPC	綬
YNTI	綮
XQRM	綯
XPHN	綰
XMUN	網
XCCC	綴
XESY	綵
XJSY	綶
XYWF	綷
XWGA	綸
XTHK	綹
XDSK	綺
XRTF	綼
XFWT	綾
XGVV	緀
XGVH	緁
XOOY	緂
XWWH	緃
XJXX	緄
XBCY	緅
XJQR	緆
XVLG	緇
XFUF	緈
AHNI	緊
XTVG	緌
XQAJ	緍
XAKG	緎
XWCN	総
XVIY	緑
XFTJ	緒
XAMD	緓
XYJG	緕
XSHG	緗
XDGY	緘
XAKF	緙
XRIY	線
RMHI	緜
XWDC	緞
XTGF	緟
XNNJ	緡
XALG	緢
XWKS	緥
XLNY	緦
XUSG	緧
XNGG	緪
XQRN	緫
XDMD	緬
XLEG	緭
XTJT	緮
XWND	緱
XHIT	緲
ODHI	緳
XRBT	緵
XWGR	緶
XPLH	緷
XSFG	緸
XJGH	緹
XMNK	緺
XGCT	緻
XJLG	緼
XHMY	緽
XDJF	緾
XCKN	緿
XNHC	縀
XVEY	縁
XUKN	縂
XNHE	縃
XJJN	縄
XPGG	縇
OOPI	縈
XUWL	縊
XWNP	縋
XUBP	縌
XYUY	縍
XMEG	縎
TEWI	縏
XQBT	縐
XUVO	縑
XUGA	縒
XDRI	縓
XCCS	縔
XLWL	縕
XPDK	縖
XYKE	縗
XEXD	縘
XABG	縙
XEEG	縚
XGEF	縛
XKMY	縜
XFHW	縝
XYKK	縞
XDFF	縟
XPUF	縡
HITI	縣
XGXI	縤
XDWT	縥
XTUH	縦
XWHS	縧
XJIQ	縨
XWFI	縩
XYRC	縭
XPGW	縯
XTHH	縰
XTWH	縱
XLXI	縲
XGJF	縳
XYXG	縴
XJLC	縵
FUFI	縶
XLVG	縷
XAJD	縸
XLPY	縺
OSSI	縻
XGMY	績
XCCE	縿
TXTI	繁
XYXF	繂
ATDI	繄
XVJS	繅
XNWE	繆
ERMI	繇
XXCJ	繈
XHQI	繉
XFOY	繊
LWCI	繋
XTLT	繌
XVOJ	繍
XQDO	繎
XNNW	繏
XGJN	繐
XTDK	繑
XULJ	繒
XJBC	繓
XUGK	繕
XAET	繖
XOQH	繗
XCNK	繘
XTOL	繙
GXIF	繛
XUSF	繜
XUEG	繝
NNNI	繠
XVFJ	繡
XKHM	繢
XVFG	繣
AHDI	繤
XFKK	繥
XXKJ	繦
XFFC	繧
XFUP	繨
XWGJ	繪
LBWI	繫
XFWK	繬
AMHJ	繭
XLGE	繯
XKKS	繰
XAQN	繱
XQEG	繲
NKUI	繴
XYLG	繵
XUJN	繶
XMAE	繷
XUEP	繸
XLFF	繹
XQVO	繺
XFDJ	繻
XXXN	繼
XKHP	繾
XAHL	繿
XWOW	纀
XTGO	纁
THDI	纂
XYUJ	纃
XATP	纄
XRXS	纅
OXIM	纇
XFKM	纈
XFWM	纉
XOAW	纊
XDET	纋
XFHY	纎
XOJF	纏
XYWM	纐
XHAL	纑
XMMV	纓
XQKY	纔
XWWY	纖
XTFM	纘
XLXY	纙
GXHI	纛
XAHQ	纜
XLLI	纝
XYXN	纞
XNNG	纟
XDFN	绔
XIMK	绱
RMBH	缷
RMAG	缸
RMOU	缹
RMGY	缻
RMQW	缼
RMSG	缽
RMUA	缾
RMRK	缿
RMQI	罀
RMMM	罁
RMHF	罅
RMXM	罆
RMUF	罇
RMSF	罈
RMIR	罉
LBWM	罊
YXTM	罋
MMRM	罌
LLLM	罍
RMJC	罎
RMHL	罏
MUYN	罔
PWFJ	罕
LWYU	罖
LDHU	罘
LYGF	罜
LEGF	罝
LCNT	罞
LGHF	罡
LFFF	罣
LUXT	罤
LKEF	罥
LEBF	罦
LSSU	罧
LDJN	罨
LHJF	罩
LHDD	罪
LFFH	罫
LFMF	罱
LLNU	罳
LCOU	罵
LQYL	罶
LYFU	罸
LNWY	罹
LVJS	罺
LNFF	罻
LJAF	罼
LDOJ	罽
LULJ	罾
MRRL	羀
LXKE	羂
LAJH	羃
LXHF	羄
LCEO	羆
LAKK	羇
LYXI	羉
DUGJ	羍
UGDU	美
GHHY	羐
UGWV	羒
UGCN	羓
UGOU	羔
UGYI	羕
UGNC	羗
UGWC	羚
UGXJ	羛
UGPS	羜
UGQY	羝
UGNF	羞
UGGW	羠
UGAD	羢
VTKG	群
UGGA	羥
UGPQ	羦
UGCT	羧
UGIW	羨
UGTY	義
UGYE	羪
UGPA	羫
UGDY	羬
UGWJ	羭
UGOW	羮
UGJN	羯
UGMO	羰
UGDI	羱
UGTL	羳
UGUG	羴
UGFM	羵
UGWW	羷
UGOD	羹
UGFJ	羺
UGOT	羻
NUGG	羼
NNYG	羽
WCNF	翁
NWVT	翂
DCNG	翃
NVFJ	翆
NDCY	翇
SGNG	翉
WYCN	翎
NWER	翏
FKNG	翓
UGNG	翔
WGKN	翕
QQNG	翗
MQNG	翙
NPLJ	翚
PDCN	翝
NYKI	翞
NWYF	翟
NYWF	翠
MFKN	翢
NUVF	翣
KMAN	翤
FTJN	翥
UEJN	翦
YNMN	翩
NRFQ	翫
NWND	翭
GKMN	翮
NYKK	翯
SFIN	翲
ATDN	翳
NWVO	翵
RIFN	翶
FAMN	翸
THIN	翺
HDGN	翽
LGKN	翾
FNAN	翿
FTXB	老
FTXN	耄
FTJF	者
FTXJ	耆
FTQK	耇
FTXK	耈
FTTK	耉
FTXF	耋
DMJJ	而
DMJD	耎
DMJF	耐
MDMJ	耑
DISH	耓
DIBG	耔
DIFJ	耕
DIIT	耖
DITN	耗
DIFC	耘
DICN	耙
DIHC	耚
DICK	耛
DIHN	耜
DIEK	耞
DIAN	耟
DIWK	耠
DIEE	耡
DIAE	耢
DIWA	耣
DIAJ	耤
DIIK	耥
DIJY	耦
DIDF	耨
DIAF	耩
DIYY	耪
DIGM	耫
DILV	耬
DIXW	耭
DIOE	耮
DIAC	耯
DIDT	耰
DIOD	耱
DIYE	耲
BGHG	耳
BWYN	耹
BFCY	耺
BDCY	耾
BWVT	聁
BMFG	聃
BWET	聄
BTDY	聅
BXET	聈
BBMH	聉
BQIY	聎
BDMJ	聏
BFKG	聐
BTDG	聒
AWYB	聓
BTFK	聕
BKGF	聖
BGEG	聙
BPWA	聜
BAKG	聝
TDKB	聟
BUAH	聠
BWCN	聡
BPGH	聢
BEQN	聣
BYKS	聤
BTKY	聥
BQRN	聦
BWGD	聧
BXXA	聨
BXXD	聫
BXXO	聮
BTLN	聰
GQTB	聱
TWWB	聳
BFLN	聴
BKHM	聵
BBBF	聶
BQDY	聸
BPNS	聹
BPWI	聺
ILRB	聻
NBFN	聼
YNVG	肁
GQVG	肂
XTDG	肄
YNTG	肇
YNAG	肈
TYMW	肏
ETNN	肐
EVYY	肒
YNEF	肓
ECYY	肞
EFNN	肟
EWCY	股
EFCY	肢
EWYN	肣
EDHY	肧
EDHH	肨
EGBN	肫
EDNY	肬
EMWY	肭
EDCY	肱
EQRT	肳
EXXN	肶
EQWY	肷
EWFH	肸
EWGN	肹
EGMH	肺
HPEF	肻
EFJH	肼
EDYY	肽
EJHH	胂
ERWY	胅
EXJH	胇
MUQK	胊
EHKG	胋
ERCY	胍
ECKG	胎
ETNT	胏
MUBM	胐
EKWY	胑
ENXN	胒
EGUF	胓
HXMW	胔
EWFY	胕
EUGH	胖
EWET	胗
ETHF	胙
EDHG	胚
EQAY	胝
ESKG	胢
ETBN	胣
TXEN	胤
NHEF	胥
EMDY	胦
EAIY	胨
EHGH	胩
VCMW	胬
ELDY	胭
ETAH	胮
EDFN	胯
EIGQ	胱
EYNW	胲
ETKG	胳
EMGK	胴
EGCF	胵
QRBE	胷
EDMJ	胹
EPVG	胺
ETGS	胻
EUAH	胼
EFFG	胿
BIGE	脀
MUQI	脁
EQCN	脃
EDOY	脄
VVVE	脋
ERHF	脌
ERSY	脎
EQKQ	脕
EQRK	脗
EPFQ	脘
EGIY	脙
EGVA	脛
EWWF	脞
EEFY	脟
ETHP	脠
ETFP	脡
ETXY	脢
DFEE	脣
EDFE	脤
EDWW	脥
EANY	脦
MUCT	脧
EGKI	脨
WHTE	脩
ERDH	脪
EEBG	脬
EKGG	脭
EEVG	脮
EGEY	脯
EGKU	脰
ENIY	脲
EIRB	脳
EDHK	脴
EKGD	脵
ETJH	脷
EDEY	脹
EYWF	脺
EGVH	脻
EGMY	脼
EWYG	脽
ERTF	脾
EWGA	腀
EJSY	腂
EUDB	腃
ETFG	腄
EOOY	腅
EMAW	腆
ETVG	腇
EEQN	腉
EYWY	腋
AHNE	腎
ECCC	腏
EOWF	腑
ENDG	腒
EHDD	腓
EPQB	腕
EGJI	腖
EMGJ	腗
ELGY	腘
EPFI	腙
EPGH	腚
ENGF	腛
EAFS	腜
EDMD	腝
EXGE	腞
EPGF	腟
EDWD	腠
EMNK	腡
EJMY	腢
EYUH	腣
EUJG	腤
EMDJ	腨
EFMF	腩
EPLH	腪
ETGF	腫
ECNS	腬
EKKN	腭
ELNY	腮
ERFH	腯
EVGP	腱
ELGE	腲
EEWY	腴
ENHC	腵
EWDC	腶
EGKL	腷
EJGR	腸
ERIY	腺
EVEP	腿
EUVO	膁
YTEE	膂
ELWL	膃
EEHC	膄
EOVK	膅
EGXI	膆
EWNP	膇
EGKH	膈
EUWL	膉
EGEF	膊
EIWE	膌
EEXD	膎
EAKK	膒
ETJR	膓
EONX	膔
ELAG	膕
ETDP	膖
EXKJ	膙
HALE	膚
EIPF	膛
EAJD	膜
EGJF	膞
EYXF	膟
ELVG	膢
EPWF	膣
EFVG	膤
GSDW	膥
EOQH	膦
MUUF	膧
EYUK	膪
EDUI	膫
ETFN	膬
EKHM	膭
EFFQ	膮
EWGU	膯
ETOL	膰
EUJY	膱
EWYO	膲
ERLO	膴
EAYF	膵
EUGG	膶
EXTB	膷
EDAP	膸
EFAM	膹
OWWE	膺
EMNP	膼
EWGJ	膾
EMAE	膿
EOUO	臁
NKUE	臂
EYXY	臃
EHAE	臄
ELQJ	臅
EWYM	臇
EAJN	臈
EKKS	臊
NAWW	臋
EFKC	臌
EYUJ	臍
ENYF	臎
EPGM	臏
ETGO	臐
EFDJ	臑
EAWC	臒
EAHM	臔
EONO	臕
EMGE	臖
EPAY	臗
EAKO	臙
EHAL	臚
EFWY	臛
ETFM	臜
EHHY	臞
EADY	臟
YXXW	臠
AHNH	臣
AHNC	臤
AHNW	臥
NHAH	臦
DNDY	臧
AHNK	臨
NHAJ	臩
THNN	臫
THSU	臬
THDY	臭
THIF	臯
THGX	臰
THPY	臱
THSB	臲
GCFF	至
GCFK	臵
FGCY	臷
GCFY	臹
GCFT	臻
ETHG	臼
TFED	臿
DWEF	舂
EGNO	舃
EQOU	舄
EGNW	與
AWYE	舊
EMGG	舋
TDNH	舏
TDQA	舐
TDMF	舑
TDJR	舓
TDGN	舔
TDOO	舕
WFKY	舖
WFKN	舘
TDQY	舚
QAHH	舛
EPQH	舜
NVPH	舝
RLGH	舞
TEVT	舠
TEAG	舡
TEMH	舢
TEWY	舤
TECN	舥
TEDY	舦
TETY	舧
TERC	舨
TEYW	航
TEYT	舫
TEWC	般
TEXX	舭
TEYN	舮
TEKH	舯
TEMG	舳
TETF	舴
TERG	舶
TEYX	舷
TESK	舸
TEWK	船
TELH	舺
TEAW	舼
TETH	舽
TESG	舾
TEDN	舿
TEEB	艀
TETK	艁
TEJF	艃
TEIE	艄
TEYE	艆
TETP	艇
TEYK	艈
TENN	艉
TERH	艊
TEBL	艋
TEWN	艌
TEND	艍
TEUH	艏
TERT	艐
TEYA	艑
TEJH	艒
TEAS	艓
TEOC	艔
TEYY	艕
TEUA	艖
TEUL	艗
TEEC	艘
TEGJ	艚
TELV	艛
TEAH	艜
TEFV	艝
TETI	艞
TEUF	艟
TEWU	艠
TEIL	艡
TEFK	艢
TEHE	艣
TEUY	艤
TEKY	艥
TEAC	艧
TEAE	艨
TEYJ	艩
TEQJ	艪
TEHL	艫
TEQY	艬
XJQC	艴
UAQC	艵
MAGC	艶
MDHC	艷
BTBH	艸
AWYU	芃
AVYU	芄
AAYU	芅
ACYU	芆
ATFJ	芊
AGFJ	芋
AFNB	芌
AQYU	芍
AGHU	芐
AYNB	芒
BHBH	芔
AXXB	芘
AGBN	芚
AVTR	芛
ARNB	芞
AWCU	芟
AQWU	芡
ADHU	芣
ABNB	芤
AWJJ	芥
ACNH	芧
ABYU	芨
AQAB	芪
AFQB	芫
AFCU	芰
AWXB	花
AQRR	芴
ANWU	芵
AQCU	芶
ATDU	芺
QBTT	芻
ATFN	芼
AAHT	芽
AGMH	芾
AWBR	芿
AYWB	苀
ADCU	苃
ARJJ	苅
AAVR	苆
AAQB	苉
ADBB	苊
AXHT	苐
AQBB	苑
AMFF	苒
AWYC	苓
AMKF	苘
AEHJ	苚
ASKF	苛
AUXB	苝
AQNB	苞
ANAB	苠
ANYW	苡
AHNN	苢
AANF	苣
ADHG	苤
APSJ	苧
ANXB	苨
AHKF	苫
ALWU	苬
AXER	苭
AWMJ	苮
ASGF	苯
AXCU	苰
AMDU	英
ATHF	苲
ATUU	苳
AEGF	苴
ARWU	苵
AWIU	苶
AAFF	苷
ATUF	苸
AWFU	苻
ARCY	苽
ANTR	苾
AFIU	苿
AXJJ	茀
ACNT	茅
AQTB	茆
ADCY	茇
AHXB	茈
AGSU	茉
ARGF	茊
AQAY	茋
AWFF	茌
HGHK	茍
AQRY	茐
AQBJ	茒
APWU	茓
ATKF	茖
AQKF	茗
AVVV	茘
AADR	茙
AQGB	茚
AVEU	茛
AAHH	茝
AVGJ	茟
APBF	茡
AGQJ	茢
AQQU	茤
AGMI	茦
AUQW	茨
ARGK	茩
AIGQ	茪
ADHF	茬
AYWR	茭
AHGI	茮
AWDY	茯
AJRU	茰
ARIU	茱
AIAF	茳
ALKF	茴
ALDU	茵
AWSU	茶
AWAU	茷
AVKF	茹
AYCQ	茺
AMGK	茼
AWKH	茽
AAWY	茿
AQJF	荀
AGJG	荁
ADFN	荂
AWGF	荃
AYNW	荄
ATGS	荇
AQAH	荈
AJFJ	草
AGAJ	荊
ADMJ	荋
APVF	荌
ANHT	荍
AGCF	荎
AWTF	荏
AGXW	荑
AUAJ	荓
AEER	荕
AFTX	荖
ADYY	荗
AUFF	荘
ADPU	荙
AMJJ	荝
APGF	荢
ANUD	荬
AXFU	荮
ASFF	荰
ANTN	荱
AGKU	荳
ARFW	荴
AVYN	荵
AKWN	荶
AWSK	荷
AFPB	荸
AHHR	荹
AFQU	荺
AQTO	荻
AWGS	荼
AEVF	荽
ACWT	荾
ADFE	莀
AAWW	莁
AKEJ	莂
ARDH	莃
AGJR	莄
AEGE	莇
AIWC	莈
ATJJ	莉
ANHF	莊
AUKQ	莌
AGIY	莍
ARIT	莏
AIPQ	莐
ATXU	莓
AMWG	莔
AGVA	莖
AVTK	莙
ATHP	莚
ATFP	莛
AWHT	莜
AWWF	莝
APFQ	莞
ATBR	莠
AKHU	莡
AYNN	莣
AQTF	莥
AIEF	莦
AHQB	莧
AYVE	莨
AEBF	莩
ATRY	莪
AQKQ	莬
AVCB	莭
ALER	莮
AISU	莯
AFQW	莰
ATKY	莵
ABKX	莻
AXGN	莼
ADYA	莽
ADFA	莾
AGMJ	莿
APQB	菀
AGEF	菁
ARQY	菂
AIAN	菃
AGJI	菄
APHN	菅
ABCU	菆
AVDF	菇
ARUF	菈
AVIU	菉
AQOU	菊
AKFI	菋
AJXX	菎
OGUW	菐
AVLF	菑
AJSU	菒
AEBC	菔
AWGA	菕
AJJF	菖
ARMF	菗
ASWC	菘
ATFG	菙
AAAU	菚
ARDY	菝
ATQT	菞
AIHC	菠
ABIB	菡
ARQN	菢
AAHC	菣
AUDB	菤
ASRJ	菥
ARPU	菦
AOQY	菧
AUVF	菨
AUKF	菩
APDF	菪
AGKG	菫
AIVK	菬
AICK	菭
AOVW	菮
AGAF	華
ABRY	菰
AHDD	菲
ADJN	菴
AMUN	菵
ADWG	菶
AVPH	菷
AYWU	菸
AIEG	菹
AYNE	菺
ASSU	菻
AOOU	菼
AHGC	菽
AGDN	菾
AGCJ	菿
AHAW	萀
AADW	萁
AYWF	萃
AQRM	萄
AGBJ	萅
ARTF	萆
ADEU	萇
AHQY	萈
AECB	萉
ASWW	萊
AGVV	萋
ATVF	萎
AQEF	萏
AGVH	萐
AYWQ	萒
APEG	萓
ARVK	萔
AYJF	萕
AEQB	萖
APFI	萗
ADFI	萘
ASPQ	萙
ARCG	萚
AHAJ	萛
AMWX	萞
ATVY	萟
AEEF	萠
AIRF	萡
AIQN	萢
APGH	萣
ATOU	萩
ATJF	萫
AQMU	萯
AGLI	萰
APGG	萱
AEGC	萲
AFMF	萳
AMNK	萵
AIEJ	萷
AEWU	萸
AJHF	萺
AUJF	萻
AKKN	萼
ABCL	萾
AITD	萿
ARTD	葀
AUGV	葁
AQKE	葂
AJTF	葃
AETF	葄
AWWG	葅
AWKS	葆
ACNS	葇
ACKS	葈
AEQK	葋
AGKL	葍
ATVG	葎
AIVG	葏
AWVL	葐
AFFF	葑
AXAF	葒
AIAW	葓
AWND	葔
ATIS	葕
APWY	葖
AFTJ	著
AGVL	葘
ASHF	葙
AADN	葚
AJQN	葛
ADHD	葜
AGVE	葝
AXBF	葞
AWVC	葠
AQGY	葡
ADYL	葢
ATGF	董
AUEJ	葥
ANKH	葦
AFPE	葧
ALGE	葨
ARCB	葩
AQEJ	葪
ADEF	葫
AGQA	葬
ANHC	葭
AWDC	葮
AXQY	葯
AWCT	葰
ADGY	葳
AWGD	葵
APLJ	葷
ALNU	葸
AYTB	葹
AKBF	葺
AWTJ	葻
ARBT	葼
ASVF	葽
AQBN	葾
AJLF	蒀
ASYP	蒁
AYUH	蒂
AXGE	蒃
APFF	蒄
AIVS	蒅
AAWV	蒆
AXXR	蒈
AWXX	蒊
AYTO	蒍
AIRE	蒎
APSG	蒏
ARQC	蒐
ARVC	蒑
AWNH	蒒
AJFF	蒔
ALWL	蒕
AFHW	蒖
AIYE	蒗
AVKR	蒘
AGKH	蒚
ARMW	蒛
AFII	蒜
ADRI	蒝
AUQK	蒟
ATHN	蒠
AYUY	蒡
ABWS	蒢
ATWS	蒣
AIWS	蒤
AQYL	蒥
ADHY	蒧
AWGE	蒨
ATEG	蒩
AUGA	蒫
APQY	蒬
AQBT	蒭
AEEJ	蒯
ATEC	蒰
ARGY	蒱
AXMW	蒳
AUBE	蒴
AEXD	蒵
AXWV	蒶
AKMU	蒷
AUVO	蒹
AUTD	蒺
AXUU	蒻
AWYK	蒼
ALDN	蒽
AOPU	蒾
AYKK	蒿
ABTI	蓀
ADWT	蓁
APJW	蓂
AEHC	蓃
AIYK	蓅
AOAH	蓆
AMEF	蓇
AYVB	蓈
APWK	蓉
AWCN	蓊
AWWT	蓌
AOVK	蓎
ADFF	蓐
ALFJ	蓒
AWUK	蓓
AUGO	蓔
ATLX	蓖
ATFH	蓗
AYWE	蓘
AOWF	蓙
AWHE	蓚
AGMT	蓛
ASGN	蓜
AIVC	蓡
AUFT	蓤
AWHS	蓧
ACNE	蓩
ACEP	蓪
AGEP	蓫
AODN	蓭
ATWH	蓯
ATHH	蓰
AIUA	蓱
AAKK	蓲
AAKG	蓳
AGJF	蓴
ARGH	蓵
AKWY	蓶
ARWY	蓷
ATRB	蓹
AFUY	蓻
ANWE	蓼
AJAF	蓽
AHLO	蓾
APWJ	蓿
AUKB	蔀
ALXI	蔂
AXKJ	蔃
AIFT	蔆
AVCQ	蔇
ASFI	蔈
AOJF	蔊
AGKW	蔌
AONX	蔍
AYWC	蔎
AYUK	蔏
AYUD	蔐
AVTO	蔒
AQGL	蔔
AAQH	蔕
AHAG	蔖
AOAO	蔗
ACCE	蔘
AYTH	蔙
ANFF	蔚
AGQT	蔜
AHOU	蔝
ALVF	蔞
AYTD	蔟
AXTU	蔠
AWFI	蔡
AIHV	蔢
APNM	蔤
AWVO	蔦
ADHV	蔧
ALUB	蔨
APGW	蔩
ALRJ	蔪
AGHO	蔫
ANHK	蔬
ABWC	蔭
ALAG	蔮
ABGI	蔯
AYNC	蔰
ARSC	蔱
APFT	蔲
AIGE	蔳
AOSS	蔴
ADAY	蔵
AGMU	蔶
ARQQ	蔸
APFC	蔻
AUMT	蔽
AETO	蔿
AVAF	蕁
AEUE	蕂
ATOL	蕃
AUNU	蕄
AIJY	蕅
ASJF	蕈
AWYO	蕉
ANNN	蕊
AHHH	蕋
AJJJ	蕌
AIWJ	蕍
ATDK	蕎
AQTJ	蕏
AGWG	蕐
AUEF	蕑
ALMU	蕒
AFFC	蕓
AFUC	蕔
AQTG	蕕
AIAS	蕖
AKHK	蕗
AFFQ	蕘
AGJN	蕙
ATUT	蕛
AHDN	蕜
AXQC	蕝
AJBC	蕞
AWXC	蕟
AVKI	蕠
AFAM	蕡
AEPH	蕣
AGEG	蕤
AAHY	蕥
AEDM	蕦
ATTT	蕧
ADUW	蕨
AXXI	蕬
AEQO	蕮
ABTG	蕯
AIJL	蕰
ATIE	蕱
AQWE	蕵
ACNM	蕷
ANHP	蕸
AYXY	蕹
AKBY	蕺
ADCW	蕻
ADCG	蕼
AMAE	蕽
AFLF	蕾
AOEC	蕿
AILL	薀
ATMD	薁
ARYT	薂
AIGF	薄
AEPT	薆
ATMT	薇
AWGJ	薈
AHDY	薉
AUQM	薋
AXTB	薌
AECN	薍
ALPA	薎
AUJN	薏
ATFT	薐
AGLG	薑
AHQO	薒
AFWK	薔
AOUO	薕
AMNP	薖
ALFY	薗
AFUP	薘
AGQR	薚
AWNF	薛
ANKF	薜
AQDY	薝
AGQE	薞
AWGW	薟
AODM	薠
AQEG	薢
AFKC	薣
AGQG	薤
ALQJ	薥
AONO	薦
AYKX	薧
ALPX	薨
ARIS	薬
ATRF	薭
ATGO	薰
AOGF	薱
APGM	薲
AFKP	薳
APNS	薴
AFNF	薵
AEJF	薶
AFDJ	薷
AISI	薸
AFKF	薹
AYUJ	薺
AONF	薼
ASFY	薽
AGWR	薾
AXTH	薿
AOOO	藀
AYKS	藁
ABCI	藂
AYKW	藃
AADI	藄
ALYJ	藅
APAR	藆
AEGW	藇
AHWD	藈
ATYA	藊
ANWY	藋
APNJ	藌
AVHL	藎
ADNY	藏
AQMT	藑
ATJN	藒
APDI	藔
AAHM	藖
AGKP	藗
AHAN	藘
AUEC	藙
APEO	藛
ATQI	藜
AFWC	藝
ADDD	藞
ALLL	藟
ARRR	藠
AYUP	藡
ALCX	藣
AOSR	藦
AXEC	藧
AITL	藩
ALVT	藪
AISF	藫
ABKM	藬
APWX	藭
ASWO	藮
ANFN	藯
AQYJ	藰
AURC	藱
ASAK	藲
AYKT	藳
AXJL	藴
AWKE	藵
ADTH	藶
AYFJ	藷
AGEJ	藸
AYJN	藹
AUWY	藺
APGN	藼
AUSQ	藽
AGKM	藾
AFWY	藿
ARLF	蘀
AGKK	蘁
ANNS	蘂
AHHS	蘃
ATQS	蘅
ATWM	蘈
ALPC	蘉
AHHM	蘋
ATRI	蘌
ATGE	蘍
AFEC	蘎
AXFM	蘏
AYEC	蘐
AOSD	蘑
ATQN	蘒
ATQO	蘓
AXTM	蘔
AXTP	蘕
ANKS	蘗
AYKE	蘘
AATN	蘙
AQOG	蘚
AADE	蘛
AAKO	蘜
AWGT	蘞
ABEN	蘟
AMMV	蘡
AUED	蘢
AAMG	蘣
AREO	蘤
AFKK	蘦
AHAP	蘧
AERI	蘨
ATXI	蘩
AIAL	蘫
ALDJ	蘮
AXJC	蘰
ALLF	蘲
AAMF	蘳
ABUY	蘵
ATVC	蘶
HGHT	蘷
ASGO	蘸
ANYE	蘹
AYRY	蘺
ALBI	蘻
ALLS	蘽
AFYE	蘾
AYUG	虀
AUTT	虁
AJTG	虄
AEUO	虅
ALLI	虆
AXAY	虇
AGKO	虉
AYXS	虊
AEMV	虋
AUMX	虌
HAWV	虎
HATW	處
HATF	虖
HARG	虗
HAEG	虘
HANT	虙
HAWR	虝
YWRW	虠
EFHW	虢
FHNW	虣
HAWW	虤
HAWA	虥
AAHW	虦
HAWN	虧
HASE	虨
IJIW	虩
HAWO	虪
JNHH	虯
JTAN	虴
GQJI	虺
JYNN	虻
JTNN	虼
XTJU	蚃
JDBN	蚅
JNYY	蚇
JGAH	蚈
JMWY	蚋
JXXN	蚍
JFCY	蚑
JMYG	蚒
JXHH	蚓
JQAN	蚔
JFQN	蚖
JKHH	蚛
JAHT	蚜
WVJU	蚠
JYWN	蚢
JWCY	蚣
CYJU	蚤
JWRY	蚥
JWJH	蚧
JFWY	蚨
BHGJ	蚩
JUFH	蚪
JQNN	蚫
JNXN	蚭
JWAY	蚮
JGUF	蚲
JQAY	蚳
JXET	蚴
JSKG	蚵
JAFG	蚶
JRYY	蚸
JWFY	蚹
JMFG	蚺
SNJU	蚻
JDHG	蚽
JHCY	蚾
JDCY	蛂
JHKG	蛅
JEGG	蛆
JPXN	蛇
JWYC	蛉
IPJU	蛍
JMAG	蛐
JCTG	蛑
JTKG	蛒
FJXY	蛓
JLKG	蛔
WNNJ	蛗
JUGH	蛘
JFFG	蛙
JGQJ	蛚
JVEY	蛝
JTDG	蛞
JYWR	蛟
JEEE	蛠
JUAH	蛢
JFKG	蛣
JWGK	蛤
JQQY	蛥
JGXW	蛦
JMRR	蛧
JDJG	蛨
AWYJ	蛩
DHVJ	蛪
JQDB	蛫
AWJU	蛬
JGCF	蛭
JFTX	蛯
JGVA	蛵
JEFY	蛶
JGIY	蛷
JIEG	蛸
JCEH	蛹
JDWW	蛺
JTRY	蛾
LQJU	蜀
JTNH	蜁
DFEJ	蜃
JHQN	蜆
RRJU	蜇
JKGD	蜈
JEBG	蜉
JTJH	蜊
JYVE	蜋
JXXF	蜌
JWGS	蜍
JKEG	蜎
JTBT	蜏
JFCE	蜐
THPJ	蜑
JTHP	蜒
JTFP	蜓
JQLG	蜔
JMJD	蜖
JTDK	蜘
JSWC	蜙
HDHJ	蜚
JNDG	蜛
JADW	蜞
JYCE	蜟
JLTY	蜠
JBLG	蜢
JUGN	蜣
SRJU	蜤
JWGA	蜦
JYNY	蜧
JGVH	蜨
JMFK	蜩
JQRM	蜪
JJXX	蜫
JBIB	蜬
JQEG	蜭
JAKG	蜮
JDWG	蜯
ECJU	蜰
JRTF	蜱
JTVG	蜲
JYKB	蜳
JJQR	蜴
JJGG	蜵
AHNJ	蜸
JWYG	蜼
JGMY	蜽
JJSY	蜾
JPQB	蜿
JGJI	蝀
GFGJ	蝁
JTHC	蝂
JCCC	蝃
JMUN	蝄
GDGJ	蝅
JHGF	蝆
JPGH	蝊
JIWG	蝋
JTUF	蝌
JVCB	蝍
JYKS	蝏
JJHG	蝐
JNHE	蝑
JDMD	蝒
JWGJ	蝓
JXXR	蝔
JRGG	蝗
JAJV	蝘
JYNA	蝙
JCNS	蝚
JDGY	蝛
JQMY	蝜
JXGE	蝝
JNHG	蝞
JLEG	蝟
JGKL	蝠
JYTB	蝣
JUSG	蝤
JNHC	蝦
NFJJ	蝨
JRBT	蝬
JJGH	蝭
JTJT	蝮
JEGC	蝯
JDFF	蝰
YNJJ	蝱
JGXY	蝳
JDEG	蝴
TOJU	蝵
JANS	蝶
JOUT	蝷
JMNK	蝸
JJLG	蝹
JTKY	蝺
JFMF	蝻
JDWJ	蝽
JJJN	蝿
UQFJ	螀
JVEP	螁
JYVB	螂
JYUY	螃
JWNH	螄
JTHN	螅
JUXX	螆
JEXD	螇
JDRI	螈
JUVO	螊
JEHC	螋
TEWJ	螌
GKMJ	融
JGKH	螎
JUTD	螏
JWNO	螐
JTHY	螑
FJFJ	螒
JDWT	螓
JRHW	螔
JTLX	螕
JMEG	螖
JOVK	螗
SJJU	螙
CEXJ	螚
JPDK	螛
FPGJ	螜
JRQC	螝
JPJW	螟
JUWL	螠
YJJU	螡
OOPJ	螢
EUDJ	螣
YJJW	螤
JGXI	螦
JAGW	螨
JWHS	螩
JYUK	螪
FOTJ	螫
JGMJ	螬
JYRC	螭
JAQH	螮
GQTJ	螯
JONX	螰
NFIJ	螱
JPWF	螲
JIPF	螳
BGJJ	螴
JSFI	螵
ANJJ	螶
ORTJ	螷
WWKJ	螸
JLRH	螹
JLVG	螻
TUJJ	螽
JPGW	螾
NHDJ	螿
JYXF	蟀
JWVS	蟂
JJLC	蟃
FUFJ	蟄
JOAO	蟅
JAJD	蟆
JLAG	蟈
JNWE	蟉
JTON	蟋
JTLN	蟌
JTJS	蟍
JAVJ	蟏
JIPH	蟐
JUJF	蟑
JADA	蟒
JQKE	蟓
JLFO	蟔
JHXH	蟕
JADR	蟖
JWAM	蟘
JUJY	蟙
FKUJ	蟚
JFKE	蟛
JIAS	蟝
JTOL	蟠
JETO	蟡
JXXY	蟣
JNNW	蟤
JAMW	蟥
JFAM	蟦
JOOE	蟧
JDUW	蟩
JGJN	蟪
JKKL	蟬
JWYO	蟭
JUGK	蟮
JVFJ	蟰
JRLO	蟱
JVAF	蟳
JDGF	蟵
JBKG	蟶
JIPL	蟷
GEJJ	蟸
JYLG	蟺
JUGY	蟻
AQKJ	蟼
JFUP	蟽
JQDY	蟾
LBWJ	蟿
JUQM	蠀
JAAS	蠂
AJMJ	蠆
JAJY	蠇
MADJ	蠈
JLGE	蠉
JOUO	蠊
JLQJ	蠋
JJQW	蠍
JYUJ	蠐
JOOS	蠑
GWMJ	蠒
JAPE	蠓
JFDJ	蠕
JAWC	蠖
JPGM	蠙
ADKJ	蠚
JALY	蠛
SRRJ	蠜
JLLL	蠝
TVCJ	蠞
XGEJ	蠡
JDAY	蠣
USGJ	蠤
BTWJ	蠥
FPDJ	蠧
JYFJ	蠩
UEGJ	蠪
EJJJ	蠫
JATN	蠮
UWLJ	蠲
JMMV	蠳
JALJ	蠴
JMWK	蠵
AQAJ	蠶
JHHY	蠷
JAKY	蠸
GKHJ	蠹
YXXJ	蠻
JHHC	蠼
IWYJ	蠽
VXXJ	蠿
TLVY	衂
TLDH	衃
TLNF	衄
TLIU	衆
TLRE	衇
TLBG	衈
TLAY	衊
VGDL	衋
TIGS	衍
TFGS	衎
TFQS	衏
TANS	衐
TYXS	衒
TMGS	衕
TRHS	衘
TDES	衚
TNKS	衛
TUTS	衜
TTGS	衝
TVDS	衟
TFHS	衠
PUYY	衤
PUGF	衧
PUCY	衩
PUBN	衪
PUET	衫
PUFW	衭
PUWV	衯
YKGE	衰
PUBY	衱
PUMW	衲
PUWC	衳
PUPQ	衴
PUKH	衶
PUWJ	衸
PUQA	衹
YAHE	衺
PUMF	衻
PUFC	衼
PUTF	衽
WYNE	衾
PUWN	衿
PUQU	袀
FKEU	袁
PUNW	袂
AVYE	袃
PUMY	袇
PUPX	袉
YQNE	袌
PUQN	袍
PUXE	袎
PUDA	袏
PUNT	袐
PUJG	袒
PUEG	袓
PUSK	袔
PUPW	袕
PUWE	袗
PUTB	袘
PURG	袙
PUDY	袚
PUQY	袛
PUWF	袝
YRWE	袠
PUUG	袢
PUAN	袣
YCNE	袤
PUDG	袥
PUBM	袦
PUQK	袧
PUYX	袨
PUHK	袩
YCKE	袬
PUTI	袮
PUNY	袯
XYEU	袰
PUWY	袱
YQQE	袲
PUQQ	袳
PUDN	袴
PUTH	袶
PUDB	袸
PUDJ	袹
PUFK	袺
PUTK	袼
PURI	袾
PUFF	袿
PULD	裀
FYEY	裁
GQJE	裂
PUHH	裃
PUTS	裄
PUTL	裇
PUPL	裈
PUVE	裉
WVGE	裊
PUGU	裋
PUDW	裌
PULS	裍
PUKG	裎
YJFE	裏
PUKE	裐
YEEU	裒
PUAA	裓
YEMK	裔
PUWK	裕
PUDE	裖
PUYK	裗
GIYE	裘
PUVK	裙
RRYE	裚
YKCE	裛
PUGY	補
NHDE	裝
IITE	裟
VTKE	裠
PUJF	裡
YQGE	裦
PUOO	裧
PURF	裨
PUJX	裩
PUQM	裪
PUFT	裬
PUHW	裭
PUJJ	裮
PUMK	裯
PUCC	裰
PUGE	裱
IPKE	裳
HDHE	裴
YHDE	裵
PUHD	裶
PUUB	裷
HGIE	裻
PUJR	裼
PUND	裾
PUDK	裿
PUAW	褀
JSEU	褁
PUFH	褂
PUHE	褃
PUGV	褄
PUYH	褅
PUJH	褆
PUTT	複
PUDD	褉
PUYA	褊
PUAS	褋
PUMJ	褍
PUJN	褐
PUEC	褑
YWKE	褒
PUWS	褓
PUGL	褔
PUAV	褗
PUNH	褘
PUUE	褙
EQNE	褜
PUJL	褞
PUAF	褠
PUAK	褡
YRQE	褢
PUPK	褣
PUFE	褤
PUDF	褥
PUCX	褦
BOYE	褧
PUUA	褨
TEWE	褩
PURW	褫
PUCS	褬
YCOE	褭
PUOH	褯
PAWE	褰
YLIE	褱
PULP	褳
PUYC	褵
PUNR	褶
PULV	褸
PUFY	褹
FUFE	褺
PUSN	褼
NFIE	褽
PUGJ	褿
PUGM	襀
PUCE	襂
YKKE	襄
PUOW	襆
PUUJ	襇
PUJC	襊
PUGI	襋
PUKL	襌
PUQE	襐
PUVF	襑
PUUT	襒
PUFQ	襓
PUUI	襕
PUTD	襖
PULF	襗
PUKS	襙
PUUP	襚
PUME	襛
PUWW	襝
PUSI	襟
PUIL	襠
PULJ	襡
PUYG	襢
PUTJ	襣
PUAL	襤
PUGR	襧
PUOF	襨
PUFM	襩
PUAY	襪
PULX	襬
PUJI	襮
PUUQ	襯
PUUD	襱
PUBB	襵
PUER	襷
PUTM	襸
PUGX	襹
PUAJ	襺
PUSR	襻
PUAC	襼
PUAI	襽
GMJG	襾
SGHG	西
STPU	覂
SJFJ	覃
SVQR	覅
STTT	覆
SAKE	覇
SRYT	覈
SAKO	覊
CHQN	覌
IHQB	覍
HQBD	覎
HQRR	覐
THGQ	覑
DHHQ	覔
NTHQ	覕
NGKQ	覗
HKHQ	覘
QIHQ	覙
IPHQ	覚
REHQ	覛
FOHQ	覝
HQHQ	覞
FNHQ	覟
VTKQ	覠
AWWQ	覡
OOHQ	覢
TVHQ	覣
HAWQ	覤
MAWQ	覥
WGEQ	覦
KKFQ	覨
FTJQ	覩
YUPQ	覫
PJYQ	覭
AMFQ	覯
HAEQ	覰
LRHQ	覱
AKGQ	覲
RWYQ	観
WGKQ	覴
UEHQ	覵
ECMQ	覶
HAOQ	覷
UJHQ	覸
HQTT	覹
HAGQ	覻
GWMQ	覼
PTOQ	覾
FLMQ	覿
AKKQ	觀
MQBD	觃
QEHJ	角
QEHH	觓
QEHE	觔
TQEH	觕
QEHW	觖
QEHA	觗
QEHT	觘
QEHY	觚
HXQH	觜
UDQH	觠
QEHK	觡
DHVH	觢
QEHG	解
QEHB	觤
QEHQ	觥
QEHI	觫
QMFJ	觰
DGKH	觱
QMFR	觴
QEHL	觶
ERRH	觷
QEHM	觹
QEHS	觻
QEHO	觾
YYYY	言
YNHH	訆
YWYY	訉
YQYY	訋
YCYY	訍
YGFH	訏
YVYY	訒
YTNN	訖
YTAN	託
YWVT	訜
YAHT	訝
YTDY	訞
YXHH	訠
YNWY	訣
YRRY	訤
YMWY	訥
YPQN	訦
YRBH	訩
YITT	訬
YWCY	設
YGAH	訮
YBYY	訯
YGBN	訰
YTFH	許
YKHH	訲
YNYY	訳
YSKG	訶
YJHH	訷
YSYY	訹
YWET	診
YYGG	註
YGHG	証
YQKG	訽
HXYF	訾
YHXN	訿
YHKG	詀
YWFY	詂
YYXY	詃
YRWY	詄
YWYC	詅
YMDY	詇
YVCY	詉
YKQN	詋
YAFG	詌
YANN	詍
YANG	詎
YXET	詏
YTHF	詐
YPXN	詑
YCKG	詒
YFCY	詓
YVKG	詔
YHCY	詖
YMKG	詗
YBMH	詘
YDCY	詙
YJGG	詚
YBHC	詜
YPSH	詝
YNGK	詞
DXYY	詟
YYNI	詠
YQJG	詢
YXJG	詣
YWNK	詤
YWGK	詥
YAAY	試
YYWR	詨
YVEY	詪
YRGK	詬
YQDB	詭
YWGG	詮
YTHG	詯
YFKG	詰
YTDG	話
YUGH	詳
YDEG	詴
YTFQ	詵
YYTH	詶
YMGK	詷
QDWY	詹
YTKG	詻
YGDF	詽
YQRB	詾
YFFG	詿
YUAH	誁
YQIY	誂
YQQY	誃
YDIY	誄
YRIY	誅
YAGG	誆
YGCF	誈
YNNY	誋
YFNY	誌
YGKI	誎
YTRY	誐
YQTG	誑
YCTD	誒
YTFP	誔
YFPB	誖
YTJH	誗
YTBT	誘
YGVA	誙
YIEG	誚
YVPC	誛
YCWT	誜
YWYK	誝
YFTB	誟
YDNY	誠
YAAH	誡
YHQN	誢
YAWW	誣
YTFK	誥
YCEH	誦
YWKQ	說
YDFE	誫
YUKQ	説
YFPQ	読
YAWX	誮
YJJG	誯
YWYG	誰
YGVH	誱
YNBM	誳
YPFI	誴
YRDE	誵
YYWF	誶
YMUN	誷
YSWW	誺
YIJG	誻
YPEG	誼
YEQN	誽
YRTF	諀
YCCC	諁
YSSY	諃
YYKB	諄
ADWY	諅
YADW	諆
YOOY	談
YTFG	諈
YTVG	諉
YQOY	諊
YGJI	諌
YQVH	諍
YAJG	諎
YBCY	諏
WKKY	諐
YGEY	諑
YHGC	諔
YHAW	諕
YWGA	論
YWYN	諗
YQAJ	諙
YPGH	諚
YEWY	諛
YNHE	諝
YYNA	諞
YJGH	諟
YPGG	諠
YWGL	諡
YPLH	諢
YMNK	諣
YKKN	諤
YTGF	諥
YYUH	諦
YXXR	諧
YGKL	諨
YUOG	諩
YYKS	諪
YGLI	諫
YWGJ	諭
YUQK	諮
YMDJ	諯
YLNY	諰
YSFG	諲
YUJG	諳
YDGY	諴
YFMF	諵
YADN	諶
YJGR	諹
YUTE	諺
YRGG	諻
YEGC	諼
YAKF	諽
YKBG	諿
YJQN	謁
YLEG	謂
YJTG	謃
EUDY	謄
YQBT	謅
YYNN	謆
PAWY	謇
YRQC	謉
YAYK	謊
YSKK	謌
YEHC	謏
YNTL	謐
YEXD	謑
YFHW	謓
YHAG	謔
YRHW	謕
YLWT	謖
YYUY	謗
YUWL	謚
YAMF	講
YDRI	謜
YTMF	謝
YYKK	謞
YEEG	謟
YQRM	謠
YERM	謡
YFFN	謣
YSFI	謤
YTLN	謥
FNWY	謦
YYRC	謧
YAJD	謨
AJDY	謩
YYUK	謪
YYUD	謫
YNWE	謬
YUEV	謭
YGMY	謮
YLPY	謰
YLVG	謱
YCCE	謲
YXFM	謴
YNRG	謵
YOAO	謶
YGQT	謸
YTQQ	謻
YHAF	謼
XKJY	謽
YJLC	謾
YFJE	謿
YNBT	譀
YAGF	譁
YKKL	譂
YULJ	譄
YVYH	譅
YFKK	譆
YDFJ	譇
YYKT	譈
YFFQ	譊
YUEG	譋
YETO	譌
OWWY	譍
YCNK	譎
YXXY	譏
YUSF	譐
YGJN	譓
YNNW	譔
YRLO	譕
YAQJ	譖
YTWK	譗
YUJY	識
YWYO	譙
YSJF	譚
YFWJ	譛
YLGE	譞
YKKS	譟
YYLG	譠
YIPL	譡
YUEP	譢
YWGW	譣
YRYT	譤
AQKY	警
YOUO	譧
YMAE	譨
YUJN	譩
YAJN	譪
YQDY	譫
NKUY	譬
YEAC	譭
UGYY	譱
YYWE	譲
YFDJ	譳
YKHP	譴
YOGF	譵
YYYF	譶
YFNF	譸
YXTH	譺
MMYF	譻
AHNY	譼
EGNY	譽
YUEN	譾
YDHN	譿
YYUP	讁
YQMT	讂
YFWM	讃
YLLL	讄
YPTL	讅
TNKY	讆
YUQE	讇
YDTH	讈
UEGY	讋
YAKO	讌
YGKK	讍
WYYY	讎
WYWY	讐
YYKE	讓
YBEN	讔
YUGI	讕
YMWK	讗
YBBB	讘
YAKY	讙
YAFC	讛
YIPO	讜
YKKT	讝
YHAY	讞
YFLY	讟
YDTF	诪
YPJH	谉
TDWK	谸
WWKC	谹
WWKT	谺
WWKG	谻
WWKW	谼
WWKK	谽
WWKA	谾
EXDK	谿
WWKD	豀
WWKE	豂
WWKM	豄
GKUF	豆
GKUC	豉
MAGU	豊
GKUB	豌
AHNU	豎
GKUO	豏
MDHU	豐
MAGT	豑
MDHL	豔
GEYI	豖
GQGE	豗
GEGN	豘
GEWC	豛
GEGA	豜
GECN	豝
GEQK	豞
GEYN	豟
QKEU	象
GEGF	豣
GEVE	豤
GEYW	豥
GEGY	豧
GERH	豨
GEGE	豩
YKPE	豪
GEFJ	豬
GENC	豭
GEFM	豮
GEED	豯
FPFC	豰
GEJL	豱
GEDI	豲
MGEE	豳
GEYD	豴
GETH	豵
GEFU	豷
ETYT	豸
EQYY	豹
EFTT	豺
EPWY	貁
EVKG	貂
EVGH	貄
EWSY	貅
EGJG	貆
EVEY	貇
ETEY	貈
EDJG	貊
EJFH	貋
ERQN	貌
EJFG	貍
EALG	貓
ETLX	貔
EKKL	貚
EAKY	貛
EHHC	貜
MHNY	貝
AYMU	貣
MYWN	貥
WXMU	貨
MRCY	販
WYNM	貪
RFMI	貭
FMNY	貮
ANMU	貰
HXMU	貲
AFMY	貳
KHGM	貴
CDMU	貵
WAYM	貸
MTGG	貹
MKQN	貺
MHKG	貼
QYVM	貿
FAMU	賁
MTKG	賂
WTFM	賃
MYNW	賅
MUAH	賆
MTLG	賉
MADT	賊
MOFG	賍
MDXY	賎
PGHM	賓
PNMU	賔
MGIY	賕
MWGS	賖
MKKH	賗
MOFY	賘
MMFK	賙
SWWM	賚
FWFM	賛
MPWS	賝
IPKM	賞
MMAW	賟
MUKG	賠
OVWM	賡
AHNM	賢
MAAY	賤
MOOY	賧
MDEY	賬
VHGM	賮
MQJB	賯
MDWJ	賰
MPLH	賱
WKSM	賲
MFKY	賳
GKIM	賴
MJHG	賵
FKKM	賷
EUDM	賸
MUWL	賹
MUVO	賺
MGEF	賻
MAMF	購
ATDM	贀
MMTY	贁
FUFM	贄
GQTM	贅
MDYY	贆
YFHM	贇
MULJ	贈
MSJF	贉
TFQM	贊
MOGW	贌
MQDY	贍
MAJY	贎
YNKY	贏
MVHL	贐
MDNY	贓
MMMU	贔
QYTM	贕
MFLM	贖
MIPM	贘
HAWM	贙
UJFM	贛
MADY	贜
FWWM	赍
FOQW	赥
FOBC	赧
FOJY	赨
FOQC	赩
FOHM	赪
FOFJ	赭
FONC	赮
FOOK	赯
FUYU	赱
FHEE	赲
FHNH	赳
FHHI	赴
FHMK	赸
FHQU	赹
FHWN	赺
FHIT	赻
FHQW	赼
FHRK	赾
FHQA	赿
FHTT	趀
FHQI	趂
FHRW	趃
FHEG	趄
FHVK	超
FHQY	趆
FHUD	趇
FHHK	趈
FHBM	趉
FHGY	越
FHFK	趌
FHQQ	趍
FHRI	趎
FHTD	趏
FHND	趐
FHUW	趑
FHWS	趓
FHGJ	趔
FHJF	趕
FHWF	趖
FHKH	趗
FHGI	趚
FHQD	趛
FHQO	趜
FHAJ	趞
FHIK	趟
FHHF	趠
FHVI	趢
FHPD	趤
FHUG	趥
FHUK	趦
FHJH	趧
FHQT	趨
FHLW	趩
FHAW	趪
FHTK	趫
FHFQ	趬
FHWO	趭
FHKS	趮
FHGR	趰
FHTM	趲
KHWY	趴
KHQY	趵
KHTN	趷
KHNW	趹
KHFW	趺
KHWN	趻
KHGA	趼
KHYT	趽
KHHG	趾
KHBY	趿
KHCN	跁
KHFC	跂
KHRY	跅
KHCK	跆
KHWE	跈
KHWC	跉
KHFI	跊
KHDY	跋
KHRW	跌
KHDG	跍
KHPX	跎
KHEK	跏
KHHX	跐
KHQN	跑
KHSK	跒
KHYG	跓
KHQK	跔
KHHK	跕
KHWF	跗
KHMG	跚
KHHC	跛
KHNX	跜
KHAN	距
KHGW	跠
KHYO	跡
KHQQ	跢
KHTQ	跣
KHYR	跤
KHBS	跥
KHRI	跦
KHWG	跧
KHJX	跩
AWYH	跫
KHTK	路
KHQI	跳
KHSG	跴
KHDP	跶
KHWS	跺
KHNK	跼
KHNN	跽
WHTH	跾
KHFH	跿
KHKH	踀
KHBN	踂
KHIE	踃
KHHH	踄
RRKH	踅
KHCT	踆
KHTX	踇
KHGI	踈
KHYE	踉
KHFB	踋
KHDK	踎
KHAA	踐
KHTV	踒
KHHF	踔
KHQO	踘
KHBC	踙
KHWA	踚
KHFT	踜
KHJS	踝
KHND	踞
KHPB	踠
KHJR	踢
KHUK	踣
KHYF	踤
KHUV	踥
KHWH	踨
KHUG	踫
KHQH	踭
KHOK	踮
KHWJ	踰
KHOC	踱
KHRH	踲
KHDJ	踳
KHCE	踴
KHTF	踵
KHJH	踶
KHFJ	踷
KHMJ	踹
KHVP	踺
KHMK	踻
KHTY	踽
KHGL	踾
KHAS	蹀
KHYA	蹁
KHAK	蹃
KHYH	蹄
PAWH	蹇
KHEE	蹈
KHUA	蹉
KHJN	蹋
KHWK	蹌
KHNE	蹍
KHQL	蹓
LRKH	蹔
KHJF	蹕
KHDE	蹖
KHOX	蹗
KHIF	蹚
KHAH	蹛
KHPJ	蹜
KHXM	蹞
KHOO	蹠
KHNF	蹡
KHYD	蹢
KHTH	蹤
KHLP	蹥
KHME	蹦
KHGJ	蹧
KHKM	蹪
KHWU	蹬
KHUJ	蹭
KHSN	蹮
KHTL	蹯
KHUF	蹲
KHYY	蹴
YKIH	蹵
KHDW	蹶
DUBH	蹷
KHOH	蹸
KHFQ	蹺
KHOW	蹼
KHDI	蹽
KHKS	躁
KHFP	躂
KHLJ	躅
KHHE	躆
KHAJ	躇
KHRT	躈
AJMH	躉
KHFF	躊
KHNY	躍
KHGR	躎
KHVN	躐
KHUB	躑
KHRS	躒
KHRM	躓
KHOF	躕
KHXG	躖
KHUD	躘
KHUY	躙
KHSP	躚
KHUI	躝
KHYC	躞
KHBB	躡
KHUN	躢
KHHY	躣
KHPN	躥
KHTM	躦
KHGX	躧
KHUT	躨
KHAY	躪
TMDX	躬
TMDQ	躭
TMDV	躮
TMDG	躰
TMDS	躲
TMDE	躴
TMDN	躵
TMDO	躹
TMDK	躺
TMDA	躻
TMDD	躾
TMDI	躿
TMDL	軃
TMDU	軆
TMDM	軉
LGQN	軏
LNFH	軐
LWYY	軓
LVYY	軔
LWCY	軗
LHCY	軙
LDBN	軛
LMWY	軜
LQAN	軝
LTFN	軞
LTFG	軠
LWYN	軡
LFCY	転
LQKG	軥
LKQN	軦
LQAY	軧
LCKG	軩
LXET	軪
LWET	軫
CDLJ	軬
LAGG	軭
LMDY	軮
LGUF	軯
UXLJ	軰
LQNN	軳
LYGG	軴
LWFY	軵
LDCY	軷
LKWY	軹
LVKG	軺
LSKG	軻
LRWY	軼
LCFG	軽
LAAY	軾
LUAH	軿
LDMJ	輀
LAWY	輁
AWLJ	輂
LIGQ	輄
LWGG	輇
LTEY	輈
LGCF	輊
MDLJ	輋
LGMM	輌
LWWK	輍
LIEG	輎
LSGG	輏
LPFQ	輐
LVTK	輑
LBNN	輒
LQKQ	輓
LGEY	輔
LMFK	輖
LEQN	輗
LFWT	輘
LBCY	輙
LGMY	輛
LVLG	輜
LMUN	輞
LCCC	輟
LJSY	輠
LQEG	輡
LEEG	輣
LGEG	輤
LJXX	輥
FWFL	輦
LPHN	輨
HDHL	輩
LWGA	輪
LYKI	輬
LDMD	輭
LCNS	輮
LDGY	輱
LDWD	輳
LRFH	輴
LJQN	輵
LUSG	輶
LQYG	輷
LTJT	輹
LGVL	輺
LJLG	輼
LCDL	輽
LLWL	轀
LDWT	轃
LONX	轆
LGJF	轉
LDHV	轊
LLPY	轋
LFVG	轌
LYCT	轍
LNBB	轏
LOGW	轐
LDUI	轑
LFAM	轒
LTOL	轓
LOQH	轔
LAJN	轕
LFWK	轖
LDGN	轗
LUGY	轙
LBWL	轚
LOGF	轛
LFDJ	轜
EGNL	轝
LAHL	轞
LXXK	轡
LRXS	轢
LDTH	轣
LHAL	轤
LAUY	轥
LTUF	轷
DUFJ	辜
CKUF	辝
THUF	辠
UDUF	辡
GKIF	辢
EPCF	辤
BTWF	辥
UDVF	辧
HWNF	辪
ECMF	辭
UDYF	辯
SSDE	辳
PYNY	辶
TYPI	込
GFPK	迂
FNPV	迃
GMHP	迊
GBNP	迍
DYPI	迏
YWPV	迒
AHTP	迓
TFPK	迕
GDPI	迗
KHPK	迚
HKPD	迠
NXPV	迡
ANPV	迣
MKPD	迥
EKPD	迦
JHPK	迧
CKPD	迨
YGPD	迬
THFP	迮
QHPI	迯
PXPV	迱
FCPI	迲
LKPD	迴
MGKP	迵
DEPD	迶
QQPI	迻
FKPD	迼
GQJP	迾
QJPD	迿
TAHP	逄
RGKP	逅
UBTP	逆
FBPV	逇
TMKP	逈
GEHP	逋
HMNP	逌
SGPD	逎
GEPI	逐
GIYP	逑
RFMP	逓
GVAP	逕
QTOP	逖
CTDP	逘
GKPD	逜
RRPK	逝
GKIP	速
CWTP	逡
IITP	逤
WWKP	逧
SWWP	逨
DFAP	逩
AJPD	逪
CCCP	逫
TGDP	逬
PHNP	逭
VIPI	逮
RTBP	逰
MFKP	週
YCEP	逳
HJFP	逴
FWFP	逵
JQRP	逷
FUFP	逹
FNWP	逺
ADKP	逽
JGQP	逿
DAEP	遀
RFHP	遁
UTEP	遃
MDMP	遄
NUGP	遅
YUPP	遆
JGHP	遈
HMPI	遉
YTBP	遊
KKFP	遌
RGPD	遑
FMUP	遖
AMFP	遘
EHCP	遚
QYVP	遛
LIPI	遝
NUFP	遟
JNPD	遢
COPI	遤
XFMP	遦
UJFP	遧
EGEP	遯
AQPP	遰
LVPD	遱
AWWP	遳
USGP	遵
FFFP	遶
NNAP	選
CNHP	遹
KHGP	遺
KKUP	遻
HAGP	遽
TAWP	遾
QEHP	邂
PWUP	邃
YLKP	邅
WGKP	邆
GWMP	邇
ERQP	邈
THPP	邊
VLRP	邋
TQTP	邌
TLVP	邍
QYTP	邎
GMYP	邐
GFBH	邘
YNBH	邙
FWBH	邞
YWBH	邟
WVBH	邠
PQBH	邥
DTBH	邦
FQBH	邧
GBNB	邨
DTKC	邫
QKBH	邭
CKBH	邰
RGBH	邱
NTBH	邲
GMWB	邴
VKBH	邵
UXBH	邶
GNNB	邷
QAYB	邸
AGBH	邼
FFBH	邽
RIBH	邾
DFNB	郀
YNTB	郂
WGKB	郃
RDCB	郄
GCFB	郅
FKBH	郆
QJBH	郇
RGKB	郈
GDFB	郉
THBH	郋
FFKC	郌
TEBH	郍
YVCC	郒
THPB	郔
DNXB	郕
RDMB	郗
KKBH	郘
GEHB	郙
GKBH	郚
EBBH	郛
TFKB	郜
FOBH	郝
YVEB	郞
DWWB	郟
GJRB	郠
VTKB	郡
KGBH	郢
FPBB	郣
RDEB	郩
GVHB	郪
GEBH	郬
YKBB	郭
MFKB	郮
BCBH	郰
UABH	郱
SWWB	郲
EQBH	郳
UKKC	郶
XTVB	郷
HDYB	郹
QQVC	郺
HNVB	郻
NKAB	郼
NHBH	郿
ADKB	鄀
UXEB	鄁
KKFB	鄂
TKMB	鄅
WNTB	鄇
WGDB	鄈
XTBB	鄊
EHCB	鄋
OVHB	鄌
PJYB	鄍
THNB	鄎
DFEB	鄏
YXLB	鄐
GOGB	鄑
WNGB	鄔
XTRB	鄕
YKMB	鄗
OVEB	鄘
AJDB	鄚
VJSB	鄛
ONJB	鄜
NWEB	鄝
GJHB	鄟
WVGB	鄡
UJFB	鄣
JLCB	鄤
RLGB	鄦
UMIC	鄨
VAKB	鄩
XJMB	鄪
ULJB	鄫
QYVB	鄮
UGUB	鄯
OQAB	鄰
TOLB	鄱
OGUB	鄴
KKKB	鄵
WGLB	鄶
MAGB	鄷
ALPB	鄸
BCIB	鄹
OAMB	鄺
FWFB	鄻
OJFB	鄽
DEPB	鄾
AKKB	鄿
AKUB	酀
QKXB	酁
MWYB	酅
MDHB	酆
GMYB	酈
SGSH	酊
SGNN	配
SGFY	酎
SGBN	酏
SGFH	酐
SGGF	酑
ISGG	酒
WYNG	酓
SGVF	酔
SGTN	酕
SGPQ	酖
SGWV	酚
SGFQ	酛
SGFW	酜
SGDY	酞
SGHK	酟
SGSK	酠
SGPX	酡
SGTF	酢
SGDG	酤
SGNY	酦
SGPF	酧
FSGY	酨
SGQK	酩
SGWG	酫
SGMK	酮
SGXJ	酯
SGTQ	酰
SGXE	酳
SGWS	酴
SGFB	酵
SGTX	酶
SGTK	酷
SGEF	酹
SGGY	酺
SGEB	酻
SGYK	酼
SGWY	醀
SGVI	醁
SGSS	醂
SGDN	醃
SGQM	醄
SGUK	醅
SGAA	醆
SGOO	醈
SGCC	醊
SGAJ	醋
SGJX	醌
SGJH	醍
SGFJ	醏
SGDE	醐
SGJG	醒
SGPL	醓
TOSG	醔
SGYJ	醕
SGWQ	醗
SGFL	醘
SGEC	醙
SGOP	醚
SGAG	醛
SGRC	醜
SGUA	醝
SGML	醠
SGDL	醢
SGOK	醣
UEFG	醤
SGSI	醥
SGCE	醦
SGAK	醧
SGYC	醨
SGGJ	醩
SGNE	醪
ATDG	醫
NHDG	醬
SGOW	醭
SGWO	醮
SGYL	醯
SGSF	醰
SGWC	醱
SGME	醲
SGLF	醳
SGHE	醵
SGWW	醶
SGUN	醷
SGTO	醺
SGFF	醻
SGAO	醼
SGFK	醽
SGOI	醿
SGYE	釀
EMGV	釁
SGGX	釃
SGOD	釄
SGKT	釅
TONY	釈
TOMG	釉
TOLF	釋
TGJF	重
JGJF	量
FITF	釐
QQYY	釣
QWYY	釩
QGFH	釪
QFNN	釫
QFTT	釮
QYNN	釯
QVYY	釰
QTNN	釳
QAYY	釴
QCYY	釵
QRHY	釽
QAHT	釾
QPQN	鈂
QGAH	鈃
QWCY	鈆
QFWY	鈇
QMWY	鈉
QWXN	鈋
QNWY	鈌
QGBN	鈍
QQCY	鈎
QXHH	鈏
QWYN	鈐
QRCY	鈑
QBYY	鈒
QNHF	鈕
QWVT	鈖
QCQN	鈗
QFCY	鈘
QXXN	鈚
QQUG	鈞
QKHH	鈡
QGHN	鈣
QDYY	鈦
QYWN	鈧
QFQN	鈨
QYNT	鈩
QDBN	鈪
QNYY	鈬
HXQF	鈭
QNXN	鈮
QBMH	鈯
QYMH	鈰
QNNA	鈱
QSKG	鈳
QGMW	鈵
QCKG	鈶
QDCY	鈸
QHCY	鈹
QGYY	鈺
QHNN	鈻
QTHF	鈼
QDMH	鈽
QWET	鉁
QKRY	鉂
QRWY	鉄
QANG	鉅
QHKG	鉆
QPXN	鉈
QYXY	鉉
QQNN	鉋
QNTT	鉍
QEGG	鉏
QYGG	鉒
QTMH	鉓
QTUY	鉖
QXJH	鉘
QKWY	鉙
QQTB	鉚
QWFY	鉜
QGNY	鉞
QDHG	鉟
QMDY	鉠
QUGH	鉡
QSGG	鉢
QSYY	鉥
QGHG	鉦
QWIY	鉩
QANN	鉪
QEKG	鉫
QJGG	鉭
QJHH	鉮
QNYW	鉯
QNGK	鉰
QOCY	鉱
QHGH	鉲
QUXN	鉳
QGAJ	鉶
QAWY	鉷
QYWR	鉸
QQQY	鉹
QTKG	鉻
QUAH	鉼
QCTG	鉾
QWGK	鉿
QQJG	銁
QYCQ	銃
QDJG	銆
QDIY	銇
QFFG	銈
QVGH	銉
QDGY	銊
QWTF	銋
QDHB	銌
QGCF	銍
AWYQ	銎
QMMG	銏
GQJQ	銐
QTFQ	銑
QGDF	銒
QWGG	銓
QDHF	銔
QGXW	銕
QRIY	銖
QRGK	銗
QQKG	銘
QDFN	銙
QQIY	銚
QWSY	銝
QJQF	銞
QMMH	銟
QFTX	銠
QFKG	銡
QFIY	銢
QVKG	銣
QYEY	銥
QLDY	銦
QIGQ	銧
QPVG	銨
QTFC	銩
QDEG	銪
QQCN	銫
QFTN	銬
QDXY	銭
QXIY	銯
QARY	銰
QJFH	銲
RRQF	銴
QTMT	銵
QGIY	銶
QBNN	銸
QTBT	銹
NHDQ	銺
QUXT	銻
QWWF	銼
QQAK	銽
QAIY	銾
QCEH	銿
QGKU	鋀
QTXY	鋂
QYVE	鋃
QGOC	鋄
QUFH	鋅
FQUQ	鋆
ITDQ	鋈
QGKI	鋉
QWWK	鋊
QTHP	鋋
QTFP	鋌
QFPB	鋍
QPFQ	鋎
QDWW	鋏
QPDC	鋐
QCWT	鋑
QTDH	鋒
QTJH	鋓
QQKQ	鋔
QFNY	鋕
QEVG	鋖
QKEG	鋗
QKGD	鋘
QGKG	鋙
WHTQ	鋚
QKKH	鋛
QKHY	鋜
QEFY	鋝
QGVA	鋞
QVPC	鋟
QDFE	鋠
QEBG	鋢
QEGE	鋤
QNNK	鋦
QHQN	鋧
QAYN	鋩
TJQF	鋫
RRCQ	鋬
QUKQ	鋭
QDNY	鋮
QTFK	鋯
QJFG	鋰
QANY	鋱
QRGW	鋲
QDTF	鋳
QDQN	鋴
QTWN	鋵
QBCY	鋷
QNDG	鋸
QDEY	鋹
QPQB	鋺
QHJF	鋽
QQRM	鋾
QIMK	鋿
QJSY	錁
QFWT	錂
IHCQ	錃
TQTQ	錅
QGEG	錆
QUDB	錈
QQAJ	錉
QYWF	錊
QEEG	錋
QMDF	錌
QRTF	錍
QQEG	錎
QGFG	錏
QWYG	錐
QYNY	錑
QBSK	錒
QUFQ	錓
QIJG	錔
QJXX	錕
HGIQ	錖
QTVG	錗
QTFG	錘
QVLG	錙
QQVH	錚
QDFA	錛
QPFI	錝
QYKB	錞
QOOY	錟
QDSK	錡
QAAY	錢
QCCC	錣
QADW	錤
QYCE	錥
QPHN	錧
QALG	錨
QJJG	錩
QMAW	錪
QGJI	錬
QMFK	錭
QLDG	錮
QSOY	錰
QVIY	録
QBLG	錳
QFWF	錴
QAWX	錵
QGEY	錶
QLNN	錷
QSWW	錸
QHEG	錹
QAYT	錺
QFHY	錻
QDFI	錼
QGOT	錽
QHAW	錿
QYKI	鍄
QXXR	鍇
QAMD	鍈
QJGH	鍉
QGLI	鍊
QOAC	鍍
QRFH	鍎
QNKH	鍏
QRBT	鍐
QTJT	鍑
QCNS	鍒
QKBG	鍓
QKKN	鍔
QPLH	鍕
QADN	鍖
QYUH	鍗
QMJH	鍘
IAWQ	鍙
QJGR	鍚
QNHC	鍜
QJMY	鍝
QHMY	鍞
QJTG	鍟
QRGG	鍠
QLGE	鍡
QAVK	鍣
QQYG	鍧
QWGD	鍨
CNHQ	鍪
TOQF	鍫
QWND	鍭
QWGJ	鍮
QEGC	鍰
QANS	鍱
QNNJ	鍲
QMDJ	鍴
QLNY	鍶
QDFF	鍷
QPGG	鍹
QFTJ	鍺
QJQN	鍻
QYNA	鍽
QTGF	鍾
QGVL	鍿
QWHE	鎀
QBBH	鎁
QUGD	鎂
QIRE	鎃
QLWJ	鎅
QUEJ	鎆
QJNG	鎉
QYUY	鎊
QPDK	鎋
QUVO	鎌
QFPI	鎍
QRNO	鎎
IYCQ	鎏
QERM	鎐
QFCL	鎑
QWCN	鎓
QPWK	鎔
QOVK	鎕
QWYK	鎗
QGKH	鎘
QUBE	鎙
QWNP	鎚
QGEF	鎛
TEWQ	鎜
QTLX	鎞
QCCS	鎟
QLGH	鎠
QUXX	鎡
QWNO	鎢
OOPQ	鎣
QJIQ	鎤
QQYL	鎦
QMGU	鎧
QWYF	鎨
QRSC	鎩
QEHC	鎪
QYKK	鎬
QXHW	鎭
QUWL	鎰
QFKE	鎱
QIPQ	鎲
QTHS	鎳
QTHN	鎴
QPGE	鎵
QSKK	鎶
QCOY	鎷
QWYB	鎸
QUDP	鎹
QPYG	鎺
QVMY	鎻
QHAR	鎼
QMTH	鎽
QJLG	鎾
QHLO	鏀
QVJS	鏁
QAKK	鏂
QYTD	鏃
QGJF	鏄
QXFM	鏆
QYTH	鏇
QGKW	鏉
GQTQ	鏊
QAMY	鏋
QAJD	鏌
QLXI	鏍
QJAF	鏎
QDHV	鏏
QNWE	鏐
QYUD	鏑
QCCE	鏒
QTLN	鏓
QONX	鏕
ONJQ	鏖
QAHF	鏗
QIPH	鏛
QIPF	鏜
QJLC	鏝
QOVH	鏞
QUTG	鏟
QTDP	鏠
QSFI	鏢
QOAO	鏣
QLVG	鏤
QPWJ	鏥
FNWQ	鏧
LRQF	鏨
QLRH	鏩
QGMJ	鏪
QHAF	鏬
QOVI	鏮
QDRR	鏯
QMEE	鏰
QYXG	鏲
QULJ	鏳
QKHK	鏴
QAGF	鏵
QWYS	鏶
QOGW	鏷
QGJN	鏸
QXKJ	鏹
QWXC	鏺
QOQH	鏻
QTGI	鏼
QVFJ	鏽
QAET	鏾
QIPS	鏿
QKHM	鐀
QADR	鐁
QGJL	鐂
QFFQ	鐃
QAMW	鐄
UMIQ	鐅
BUEQ	鐆
QTOL	鐇
QNNW	鐉
QBJR	鐊
QIJR	鐋
QQKE	鐌
QCNK	鐍
QWYO	鐎
QUSF	鐏
QXFK	鐑
QOOE	鐒
QYKT	鐓
QSJF	鐔
QAQJ	鐕
QXXY	鐖
QUEG	鐗
QUJF	鐘
QWGU	鐙
QGFN	鐚
QJYI	鐛
YKBQ	鐜
QVAF	鐞
QFWJ	鐟
QUOJ	鐠
SRRQ	鐢
QIPR	鐣
QUGK	鐥
QXJM	鐨
QUEP	鐩
QHAE	鐪
QHDY	鐬
QTMD	鐭
QOUO	鐮
QKKS	鐰
QWGW	鐱
QLQJ	鐲
QFLG	鐳
QNKF	鐴
QFKY	鐵
QAAS	鐷
QLFF	鐸
QMNP	鐹
QIPL	鐺
QFAM	鐼
QFUP	鐽
NKUQ	鐾
QUJN	鐿
QEPT	鑀
QOBT	鑁
QTGO	鑂
QOOS	鑅
QOGF	鑆
QYUJ	鑇
QGWR	鑈
QAFL	鑉
QAWC	鑊
LGVQ	鑋
QPGM	鑌
MMQF	鑍
QAKM	鑎
QPNS	鑏
QFDJ	鑐
QAHL	鑑
AHNQ	鑒
QKHP	鑓
QRRM	鑕
QALY	鑖
QLLL	鑘
QTDJ	鑙
QFWM	鑚
QOAW	鑛
QIPM	鑜
QATP	鑝
QVLN	鑞
QFLM	鑟
QRXS	鑠
QHBH	鑡
QHAN	鑢
QONO	鑣
QJAI	鑤
QQOJ	鑥
QAHM	鑦
QPAY	鑧
QUED	鑨
QGKK	鑩
QHAL	鑪
QQQF	鑫
QAHQ	鑬
QUGI	鑭
QAIF	鑮
QWWY	鑯
QWGA	鑰
QQKY	鑱
QYKE	鑲
QPAH	鑳
QMWK	鑴
QAKY	鑵
QADY	鑶
QBBB	鑷
QLLF	鑸
QPWN	鑹
QHHY	鑺
QSRR	鑻
QTFM	鑽
YXXQ	鑾
QHAY	钀
QHHC	钁
QIPO	钂
QNIJ	钃
QAUI	钄
QTGN	钅
QNRT	钖
QDHY	钚
QAKG	钷
QGOG	铔
QAHB	铘
QKMH	铞
QKGG	锃
QYCK	锍
QUGA	锎
QUJG	锏
QADK	锘
QJGF	锝
QRFM	锧
QRQW	锨
QQRN	锪
QUKG	锫
QNHG	镅
QWGR	镎
QDUW	镢
QQGJ	镥
QPWH	镩
QPWI	镲
DCQY	镹
DCTD	镺
DCRW	镻
DCNM	镼
DCDI	镽
DCGR	镾
UHNG	門
UGAK	開
UYWV	閌
UDCI	閎
UUFK	閗
UYMH	閙
UGUF	閛
UCAK	閞
UNTE	閟
UYNW	閡
UUDI	関
UWGK	閤
UWAI	閥
UWWW	閦
UAWI	閧
UFFD	閨
ULSI	閫
UYVE	閬
UKKD	閭
UTFP	閮
UJJD	閶
RSUW	閷
UDJN	閹
UJYI	閺
UQED	閻
UQAJ	閽
UAKG	閾
UEPC	閿
UAWN	闀
UUDB	闂
UHDY	闃
USVD	闄
UHHC	闅
UKKK	闆
UNKH	闈
USFD	闉
UGLI	闌
URII	闎
UFHW	闐
UTHS	闑
UJND	闒
UFCL	闔
UUBW	闕
UCOI	闖
UGKF	闘
UYNK	闙
UFWQ	闚
UIPF	闛
UXXG	關
UMTI	闝
UNBT	闞
UKHM	闠
UKKL	闡
UNKF	闢
UIPL	闣
UFUP	闥
UMAU	闦
UFKP	闧
UMNV	闿
BNFH	阠
BTFH	阡
BGQN	阢
BTNN	阣
BUFH	阧
BDBN	阨
BDHY	阫
BYWN	阬
BCQN	阭
BFQN	阮
BXXN	阰
BFJH	阱
BYNN	阸
BQAY	阺
BTHF	阼
BHKG	阽
BTBN	陁
BHCY	陂
BGMW	陃
BQQY	陊
BTAH	降
BRIY	陎
BDEG	陏
BQDB	陒
BDFN	陓
BCWT	陖
BIEG	陗
BGVA	陘
BDFE	陙
BXXF	陛
BDWW	陜
BDTY	陝
BTAF	陞
BHHT	陟
BGEY	陠
BFHY	陡
BQHJ	陥
BDTF	陦
BHDD	陫
BBCY	陬
BDSK	陭
BWYG	陮
BWGA	陯
BWYC	陰
BQOY	陱
BTFG	陲
BRTF	陴
BQRM	陶
BTAJ	陹
BSFG	陻
BFTJ	陼
BDMD	陾
BADW	陿
BTGF	隀
BAJV	隁
BWDC	隂
BWGJ	隃
BJGH	隄
BJMY	隅
BDGY	隇
BLGE	隈
BEAG	隉
BDAE	隋
BUJG	隌
BRGG	隍
BMGU	隑
BUVO	隒
BDAA	隓
BGKH	隔
BWNO	隖
BRQC	隗
BUWL	隘
BIJI	隙
BIPF	隚
BWFI	際
BWVO	隝
BGQT	隞
BVJS	隟
BEVN	隠
BUTG	隡
BFFQ	隢
BOQH	隣
BWGU	隥
BNKF	隦
BDAP	隨
BTMD	隩
BWGW	險
BFAM	隫
BGWR	隬
BYUJ	隮
BFNF	隯
BJXO	隰
BITO	隲
BDAN	隳
BUED	隴
BHAA	隵
FFII	隷
SFII	隸
PWYD	隺
WYCU	隻
AYWY	隿
DWWY	雁
WYSU	集
HGHY	雈
TDWY	雉
WYHM	雋
YXTY	雍
EGWY	雎
HAWY	雐
VSWY	雑
TKWY	雒
WGSY	雓
KJWY	雖
FJFY	雗
MYAC	雘
WYWC	雙
YWWY	雜
VKCY	雝
BTWK	雟
NWEY	雡
AKFY	難
ERRY	雤
FGHY	雨
FFNB	雩
FGHU	雫
FBYU	雭
FTFN	雮
FWVR	雰
FMDU	雵
FWYC	零
FAFF	雸
FCNT	雺
FQIU	雿
FISU	霂
FIPQ	霃
FIEF	霄
FTFP	霆
FIGH	霈
FFOG	霊
FGVV	霋
FMFK	霌
FUVF	霎
FHDD	霏
FIXC	霐
FFCN	霒
FIYG	霔
FSSU	霖
FIWC	霗
FAMD	霙
FXXX	霛
FKKK	霝
FIAW	霟
FUWN	霠
FEYI	霡
FERE	霢
FKMU	霣
FQYL	霤
FSSE	霦
FCNE	霧
FNRF	霫
FLAW	霬
FIAN	霮
FAET	霰
FCNK	霱
FBTG	霳
FFCI	霴
FKBY	霵
FIYY	霶
FJJR	霷
FNKF	霹
FTMT	霺
FMAU	霻
FFCO	霼
FYUJ	霽
FEJF	霾
FCNH	霿
FAPE	靀
FLLL	靁
FDTH	靂
FYJN	靄
FFCM	靅
FFCP	靆
FFCT	靉
FIDH	靋
FPGM	靌
FWYO	靍
FQWO	靎
FPWO	靏
FLFL	靐
GMHG	靑
GERN	靔
GHGE	靕
UGEG	靖
GEIQ	靗
GEQC	靘
GEPH	靛
GERO	靝
HDHD	非
DLKF	靣
DMJQ	靦
DMJM	靧
DJED	靨
AKFJ	革
AKFX	靴
AKFC	靶
AKFT	鞂
AKFD	鞅
AKFF	鞋
PVAF	鞌
AKFV	鞍
AWYF	鞏
AKFQ	鞔
WHTF	鞗
AKFA	鞚
AKFB	鞟
AKFU	鞡
AKFS	鞣
AKFO	鞦
AKFR	鞭
AKFL	鞰
AKFH	鞴
TEWF	鞶
GKMF	鞷
AKFM	鞼
AKFG	韁
AKFP	韆
NKAH	韋
NKAY	韌
NKAS	韎
UDNH	韏
NKAK	韐
IGQH	韑
FJFH	韓
JGHH	韙
NKAF	韚
NKAE	韜
NKAL	韞
NKAN	韢
NKAJ	韣
NKAM	韥
FNHY	韨
HDHG	韭
AHDG	韮
FHDY	韯
HQCG	韰
WWGY	韱
UJGH	韴
UJBM	韷
UJTH	韸
UJRG	韹
UJAD	韺
UJTP	韼
WYNJ	韽
XTYJ	響
UJAC	頀
XDMY	頃
VDMY	頄
ADMY	項
KDMY	順
FDMY	頇
EDMY	須
HDMY	頉
GDMY	頊
DBDM	頋
WCDM	頌
FCDM	頍
RDMY	頎
YWDM	頏
CNHM	預
FQDM	頑
WVDM	頒
HKDM	頕
UGDM	頖
GHDM	頙
CFDM	頚
DIDM	頛
WGKM	頜
YWRM	頝
PVDM	頞
TKDM	頟
QDBM	頠
FKDM	頡
TDDM	頢
AHKM	頤
HAHM	頥
YNTM	頦
NDMY	頨
UADM	頩
QIDM	頫
GUDM	頬
GKUM	頭
QADM	頯
DWWM	頰
EFDM	頱
TFPM	頲
FODM	頳
XFIM	頴
VTKM	頵
TFKM	頶
TBDM	頺
TWDM	頽
EDMX	頾
EHXM	頿
WYDM	顀
OODM	顃
BIBM	顄
YNEM	顅
YWWM	顇
XXIM	顈
QDMY	顉
LNDM	顋
PTKM	額
KKFM	顎
PLDM	顐
DGKM	顑
JMHM	顒
MDMM	顓
UTEM	顔
JOGM	顕
TLRM	顖
MGKM	顗
DRIM	願
CCCM	顙
XHNM	顚
AMFM	顜
MEDM	顝
NWEM	顟
SFIM	顠
UEDM	顡
AMHM	顢
DHGM	顣
FFFM	顤
JYKM	顥
WYOM	顦
DMDJ	顨
HDGM	顪
ALPM	顭
HHDF	顰
HALM	顱
OOYM	顲
BBBM	顳
AKKM	顴
FDMM	颥
WTJI	風
WTJE	颩
GHWJ	颪
WTJT	颬
WTJN	颮
WTJY	颰
WTJK	颱
WTJJ	颲
WTJD	颳
WTJW	颶
WTJO	颷
ERMJ	颻
WTJC	颼
COWJ	颿
WTJL	飀
NRWJ	飁
SFIJ	飄
DYDJ	飆
OOOJ	飊
WRNR	飏
WRHK	飐
WRLN	飔
ERMR	飖
WRQL	飗
WROO	飚
NUTH	飛
TOLH	飜
WYVE	食
UWYE	飡
WYWN	飢
WYSH	飣
WYTA	飥
WYFH	飦
QWYE	飧
WYGN	飩
WYTF	飪
WYTD	飫
UDYE	飬
WYTE	飭
WYVW	飮
WYRC	飯
WYYH	飰
WYYG	飳
WYCK	飴
WYEG	飷
WYQB	飹
HXWE	飺
WYQN	飽
WYTH	飾
WYBM	飿
WYAR	餀
WYYR	餃
WYWK	餄
WYUA	餅
WYQI	餆
WYMK	餇
UQWE	餈
WYTK	餉
UDWE	餋
WYYE	餏
HQCE	餐
WYFB	餑
WYEV	餒
WYGY	餔
WYCT	餕
WYGU	餖
WYGI	餗
WYWS	餘
WYRH	餙
WYRE	餚
WYJX	餛
WYJS	餜
WYAY	餝
WYAA	餞
WYCC	餟
WYQE	餡
WYUK	餢
WYDN	餣
WYDE	餦
WYTV	餧
WYPN	館
WYWW	餩
WYDD	餪
WYPL	餫
WYRG	餭
WYXE	餯
WYTS	餰
WYWD	餱
WYJN	餲
WYJR	餳
WYDA	餴
WYME	餶
WYSG	餷
WYUP	餸
WYOK	餹
WYGF	餺
WYUO	餻
WYRO	餼
WYQL	餾
WYEC	餿
WYEE	饀
WYFL	饁
WYJL	饂
WYAD	饃
WYIF	饄
WYJF	饆
WYAK	饇
WYUF	饈
WYAG	饉
WYAT	饊
WYKM	饋
WYNW	饌
WYFK	饎
NBTE	饏
WYFU	饐
WYXY	饑
WYFQ	饒
WYIS	饓
YXTE	饔
KGNE	饕
WYHY	饖
XTYE	饗
WYFM	饙
WYAL	饚
WYAE	饛
DJEE	饜
WYOD	饝
WYQY	饞
WYLY	饠
WYTM	饡
WYGE	饢
QNSH	饤
QNTA	饦
QNBM	饳
QNWK	饸
QNTK	饹
QNYE	饻
QNGU	饾
QNCT	馂
QNJS	馃
QNSG	馇
QNME	馉
QNFL	馌
QNGF	馎
QNAT	馓
QNGE	馕
VUTH	馗
UTHG	馘
TJWV	馚
TJDY	馛
TJNX	馜
TJNT	馝
TJFB	馞
TJEB	馟
TJWK	馠
TJHD	馡
TJAA	馢
TJDN	馣
TJJN	馤
TJTT	馥
TJUO	馦
TJJL	馧
FNWJ	馨
TJFM	馩
TJPM	馪
TJTJ	馫
COCY	馭
UCOY	馮
COFH	馯
COQY	馰
CODY	馱
COTA	馲
COKH	馴
COAJ	馵
COFC	馶
COGH	馷
CORH	馸
COJG	馹
COBY	馺
COCQ	馻
COYY	馼
COPQ	馾
XFCO	駂
CONW	駃
CONY	駅
COAR	駆
COTY	駇
CORG	駈
COMK	駉
COHC	駊
COVK	駋
QBCO	駌
COGF	駍
COMG	駎
COAN	駏
COYG	駐
VCCO	駑
COQK	駒
CODG	駓
COEG	駔
EKCO	駕
COWC	駖
COWE	駗
COCK	駘
COWF	駙
COMD	駚
CONT	駜
COPX	駝
COTB	駞
COLG	駟
COQB	駠
KKCO	駡
COUA	駢
COQI	駣
COAD	駥
UDCO	駦
COQJ	駨
COWG	駩
COTQ	駪
COIQ	駫
COBG	駬
COYW	駭
COYR	駮
CORI	駯
COLD	駰
COYH	駲
COTP	駳
COAA	駴
COGN	駵
CONK	駶
COGI	駷
COVC	駸
COJF	駻
COWS	駼
COKE	駽
COUQ	駾
COMN	騁
COUF	騂
COCD	騃
COVI	騄
COWY	騅
COWK	騇
COTF	騈
COJX	騉
COQM	騊
COSW	騋
COJS	騍
COAW	騏
COWN	騐
COHD	騑
COJN	騔
COSV	騕
YNMO	騗
COQN	騘
COUJ	騚
CONH	騛
COVP	騝
CODD	騞
COJH	騠
CONC	騢
CORT	騣
COWD	騤
COCS	騥
COLN	騦
COIL	騨
CORC	騩
COEC	騪
PAWO	騫
COTX	騬
BHHO	騭
COQL	騮
EUDO	騰
COED	騱
COCO	騳
COJV	騴
CODI	騵
COQT	騶
COCJ	騷
COYN	騸
COAG	騹
CODR	騻
COOX	騼
CONR	騽
COLI	騾
AJDO	驀
COCE	驂
COSI	驃
COTN	驄
COHG	驉
COAF	驊
COVJ	驌
COOH	驎
CONB	驏
COYT	驐
COGL	驑
COKL	驒
COSF	驔
COTK	驕
COFY	驖
COWW	驗
COLF	驛
COOI	驜
COFS	驝
COPM	驞
COAO	驠
UEGO	驡
COHL	驢
COUO	驣
COYE	驤
COUW	驥
COAY	驩
COGX	驪
CGJG	驲
CGLD	骃
CGCG	骉
CGUF	骍
CGVC	骎
CGPI	骔
CGVJ	骕
CGWD	骙
CGFH	骦
MEVN	骩
MEWY	骪
MEVY	骫
MEGF	骬
MEFH	骭
MEAY	骮
MEWC	骰
MEWJ	骱
MEQN	骲
MEHC	骳
MEHX	骴
MESG	骵
MEQY	骶
MEDG	骷
MEYW	骸
MEYR	骹
MERK	骺
MEDN	骻
METK	骼
MEEV	骽
MEGR	骾
MEUA	骿
MERF	髀
MEJS	髁
MEPK	髂
MEJY	髃
MEYK	髇
MEYY	髈
MEOS	髍
MENE	髎
MELV	髏
MEFQ	髐
MELJ	髑
MEDP	髓
MEPM	髕
MEPY	髖
MEHL	髗
YJFK	髙
YKMV	髛
YKMA	髜
YKME	髝
DCET	髟
DCEW	髠
DCEQ	髡
DCEN	髦
DCEK	髫
DCEG	髬
DCEX	髭
DCEY	髮
DCEF	髯
DCEJ	髴
DCEA	髷
DCES	髹
DCED	髺
DCEI	鬃
DCER	鬄
DCEC	鬆
DCEB	鬈
DCEE	鬍
DCEO	鬏
DCEP	鬔
DCEM	鬚
HGGH	鬥
HGGF	鬦
HGGW	鬨
HGGQ	鬩
HGGT	鬫
HGGR	鬬
HGGX	鬮
OBXB	鬯
SRRE	鬰
SRME	鬱
GKMH	鬲
HAGH	鬳
GKMY	鬴
FWMH	鬶
GKMT	鬷
GKML	鬸
FWHH	鬹
GKMR	鬺
XOXH	鬻
RQCI	鬼
RQCR	鬿
RQCJ	魀
RQCF	魁
FCRC	魂
RRQC	魄
RQCE	魈
RQCG	魊
RQCW	魌
RQCN	魍
RQCY	魎
TVRC	魏
RQCO	魐
RQCC	魑
OSSC	魔
FNAC	魗
DJEC	魘
ILRC	魙
QOVT	魛
QOWY	魜
QOJH	魝
QOAG	魟
QOTA	魠
QOQY	魡
QONN	魢
QOCH	魣
QOWX	魤
QOBY	魥
QOIT	魦
QOYW	魧
QOGN	魨
QOQR	魩
QOWJ	魪
QORC	魬
QOFQ	魭
QOXX	魮
QOJF	魯
QOYY	魰
QOGG	魱
QOYN	魲
QOGH	魳
QOYT	魴
QOWV	魵
QOMW	魶
QODY	魷
QOTN	魸
QOSK	魺
QOLH	魻
QOFC	魼
QODG	魾
QOPX	鮀
QOLW	鮂
QOXJ	鮄
QONT	鮅
HXQO	鮆
QOFI	鮇
QOQK	鮈
QOMG	鮋
QOYX	鮌
QOHC	鮍
QOHK	鮎
QOTG	鮏
QOCK	鮐
QOWF	鮒
QOTF	鮓
QOAN	鮔
QOTU	鮗
QONG	鮙
QOFK	鮚
QOHI	鮛
QORK	鮜
UDQO	鮝
QODJ	鮞
QOPV	鮟
QOQB	鮠
QOQI	鮡
QORI	鮢
QOTK	鮥
QOUA	鮩
QODE	鮪
QOYR	鮫
QODN	鮬
QOFF	鮭
QOUG	鮮
QOWK	鮯
QOLK	鮰
QOFX	鮱
QOFN	鮳
QOUQ	鮵
QOUT	鮷
QOQQ	鮸
QOIE	鮹
UGQO	鮺
QOCT	鮻
QOVC	鮼
QOEV	鮾
QOBN	鮿
QOTI	鯀
QOGR	鯁
QOSG	鯂
QOGY	鯄
QOTP	鯅
QOPQ	鯇
IITO	鯊
QOYK	鯍
QOTJ	鯏
QOFH	鯐
QORH	鯑
QOVL	鯔
QOGE	鯖
UFWO	鯗
QOTV	鯘
QOYB	鯙
QOTB	鯚
QOMK	鯛
QOUV	鯜
QOLD	鯝
QOGI	鯟
QOSW	鯠
QOHD	鯡
QOEQ	鯢
QOJR	鯣
QOJX	鯤
QOJJ	鯧
QOWA	鯩
QOFT	鯪
QOBC	鯫
QOBL	鯭
QOPI	鯮
QORJ	鯯
QOWN	鯰
QOHW	鯱
QOYU	鯲
QONJ	鯴
QOCE	鯵
QOPL	鯶
QOWD	鯸
QOJG	鯹
QOGJ	鯻
QORT	鯼
QOVB	鯽
QOWR	鯾
QOYA	鯿
QOEC	鰀
QOMJ	鰂
QOLE	鰃
QOJY	鰅
QOCS	鰇
QOAS	鰈
QORG	鰉
QOAV	鰋
QOTO	鰍
QOVP	鰎
QOGL	鰏
QOKN	鰐
QOTT	鰒
QOLN	鰓
QONC	鰕
QOPF	鰘
QOAK	鰙
QOPG	鰚
QOJL	鰛
QOWO	鰞
QOCJ	鰠
QOQL	鰡
QOCO	鰢
QOWH	鰤
QOUX	鰦
QOJN	鰨
QOEM	鰩
QOFL	鰪
QOPK	鰫
QOHY	鰬
QOFJ	鰭
QOLL	鰮
QOXU	鰯
QOPH	鰰
QOLP	鰱
QOAE	鰳
QOMT	鰴
TXTO	鰵
QOWI	鰶
QOWS	鰷
QOAF	鰹
QOJC	鰻
QONR	鰼
QOSI	鰾
QOGM	鰿
VCAO	鱀
QOGP	鱁
QONF	鱂
QOOI	鱇
QOFV	鱈
UMIO	鱉
QOHG	鱋
QOQE	鱌
QOWC	鱍
QOSF	鱏
QOVJ	鱐
QOUF	鱒
QOKL	鱓
QOUK	鱔
QOTL	鱕
QODW	鱖
QOOH	鱗
QOVF	鱘
QOUJ	鱛
QOXB	鱜
QOFM	鱝
ERRO	鱟
QOMD	鱡
QOKS	鱢
QOYG	鱣
QOXG	鱦
QOMU	鱧
QOIJ	鱨
QOET	鱫
QOYJ	鱭
QOEW	鱮
QOLJ	鱰
QOVN	鱲
QORS	鱳
QOAY	鱴
QOUE	鱶
QOGK	鱷
QOHL	鱸
QOGX	鱺
QOQO	鱻
QGVT	鱽
QGNN	鱾
QGGN	鲀
QGCN	鲃
QGSK	鲄
QGGF	鲆
QGHK	鲇
QGMG	鲉
QGTF	鲊
QGRG	鲌
QGHC	鲏
QGMK	鲖
QGRK	鲘
QGWC	鲙
UGQG	鲝
QGVK	鲪
QGCH	鲬
QGAW	鲯
QGLD	鲴
QGCE	鲹
QGNJ	鲺
QGFM	鲼
QGGL	鲾
QGIC	鲿
QGJH	鳀
QGLE	鳂
QGRI	鳈
QGYA	鳊
QGCJ	鳋
QGUO	鳒
TXTG	鳘
QGOH	鳙
QGNF	鳚
QGNR	鳛
QGAC	鳠
QGDN	鳡
QGYG	鳣
QGTN	鳤
WVGO	鳥
WVGN	鳦
WVGW	鳧
VWVO	鳩
CWVO	鳮
WWVO	鳯
TYWO	鳰
FWVO	鳱
NFWO	鳵
AYWO	鳶
FCWO	鳷
YNWO	鳸
WYNO	鳹
FWWO	鳺
WVWO	鳻
YWVO	鳼
GAWO	鳽
GMHO	鳾
GWVO	鳿
DHWO	鴀
NWWO	鴂
AQWO	鴄
MYWO	鴅
PQWO	鴆
XFWO	鴇
DWWO	鴈
GHWO	鴊
GDWO	鴌
ARWO	鴎
EKWO	鴐
VCWO	鴑
WYCO	鴒
NTWO	鴓
TPWO	鴔
WVGX	鴕
NNAO	鴖
UWVO	鴗
CAWO	鴘
WVGK	鴚
QBWO	鴛
HXWO	鴜
QKWO	鴝
KGNO	鴞
QAYO	鴟
JGWO	鴠
EGWO	鴡
XEWO	鴢
DWVO	鴣
WVGU	鴤
MDWO	鴦
LWVO	鴨
RWWO	鴩
IPWO	鴬
WNNO	鴭
DFNO	鴮
DMJO	鴯
TDWO	鴰
XJWO	鴲
PVWO	鴳
TGSO	鴴
QIWO	鴵
FKWO	鴶
RIWO	鴸
UGWO	鴹
GXWO	鴺
IAWO	鴻
VKWO	鴽
CTGO	鴾
WGKO	鴿
WTFO	鵀
YWRO	鵁
WSWO	鵂
TEWO	鵃
GCFO	鵄
TKWO	鵅
TWVS	鵆
RHFO	鵇
YOWO	鵉
NNWO	鵋
PFQO	鵍
EVWO	鵎
GEHO	鵏
AWWO	鵐
KEWO	鵑
WWKO	鵒
FPBO	鵓
WVGT	鵔
CWTO	鵕
RDMO	鵗
GVAO	鵛
UXHO	鵜
TRXO	鵝
TFKO	鵠
FHNO	鵡
GKIO	鵣
UGJO	鵥
WVGI	鵦
UAWO	鵧
WGDO	鵨
EBCO	鵩
DJNO	鵪
HJFO	鵫
EEWO	鵬
QWVO	鵭
QEWO	鵮
RTFO	鵯
MFKO	鵰
YNEO	鵳
QKQO	鵵
GFGO	鵶
PQBO	鵷
DSKO	鵸
YWTO	鵺
PWAO	鵼
CCCO	鵽
JXXO	鵾
WVGA	鵿
EQWO	鶂
WVGQ	鶃
GEWO	鶄
VLWO	鶅
GJIO	鶇
GVHO	鶈
OVWO	鶊
NDWO	鶋
NBMO	鶌
JQRO	鶍
PFIO	鶎
EFWO	鶏
SYPO	鶐
OOWO	鶑
ALWO	鶓
UJWO	鶕
TOWO	鶖
JGHO	鶗
DEWO	鶘
YUPO	鶙
KKFO	鶚
XXRO	鶛
ACNO	鶜
GKLO	鶝
RFHO	鶞
PWDO	鶟
AJVO	鶠
JQWO	鶡
EGDO	鶢
PLWO	鶤
NHWO	鶥
AMDO	鶧
XGEO	鶨
CNHO	鶩
HDYO	鶪
GLIO	鶫
WYVO	鶬
XYWO	鶭
YKMO	鶮
KMWO	鶰
WCNO	鶲
PWYO	鶴
QBTO	鶵
OVHO	鶶
PDHO	鶷
XUXO	鶸
QYVO	鶹
IWEO	鶺
MEWO	鶻
UVOO	鶼
WYFO	鶽
FJFO	鶾
UXXO	鶿
UWLO	鷁
ERMO	鷂
JPVO	鷃
EXDO	鷄
SSWO	鷅
XHNO	鷆
FPDC	鷇
RHAO	鷉
GKMO	鷊
AWGO	鷋
THSO	鷍
RDFO	鷎
JDFO	鷐
TUWO	鷑
GJHO	鷒
OAOO	鷓
ATDO	鷖
AKKO	鷗
FUFO	鷙
NWEO	鷚
OVEO	鷛
LVWO	鷜
JAFO	鷝
DRRO	鷞
YTTO	鷟
DUBO	鷢
SJFO	鷣
KKLO	鷤
XXIO	鷥
WYOO	鷦
FPGO	鷧
AGAO	鷨
HHPO	鷪
VFJO	鷫
AMWO	鷬
TOLO	鷭
TDKO	鷮
DUJO	鷯
THIO	鷱
YKIO	鷲
UEWO	鷳
USWO	鷴
NFTO	鷵
LMWO	鷶
USGO	鷷
OWWO	鷹
KHTO	鷺
UJNO	鷾
LQJO	鸀
IEXO	鸂
RYTO	鸄
LFUO	鸅
HAKO	鸆
YLKO	鸇
SJGO	鸉
PNLO	鸋
WVGC	鸌
GWMO	鸍
MMWO	鸎
APFO	鸏
QTYO	鸑
LLLO	鸓
HALO	鸕
FSHO	鸘
MMVO	鸚
HHWO	鸜
GMYO	鸝
YXXO	鸞
NQYG	鸤
WBQG	鸧
KGNG	鸮
WYCG	鸰
IPQG	鸴
TGSG	鸻
TEQG	鸼
ALQG	鹋
JXXG	鹍
QEQG	鹐
OVWG	鹒
PQBG	鹓
VIJG	鹔
JQWG	鹖
TOQG	鹙
NHQG	鹛
GKMG	鹝
WCNG	鹟
QYVG	鹠
UWLG	鹢
LGKG	鹮
QYNC	鹱
APFG	鹲
FSHG	鹴
HLOU	鹵
HLON	鹶
HLOC	鹷
HLOY	鹹
HLOA	鹺
HLOO	鹻
HLOW	鹼
AHNL	鹽
ONJX	鹿
ONJW	麂
WVOX	麄
ONJN	麅
ONJG	麈
FFOX	麉
ONJO	麋
ONJD	麌
ONJK	麍
ONJE	麎
SSOX	麓
ONJI	麖
ONJJ	麘
ONJY	麙
ONJC	麚
ONJS	麜
SWWQ	麥
SWWT	麨
SWWW	麩
SWWC	麬
SWWA	麯
SWWO	麴
SWWD	麵
SWWU	麷
GQQO	麹
GQDD	麺
OSSX	麼
OSSN	麾
OSSK	麿
OSSM	黂
AGMW	黃
AMWN	黅
AMWQ	黆
AMWK	黇
ERRW	黌
TWIU	黍
TWIK	黏
TWIC	黐
JFOU	黒
LFON	黔
LFOY	默
JFDO	黙
WAYO	黛
LFOE	黝
LFOK	點
LFOQ	黟
DDYO	黡
LFOT	黢
LFOX	黣
LFOI	黥
LFOB	黦
TQTO	黧
LFOA	黭
LFOJ	黯
LFOW	黰
DJEO	黶
LFOM	黷
LFOL	黸
OGUV	黺
OGUY	黻
XHNG	黽
FQXF	黿
FWXF	鼀
FCXF	鼁
JGXF	鼂
FFXF	鼃
RIXF	鼄
TDKX	鼅
PJYX	鼆
GQTX	鼇
KKLX	鼉
NKUX	鼊
JGKN	鼌
HNDN	鼎
BHNN	鼐
HHNN	鼑
FTHN	鼒
FKUC	鼓
FKUU	鼕
FAFC	鼖
QIFC	鼗
FKUF	鼙
IJGC	鼝
ENUN	鼠
ENUY	鼣
ENUX	鼧
ENUU	鼨
ENUG	鼪
ENUM	鼬
ENUF	鼭
ENUP	鼮
ENUK	鼯
ENUE	鼱
ENUL	鼲
ENUV	鼴
ENUW	鼶
ENUD	鼷
ENUO	鼸
THLJ	鼻
THLH	鼼
THLV	鼽
THLF	鼾
THLQ	鼿
THLY	齀
THLK	齁
THLI	齂
THLN	齃
THLG	齄
THLC	齆
THLE	齈
YUHO	齌
YUHL	齍
YUHM	齎
YUHG	齏
HBNN	齓
HBXN	齔
HBTN	齕
HBAT	齖
HBRH	齗
HBWJ	齘
HBQN	齙
HBTF	齚
HBAN	齛
HBHX	齜
HBCK	齝
HBKW	齞
HBEG	齟
HBVK	齠
HBWC	齡
HOBC	齢
HBQK	齣
UDHB	齤
HBJX	齥
HBVE	齦
DHVB	齧
HBYR	齩
HBKH	齪
HBLS	齫
HBGK	齬
HBRR	齭
HBDK	齮
HBEQ	齯
HBAJ	齰
HBBC	齱
HBTY	齲
HBPL	齳
HBUE	齴
HBJY	齵
HBKN	齶
HBNF	齷
HBUL	齸
UGAB	齹
HBQT	齺
HBFW	齻
HBSH	齼
HBSI	齽
HAGB	齾
HWBN	龁
HWBR	龂
UEGD	龍
UEGA	龏
OUED	龐
UEGI	龒
DEUD	龓
UEGW	龔
WGKD	龕
FKKD	龗
TTXG	龝
WGKI	龣
AAAB	㐂
RVNV	㐆
VCNB	㐐
VKNB	㐒
SKNB	㐓
YKNB	㐔
FKNN	㐖
GKNB	㐚
GIYV	㐜
RQKN	㐝
IEBN	㐢
OLNV	㐣
QEGN	㐥
YNHT	㐧
GBWI	㐪
YRBJ	㐫
YCKB	㐬
YLKF	㐭
YWAE	㐮
WGQN	㐳
WCGG	㐷
WQWY	㐸
WRNN	㐹
WWRY	㐽
WFQN	㐾
WBMH	㑁
WGMW	㑂
WXET	㑃
WKQN	㑆
WYOY	㑊
WMAG	㑋
WAGG	㑌
WDIY	㑍
WPFY	㑏
WCDC	㑓
WDMY	㑔
WMQY	㑕
WTMT	㑗
WBNN	㑙
WRRH	㑜
WOAH	㑞
WRGW	㑟
WJCF	㑠
WVCB	㑡
WFCB	㑢
WALG	㑤
WJQR	㑥
WTBG	㑧
WKTD	㑨
WLQY	㑩
WLGJ	㑭
WCNS	㑱
WFMF	㑲
WUTD	㑵
WRNO	㑶
WCEX	㑷
WWYB	㑺
WPNM	㑻
WLTK	㑼
WIPF	㑽
WQYG	㑾
WVJS	㑿
WLFF	㒁
WAFY	㒃
WQDO	㒄
WRLO	㒇
WNBT	㒈
WIPS	㒉
WVYH	㒊
WADR	㒋
WOOW	㒌
WCCI	㒍
WPAU	㒏
WOGI	㒒
WFUP	㒓
WLQJ	㒔
WAJY	㒖
WAHU	㒘
WEAN	㒚
WNWY	㒛
WEGW	㒜
WALY	㒝
WMWM	㒞
WHQG	㒠
WERI	㒡
WBBB	㒤
WMDU	㒥
WLLF	㒦
WETN	㒨
WAHE	㒪
GHFQ	㒫
FQGD	㒬
KQKQ	㒭
FQGE	㒮
TYQU	㒱
MHTY	㒳
TYBM	㒴
MUWN	㒺
JHQB	㒻
AMHY	㒼
JUDB	㒽
JYRY	㒿
PYTA	㓃
CCCQ	㓄
UWXN	㓆
UWGG	㓌
UYCQ	㓍
UVPC	㓎
UMWK	㓏
UFWF	㓐
UFUF	㓑
UFMF	㓓
UJAF	㓖
UDHI	㓗
FJJH	㓝
DHVT	㓞
HCJH	㓟
HKJH	㓠
RMJH	㓡
TKJH	㓢
FKJH	㓤
IVJH	㓥
DJJH	㓦
YVCV	㓪
UDVJ	㓬
JQWJ	㓭
MFKJ	㓮
VLJH	㓯
YNMJ	㓲
JGHJ	㓳
THSJ	㓷
NNGJ	㓸
DOOJ	㓹
HAYJ	㓺
LGHJ	㓻
SWIJ	㓼
MPFJ	㓽
TWIJ	㓿
JYKJ	㔀
XQCV	㔃
SOJH	㔄
VFJJ	㔅
WXWJ	㔇
AHDJ	㔈
NTKJ	㔉
YLKJ	㔊
BCIJ	㔌
BTWV	㔎
DDDJ	㔏
TGHJ	㔐
AWNV	㔑
MWYJ	㔒
TFET	㔓
EKKF	㔔
RNET	㔕
XJET	㔗
BMET	㔘
UAET	㔙
TDET	㔚
FKER	㔛
EBET	㔜
GMHE	㔝
TGVE	㔟
JQWE	㔠
XQCE	㔢
LLLE	㔣
PTOE	㔤
LCEE	㔥
UGWE	㔦
QUXE	㔨
XJFJ	㔬
AWKD	㔯
AEWI	㔱
ANNW	㔵
AUJM	㔶
ARHW	㔸
HLKF	㔽
GNHK	㔿
DGAK	㕃
DGXI	㕄
DYEI	㕈
DWYD	㕍
DFKF	㕑
UGQC	㕗
CWTY	㕙
CYYI	㕚
KHCU	㕜
NMHC	㕞
KWYY	㕨
KDHH	㕩
KPQN	㕪
KTDY	㕭
KWRY	㕮
KRBH	㕳
KPWN	㕴
YDHK	㕻
IKXB	㕾
KVGH	㖀
KRDC	㖁
KJXT	㖂
KRGK	㖃
KYTH	㖄
KMAG	㖆
KWHG	㖉
KVFY	㖊
WJKX	㖋
UFKX	㖍
KXWJ	㖎
KKVT	㖐
KUXT	㖒
KTDH	㖓
KGDK	㖔
UFKF	㖖
KMWN	㖗
KDFE	㖘
EKKX	㖙
WFKX	㖚
DKXB	㖛
YKKX	㖜
FIKX	㖝
KEPC	㖟
KDFI	㖠
KOHX	㖢
KUKG	㖣
KBIB	㖤
KLTY	㖥
KGJI	㖦
KQAJ	㖧
KVIY	㖨
KBCY	㖩
KAKG	㖪
KFWT	㖫
KECY	㖬
KGDN	㖭
MGKX	㖯
KXMK	㖰
VKKX	㖲
IVKX	㖳
KAQR	㖴
KSFG	㖶
KJGH	㖷
KWVL	㖹
KDWJ	㖺
KCNS	㖻
KAFS	㖼
KKUT	㖾
KBBH	㖿
KMXX	㗀
KITH	㗂
KNNJ	㗃
KNHC	㗇
KCEE	㗈
KQDD	㗋
KPGF	㗌
KTJG	㗍
KEKS	㗎
KDYL	㗐
KWNP	㗓
KAMF	㗕
KEEG	㗖
KERF	㗗
KGEF	㗘
KQBT	㗙
KTTD	㗛
KYXL	㗜
KUGO	㗝
KDHC	㗞
VCKX	㗠
KTGE	㗢
KAQH	㗣
KBQB	㗦
KNRG	㗩
KHXI	㗪
KWFI	㗫
IPKQ	㗬
KTON	㗭
QKOW	㗮
FTJX	㗯
KTWH	㗰
KWYS	㗱
KVFG	㗲
KTWK	㗳
KUEG	㗴
KOOW	㗵
KWXC	㗶
KPAM	㗷
KTRS	㗸
KGDD	㗺
KMNP	㗻
KOGI	㗼
KUSK	㗿
KEOY	㘀
KUXN	㘂
KSLY	㘄
KTQS	㘅
KOOS	㘇
KXTH	㘈
KTVB	㘉
KFYG	㘊
KAHM	㘋
KIWA	㘍
UTHX	㘏
KCOR	㘐
KFFI	㘑
TTGX	㘒
KUGI	㘓
KAAL	㘕
KUTM	㘖
YXXK	㘘
KKKT	㘙
KWGD	㘛
LNTE	㘠
LKED	㘣
LIJG	㘤
LERI	㘥
FXXN	㘩
FQCY	㘬
FTET	㘯
FNVN	㘲
UXFF	㘳
FDMH	㘵
FARY	㘷
FWAY	㘺
FLDY	㘻
FFTN	㘼
FFXY	㘽
FPGF	㘾
FTXY	㙁
FUKQ	㙂
FRGW	㙃
FXXF	㙄
FKSY	㙅
FMAW	㙉
FDEY	㙊
FADW	㙋
FVIJ	㙌
FCCC	㙍
FTJT	㙏
FMDJ	㙐
TKMF	㙑
LCNF	㙒
FNKH	㙔
FTKY	㙖
FLGE	㙗
FSVG	㙘
IDNF	㙙
YKMF	㙜
FTHS	㙞
ATDF	㙠
FAMY	㙢
FXDE	㙣
FGJL	㙧
FXXY	㙨
FDUI	㙩
FWYS	㙫
FDUW	㙭
FTWK	㙮
FWFC	㙯
KGNF	㙱
FYXY	㙲
FDGN	㙳
FQDY	㙴
FYKF	㙵
FJXO	㙷
FWOW	㙸
FALQ	㙹
FAKM	㙺
FOJF	㙻
FDDJ	㙽
FERB	㙾
FHAA	㚀
FGKE	㚂
FPRU	㚃
RBWT	㚇
BQQU	㚉
QQMK	㚋
QQJS	㚌
QQKM	㚍
DTYY	㚒
FWFW	㚘
EKDU	㚙
DQKF	㚚
DXJF	㚛
DSSU	㚞
QKXD	㚟
DUGO	㚠
DSKK	㚡
VGJH	㚦
VNFH	㚨
VTFN	㚪
VBYY	㚫
VQUG	㚬
VPWN	㚮
VWRY	㚯
VDHG	㚰
VHKG	㚲
VEKG	㚳
VDMH	㚴
VTUY	㚵
VWIY	㚷
VNGK	㚸
VQTB	㚹
AGNV	㚽
VKQN	㚾
VQNN	㚿
VQVG	㛀
VGUF	㛁
VRCN	㛂
DHVV	㛃
VYEY	㛄
VBSY	㛆
VOFG	㛇
VFTN	㛈
VWSY	㛊
VWNY	㛋
VCTG	㛌
VDWW	㛍
VKKG	㛎
VGIY	㛏
VGJR	㛐
HQCV	㛑
VGKU	㛒
VRDH	㛓
VTDH	㛔
VKCN	㛕
VCWT	㛖
VWWF	㛗
VFPB	㛘
VUFH	㛙
VCEH	㛚
VTMT	㛛
WHTV	㛜
VQMD	㛟
VUJG	㛠
VPFQ	㛡
VTBT	㛢
VKMY	㛣
VSSY	㛦
VMDG	㛧
VUFQ	㛨
VYCE	㛩
VDJN	㛪
VJQR	㛫
VFWF	㛬
VAJG	㛭
VPOC	㛮
VQKE	㛯
VNNJ	㛰
VVTR	㛴
VEMF	㛵
VMDO	㛶
TDNV	㛷
VFKU	㛸
VWGR	㛹
VPOY	㛽
VGKH	㛿
VSHG	㜀
VSJG	㜁
FFFV	㜂
VWTJ	㜄
VYXL	㜅
VVKC	㜉
VNAE	㜊
VUWL	㜋
VOVK	㜍
VEXD	㜎
VMGU	㜐
IGEV	㜑
VEAH	㜒
VAWK	㜓
VLPY	㜕
VGMJ	㜖
VHAG	㜘
VONX	㜙
VPWJ	㜚
VLQW	㜛
VGQT	㜜
LRVF	㜞
VNBT	㜟
VTWH	㜡
VLVG	㜢
VQDO	㜣
VSJF	㜤
VLMY	㜥
VVAF	㜦
VDUW	㜧
VNIG	㜨
VTMD	㜩
VQDY	㜬
VIPL	㜭
VAHL	㜮
VAHO	㜯
VRXS	㜰
VRRM	㜱
VYLE	㜳
VALH	㜴
XGWV	㜷
VHHY	㜹
VTFM	㜺
VYXN	㜻
VCCG	㜼
BWJH	㜾
BCNH	㜿
QJBF	㝁
BRRH	㝂
BQKQ	㝃
BFKK	㝆
PQYU	㝌
PGNG	㝍
PWCU	㝐
PNCU	㝕
PQQU	㝖
PYVE	㝗
PGGW	㝙
PTHP	㝚
PGFG	㝞
PGHQ	㝟
PTKY	㝢
PDHD	㝣
PAMF	㝤
PNHO	㝥
PWYB	㝦
PFKE	㝨
POVI	㝩
PFUY	㝪
PBTG	㝫
PDHW	㝬
PNJG	㝭
PBMC	㝮
PTDK	㝯
PTHY	㝰
PNHQ	㝱
PNHH	㝲
JGFU	㝵
LQFU	㝶
VAVF	㝷
IRQB	㝸
ITQY	㝹
UVOT	㝺
AKGT	㝻
DNGF	㝼
DNII	㝽
DNDA	㝾
DNJX	㞁
DNEV	㞂
WWKY	㞃
DNDK	㞆
DNYA	㞈
DNUA	㞉
NVYI	㞍
NTPI	㞏
NFFN	㞑
NTHD	㞒
NXJD	㞓
NQQI	㞔
NWED	㞕
NGMI	㞖
NGIY	㞗
NTFI	㞙
NTFE	㞚
NTXJ	㞛
NTTV	㞜
NUSD	㞟
NAAE	㞡
BHGD	㞢
BHWV	㞣
MWYU	㞩
MQYU	㞮
MKHH	㞲
MQAN	㞴
BHGF	㞷
MSKG	㞹
MTDU	㞺
MKGN	㞻
BIMJ	㞼
MNXN	㞾
MFRU	㞿
MDFH	㟁
MUGH	㟄
MRBQ	㟅
MWXF	㟆
MWWF	㟇
MPTG	㟉
MEBG	㟊
MUKQ	㟋
MEVG	㟎
MFPB	㟑
MRDH	㟓
MKUF	㟕
MGAJ	㟖
MWVV	㟗
MAJG	㟙
SFCM	㟚
MRAF	㟛
MXQI	㟜
MAWB	㟟
MUDB	㟡
MVIU	㟤
MCDE	㟥
MPLJ	㟦
MMDJ	㟨
NNAM	㟩
MRIY	㟫
MPTK	㟯
MPJW	㟰
MUGO	㟱
MDRI	㟲
MLGH	㟵
MAWK	㟷
MRDF	㟸
MBQB	㟹
MLVF	㟺
LRMJ	㟻
MGQT	㟼
MSFI	㟽
MOVH	㟾
MYUD	㠃
MNRF	㠄
MTTT	㠅
MKKL	㠆
MYKY	㠇
MUGG	㠈
MHAG	㠊
MADW	㠌
MWYS	㠍
MSFJ	㠒
MAPE	㠓
MNKF	㠔
MBTC	㠕
MTMD	㠗
MYKE	㠙
MOGF	㠚
MAWC	㠛
MFWM	㠝
TMGM	㠞
MHAL	㠠
MYCE	㠡
MRQE	㠢
MLLF	㠥
MMDU	㠦
MOSD	㠧
MSRF	㠨
WNKB	㠩
UOGA	㠮
HNND	㠯
MHXN	㠲
MHVY	㠴
MHTW	㠶
MHBY	㠷
MHFW	㠸
MHWJ	㠹
MHIT	㠺
MHRH	㠼
MHTU	㠽
HXMH	㠿
UMII	㡀
MHDN	㡁
MHQJ	㡄
MHQQ	㡅
MHBN	㡇
MHXX	㡉
MHQE	㡊
MHJE	㡌
MHUJ	㡐
TOMH	㡑
MHPL	㡓
MHUO	㡘
MHTX	㡙
MHAF	㡚
MHAK	㡛
MHWI	㡜
MHTP	㡝
MHLV	㡞
MHGJ	㡟
MHWU	㡠
MHDF	㡡
YUPD	㡣
MHOI	㡤
MHEN	㡥
MHPM	㡦
MHET	㡪
XJQN	㡫
XXAQ	㡬
XXGN	㡭
XXDN	㡮
OTAV	㡯
OQYI	㡱
OQAV	㡳
OKWI	㡶
OEGD	㡹
OJGD	㡺
OQTB	㡻
OJXE	㡼
OVGK	㡽
OVEI	㡾
OUBT	㡿
OGMI	㢀
OQQI	㢁
OGKU	㢄
OJFD	㢆
OWYD	㢈
OTTA	㢉
ODSK	㢊
OWQQ	㢋
OBSK	㢌
OTFE	㢎
OHAG	㢒
OXTY	㢕
OAKE	㢙
OHAE	㢚
OWGW	㢛
OALN	㢜
OQOT	㢝
ONLW	㢞
IMKA	㢢
FQNY	㢤
SKSY	㢦
XNNA	㢯
XCIY	㢱
XXGW	㢲
XTEY	㢳
XLRY	㢴
XMQY	㢷
XUVG	㢺
XUMI	㢼
XBXN	㢽
XGKH	㣂
XYCX	㣃
XIAS	㣄
XAQJ	㣅
XGRH	㣇
FJYE	㣋
HKET	㣌
CKET	㣍
RIER	㣎
DJFE	㣏
RIET	㣐
OVEE	㣑
ULJE	㣒
TQKG	㣘
TADT	㣝
TWCQ	㣞
THTU	㣠
TAAY	㣤
TSSY	㣩
TEGC	㣪
TKBG	㣬
TFMF	㣮
TNIE	㣯
TTON	㣰
TRLO	㣳
TFUP	㣵
TPNS	㣷
TOGG	㣸
TOWN	㣹
NVYY	㣼
NCYY	㣾
NQYY	㣿
BYNU	㤂
AQNU	㤅
NRCY	㤆
NAHT	㤉
NRRY	㤊
NAFG	㤌
EKNU	㤎
NTUY	㤏
HKNU	㤐
NDKG	㤑
NDFH	㤒
NSGG	㤓
NWFY	㤔
NBMH	㤕
NPSH	㤖
MNGN	㤙
NTGS	㤚
NWTF	㤛
NYCQ	㤝
NPTA	㤞
MANU	㤟
GQJN	㤠
NGQJ	㤡
NDEG	㤢
NJRY	㤤
NYNW	㤥
NGKR	㤦
GQBN	㤪
DENU	㤫
NFFG	㤬
NTDJ	㤭
NMWK	㤯
WTHN	㤰
NGKU	㤱
NDHK	㤳
NBNN	㤴
BTNU	㤵
NFOY	㤸
QYTN	㤻
NFCE	㤼
NDTF	㤽
NPWS	㤾
NDJN	㤿
NFHG	㥀
NJGF	㥂
NFWT	㥄
NEPC	㥅
NVIY	㥆
MHHN	㥈
NUKG	㥉
NQOY	㥌
TQTN	㥎
NMAW	㥏
NESY	㥒
NDSK	㥓
NJYY	㥗
NKHN	㥙
NEWY	㥚
NBKG	㥛
NLEG	㥜
NXBG	㥝
NUEY	㥞
NXGE	㥟
NNHE	㥠
NNXS	㥡
NUSG	㥢
DFFN	㥣
NJMY	㥥
NOVG	㥪
NYKJ	㥫
NYUY	㥬
NDWI	㥭
EAVN	㥯
NEHC	㥰
NAHD	㥱
NDRI	㥳
NRHW	㥴
NNAN	㥸
OWVN	㥹
NFCL	㥺
DTXN	㥻
NGHO	㥼
NGMY	㥽
GQTN	㥿
NTDP	㦀
LPNU	㦁
IPKN	㦂
NAQH	㦅
NHAF	㦆
NONX	㦇
NUGL	㦈
NAGF	㦊
NDFJ	㦋
NKKT	㦍
NVFG	㦎
NNNW	㦏
NAFY	㦐
NNBT	㦑
NLYG	㦒
NQDO	㦓
JEDN	㦔
NBTG	㦕
NUNY	㦖
NSSI	㦗
RYTN	㦘
NJMN	㦙
UDNF	㦚
EJFN	㦟
NOGF	㦠
NRXS	㦡
NTVB	㦢
TNKN	㦣
NPDN	㦥
NUEQ	㦦
NTFJ	㦧
NUGI	㦨
NBEN	㦩
NYOC	㦪
NTFM	㦫
NLXY	㦬
NFKW	㦭
ACGD	㦯
FQXY	㦲
ATKD	㦴
RIAY	㦵
CEHA	㦷
HJFA	㦸
JGQA	㦹
DFEA	㦺
NRAY	㦻
DWEA	㦼
DEAV	㦽
YNBV	㦾
YNSI	㦿
YNLD	㧂
RNHH	㧃
RMGG	㧇
RGMH	㧊
RAHT	㧎
RDXY	㧔
RQTB	㧕
HXRJ	㧘
RNTT	㧙
JTYR	㧛
RAMH	㧜
EKRJ	㧝
RTDC	㧞
RCIY	㧠
RYNW	㧡
RRIY	㧣
RYCQ	㧤
RTFQ	㧥
RYCK	㧧
RWGH	㧩
RQDB	㧪
ABRJ	㧭
RFTX	㧯
RTNI	㧰
RPSY	㧲
RDHK	㧵
RTMT	㧶
RGDK	㧷
RYKB	㧸
RJGF	㧹
RLDG	㧽
RTGI	㨀
RFHG	㨁
RGJI	㨂
IHCR	㨇
RNNJ	㨉
RDAE	㨊
FPRC	㨌
FFFR	㨍
RDMD	㨎
RMDO	㨏
RWKS	㨐
RRBT	㨑
RBCL	㨕
RGCT	㨖
RHVH	㨗
RITH	㨘
RHAY	㨜
RNIE	㨝
RGXI	㨞
RPJW	㨠
RCEX	㨢
RXMW	㨥
RQYL	㨨
ROTP	㨩
RJIQ	㨪
RJTL	㨫
RFKE	㨬
RYNC	㨭
RRQQ	㨮
RYWE	㨰
RAPS	㨲
RFJN	㨴
RUEV	㨵
RWVO	㨶
RPNM	㨸
RDHV	㨹
LRRJ	㨻
LTKR	㨼
RQEF	㩂
RPAU	㩃
RMLN	㩄
RGJL	㩅
RYKY	㩆
RVFG	㩇
RWGN	㩉
RVFJ	㩋
RXJM	㩌
RJEY	㩎
RLFO	㩏
RTFF	㩐
RGDD	㩑
RSSI	㩒
EAWR	㩓
RNAC	㩔
RFWC	㩕
RMWB	㩗
RPAF	㩙
RAHL	㩜
ROOS	㩞
RPAS	㩟
RALY	㩢
RNPL	㩣
RGET	㩤
RJAI	㩧
RDHN	㩨
RXDM	㩪
RRRM	㩫
RHAA	㩬
RERB	㩭
REGR	㩮
RAKS	㩰
RHHY	㩴
RPAO	㩷
RCCG	㩹
XXFC	㩺
QDBC	㩻
TFAC	㩾
TNTY	㩿
GFTY	㪀
RNHC	㪂
SKHC	㪃
XJTY	㪄
GMWC	㪅
QAYC	㪆
VTKC	㪊
JFHC	㪋
CEHC	㪌
FPBT	㪍
RTFC	㪏
DJNC	㪑
EQHC	㪒
TFUC	㪓
SSHC	㪔
HJFC	㪕
VIHC	㪖
UKHC	㪗
JSTY	㪙
ADWC	㪛
MDMC	㪜
GLIC	㪝
YKJT	㪟
UVOC	㪠
PDHC	㪡
EHCC	㪢
VFJC	㪩
GDHC	㪪
HALC	㪭
FKKC	㪮
YQMD	㪱
FQUF	㪴
DJUF	㪶
LVUF	㪹
DHHF	㪺
SKRH	㪼
GJRJ	㪽
TKRH	㪾
BTBR	㪿
JJRH	㫀
OAOR	㫂
FQYR	㫄
YRKH	㫊
YRHG	㫌
YTSV	㫏
JGQB	㫕
JKQN	㫛
JBHC	㫞
JWKG	㫟
JTUU	㫡
JJNB	㫣
JPVG	㫨
DWHJ	㫪
JGOG	㫫
JQJG	㫬
JJGQ	㫯
JFPB	㫲
JVPH	㫶
JRNR	㫹
JRMJ	㫼
JVIY	㫽
JIMK	㫾
JIWK	㬁
JJMY	㬂
JCKO	㬃
JLYR	㬅
JNNJ	㬆
JQMD	㬇
JWND	㬋
JYJI	㬌
JGEF	㬍
JGOJ	㬐
JPYG	㬕
JYNK	㬖
JYCT	㬚
JWGN	㬛
JULJ	㬝
JMJN	㬞
QRUJ	㬟
JQVO	㬠
JFWC	㬡
JOGF	㬣
JJXO	㬤
JBMO	㬥
JBMI	㬧
JDHN	㬩
ETFH	㬳
EYWR	㬵
ETFK	㬶
ELSY	㬷
EAWX	㬸
EQVH	㬹
EAYK	㬻
EYKT	㬿
ETAW	㭀
SNFH	㭄
BGSU	㭆
SCQN	㭇
STHN	㭊
SDHH	㭋
STGH	㭌
SFNH	㭏
DGSU	㭐
SCAH	㭓
SFFY	㭙
STEY	㭚
SREY	㭛
SADT	㭜
SSVB	㭝
STFQ	㭠
STLR	㭡
SQYG	㭤
SQMY	㭥
SPTA	㭦
SAHB	㭨
SEFY	㭩
SKEJ	㭭
SVGQ	㭮
SBNN	㭯
HXGI	㭰
SALH	㭱
SWWK	㭲
SFTB	㭳
SJCF	㭴
SQLG	㭵
SAYT	㭶
SLET	㭷
SXYX	㭹
SDJN	㭺
SIMK	㭻
SIJG	㭼
SOQY	㭽
SNBM	㭾
SJQB	㭿
SBIB	㮀
SRDE	㮁
HDSU	㮂
STVG	㮃
SFQY	㮄
SWUG	㮆
SDFI	㮈
SDEB	㮋
UEJS	㮍
SDHL	㮎
SITH	㮐
STFE	㮑
SSFG	㮒
SNGG	㮓
STGF	㮔
SDMD	㮕
SAKF	㮖
HLWS	㮚
SJGH	㮛
SANF	㮜
SUQK	㮞
SAPS	㮠
SWND	㮢
VCAS	㮣
SCDL	㮥
SFPI	㮦
SWNO	㮧
SLWT	㮨
SAWS	㮪
SCLF	㮭
SDHR	㮮
STLX	㮰
SQBT	㮲
SEUD	㮳
SEHC	㮴
SYTY	㮵
SUBE	㮶
SDNJ	㮷
SUDP	㮸
SGCT	㮹
SCYJ	㮻
STEC	㮽
YVCS	㮾
SJAF	㮿
SBUK	㯁
SAQH	㯂
SSWI	㯃
SSRC	㯄
SORF	㯅
SUTG	㯆
SHDF	㯇
SGKP	㯈
SHAF	㯉
SGHO	㯊
XSDM	㯋
SYSY	㯎
FNWS	㯏
BDAS	㯐
SEHQ	㯒
SADR	㯕
SFLN	㯖
SUSY	㯗
SYCT	㯙
STWK	㯚
SFPG	㯛
SAYF	㯜
SKHK	㯝
SXKE	㯞
SSVI	㯟
SYXG	㯠
SNNW	㯢
SADS	㯦
SFHK	㯧
SFWC	㯪
SHAE	㯫
SSVP	㯬
SLQJ	㯮
STAM	㯯
SLFH	㯰
SAQT	㯳
SAPK	㯴
SOBT	㯶
SWOW	㯷
SVHL	㯸
AHNS	㯺
SAFL	㯼
SGMP	㯾
SVLN	㯿
STQI	㰀
SDDD	㰁
SPTL	㰂
SRMI	㰃
SMAA	㰄
SYUP	㰅
SSLP	㰈
SFWO	㰊
SHHM	㰋
UEGS	㰍
SMWM	㰎
STYK	㰏
SBDP	㰐
SNNS	㰑
SERB	㰒
SAHM	㰓
SYOC	㰔
SYRY	㰚
SARS	㰛
SFHM	㰜
NNQW	㰝
MQWY	㰞
RNQW	㰟
YWQW	㰠
GAQW	㰢
HXQW	㰣
SKQW	㰤
ANQW	㰥
FCQW	㰦
CKQW	㰧
FFQW	㰪
TFQW	㰫
QJQW	㰬
DFNW	㰭
GKUW	㰯
DWWW	㰰
TFJW	㰱
UKQW	㰴
THKW	㰶
GQXW	㰷
DGKW	㰹
NHFW	㰺
AJVW	㰽
RYQW	㰾
EXDW	㰿
QBTW	㱀
BMFW	㱁
OVIW	㱂
FPGW	㱅
HAGW	㱆
SSFW	㱈
FWYW	㱋
BBBW	㱌
LIQW	㱎
FHYI	㱐
HSKF	㱒
HWYC	㱓
HXQU	㱔
HVPH	㱕
DJEH	㱘
GQGN	㱙
GQHY	㱜
GQHC	㱟
GQYE	㱢
GQEV	㱣
GQDK	㱦
GQPB	㱧
GQFD	㱩
GQNJ	㱪
GQLE	㱬
GQWC	㱭
GQMU	㱯
GQRC	㱱
GQUL	㱲
AJDQ	㱳
GQGM	㱴
GQFE	㱶
GQWS	㱷
GQNF	㱸
GQHL	㱺
NNWC	㱼
PQWC	㱽
YNTC	㱾
FMGC	㱿
DFEC	㲀
PWAC	㲁
IMKC	㲂
HJXC	㲃
FNWU	㲇
QKXX	㲋
TFNB	㲌
FCTN	㲍
QKTN	㲒
UFTN	㲔
EFTN	㲕
IETN	㲖
EBTN	㲗
MTFN	㲘
TDKN	㲛
OOTN	㲜
YWWN	㲞
AMDN	㲟
EHCN	㲣
YKGN	㲤
OVHN	㲥
ABTN	㲨
OOON	㲭
PNLN	㲰
QAYW	㲳
RNKH	㲴
RNHO	㲶
RNKL	㲷
IWCY	㳂
IVFH	㳃
IQWY	㳄
IDHY	㳅
IUFH	㳆
IDMH	㳍
ICAH	㳎
IKRY	㳏
ISNN	㳐
IDKG	㳓
ICFY	㳔
IUDG	㳕
IYEY	㳖
ICYF	㳗
ICEG	㳙
IEWY	㳛
IFPY	㳡
IFTX	㳣
IUAY	㳤
IBNN	㳧
IVGQ	㳨
IDHK	㳪
IKSY	㳭
INIY	㳮
IYCA	㳰
IBJG	㳱
IDQN	㳳
INTF	㳴
ITBG	㳵
IQRJ	㳷
IAJG	㳻
AKGI	㳼
IXTI	㳽
IUFQ	㳾
IYCS	㳿
IATP	㴀
IGDJ	㴁
IMWG	㴄
ILWK	㴅
IVPH	㴆
IRGM	㴈
ICCF	㴉
IUBJ	㴊
IVIJ	㴋
IVDG	㴌
IBDI	㴍
IDFI	㴎
IHGN	㴐
IOUT	㴑
IQVN	㴔
IAKF	㴖
ISVG	㴗
IJHG	㴘
ITFE	㴙
IUEY	㴚
IGCT	㴛
TJWI	㴝
IEHJ	㴞
IDJB	㴟
IBKB	㴠
IIWH	㴢
IIGW	㴣
ISYG	㴤
IMIE	㴥
IEUD	㴨
IVKC	㴩
ITHS	㴪
ITMF	㴬
IPWH	㴭
INIE	㴮
IEXJ	㴯
ICEX	㴰
IPWU	㴱
IRHW	㴲
IFDY	㴳
IOGN	㴴
INTL	㴵
IBPQ	㴷
IOPY	㴹
IGKF	㴻
IPWJ	㴼
ITON	㴽
IFPT	㴾
ISDM	㴿
IYTD	㵀
IOAO	㵂
IJPX	㵃
IAKD	㵄
IWYM	㵅
IJTK	㵆
ITDF	㵇
IIVD	㵈
IJBC	㵊
ILMY	㵋
IUNY	㵍
IAYF	㵏
IDUW	㵐
IXJM	㵒
IPJH	㵓
IDFJ	㵔
ICCN	㵕
IVKI	㵖
IWRQ	㵚
IYEK	㵝
IPWM	㵠
IFLG	㵢
IJQW	㵣
INDW	㵤
IPNL	㵥
IDAP	㵦
IAJN	㵧
IAAS	㵩
IBBJ	㵫
IEBL	㵬
IFTO	㵭
IWDO	㵯
IRLH	㵲
IPNE	㵳
IBCI	㵵
IMAD	㵹
ILLL	㵽
IRRR	㵿
IENE	㶀
IIRO	㶃
IUQE	㶄
IERB	㶅
IYFJ	㶆
IOOJ	㶈
IEXG	㶉
IAHM	㶊
IOGG	㶋
IBXG	㶌
ILGP	㶎
IBEN	㶏
IOWN	㶐
IUCO	㶒
ILLD	㶔
ITUJ	㶕
IWHO	㶖
TXXI	㶗
ITSF	㶘
IIOG	㶙
ISAE	㶚
IYTW	㶛
IION	㶝
IJYE	㶞
ILLI	㶟
ICOF	㶠
OPQN	㶩
DUOU	㶫
OXET	㶭
GMWO	㶮
OEHH	㶲
VGOU	㶳
OQQY	㶴
OPEY	㶶
OQJG	㶷
OAIY	㶹
OGDK	㶺
TDHO	㶻
OCTD	㶼
OKMW	㶽
OFPB	㶿
OONF	㷀
OCEH	㷁
AHNO	㷂
ODEU	㷃
ODJN	㷈
NFOF	㷉
OVPH	㷌
OJQN	㷎
TTFO	㷏
OEFG	㷐
OSFF	㷑
OQRN	㷓
OEHJ	㷔
THNO	㷗
OCKS	㷘
OYOD	㷜
ODJB	㷞
OWNP	㷟
HANO	㷡
UGAO	㷢
OUGG	㷣
OOBG	㷥
BOOU	㷦
ODRI	㷧
OMTH	㷨
OWYB	㷪
FNWO	㷫
OFDG	㷯
OYRC	㷰
CEFO	㷱
OTGE	㷲
DTTO	㷴
OLFO	㷵
ONNW	㷷
OYKF	㸀
UEPO	㸂
LFHO	㸃
OYUJ	㸄
OTVB	㸅
OFWM	㸇
OFWY	㸌
OHAA	㸍
OBBB	㸎
TUDH	㸔
WREG	㸖
WRMK	㸗
WRLS	㸘
WRFJ	㸙
THGW	㸝
UDTF	㸤
AHYI	㸦
TNHH	㸨
TGMH	㸬
TPXN	㸰
DTGJ	㸴
DHVG	㸷
TRGK	㸸
TEFY	㸹
TCTD	㸻
TFPW	㸿
TFPB	㹀
TPLH	㹆
TJQN	㹇
TDRI	㹉
TWHE	㹋
TYUD	㹍
FQDG	㹕
TOOH	㹙
TOOK	㹚
TDHT	㹛
QTQA	㹝
QTNW	㹟
QTYX	㹡
QTEK	㹢
QTMG	㹨
QTCF	㹩
QTGW	㹫
QTIQ	㹰
QTFB	㹲
QTRQ	㹸
QTIJ	㹺
QTTV	㹻
QTQO	㹼
QTAA	㹽
QTVR	㺁
QTYM	㺆
QTUN	㺊
QTUO	㺌
QTLV	㺏
QTVS	㺐
QTNE	㺒
QTTL	㺕
QTKL	㺗
QTWO	㺘
QTCA	㺛
QTAL	㺝
QTEW	㺞
QTPY	㺠
QTBG	㺦
GNHH	㺩
GFNN	㺮
GGMH	㺰
WBGY	㺱
GNFG	㺲
GCAH	㺹
GNHY	㺼
GMKG	㺾
GAHH	㺿
GJRY	㻀
GLKG	㻁
GUAH	㻂
MAGY	㻃
GTGH	㻄
GWFC	㻅
GCEG	㻆
GWGG	㻇
GRGK	㻈
GHHT	㻉
GQKQ	㻊
GGKI	㻋
GWGS	㻌
GVOY	㻏
GLTY	㻒
GBCY	㻓
GTFG	㻔
GNBM	㻕
GPJH	㻘
GYCE	㻙
GJQR	㻛
GWWH	㻜
GGKJ	㻝
GDAE	㻟
GANS	㻡
GYTB	㻢
GUSG	㻥
GJMY	㻦
GUVO	㻩
GWYB	㻪
GFFN	㻬
GYXF	㻭
GWFI	㻮
GHAF	㻯
GDHV	㻰
GLVG	㻲
GJLC	㻴
GNBB	㻵
GTVG	㻶
GGMI	㻷
GAQJ	㻸
GSJF	㻼
GLQJ	㻿
GFUP	㼀
GUGY	㼁
GVLN	㼃
GXXL	㼄
GLXY	㼈
RCYQ	㼉
GBNY	㼊
DRCY	㼋
DIRY	㼍
RCYR	㼎
EVRY	㼏
RCYO	㼓
JLRY	㼔
MHGY	㼙
GAGY	㼛
QBGY	㼝
RIGY	㼡
AHKY	㼢
DJGY	㼣
FTGY	㼥
CEHY	㼧
JSGY	㼫
FHKY	㼭
GVHY	㼮
GJIY	㼯
JGHY	㼵
AYNY	㼹
OVHY	㼺
UJFY	㼿
TOLY	㽃
AFGY	㽍
AFUO	㽐
AFSF	㽑
LYWN	㽘
LCQN	㽙
KKLF	㽞
LEFY	㽟
LQOY	㽤
LUXX	㽧
LUGA	㽨
LCCE	㽩
YXTL	㽫
LMWK	㽯
EENH	㽰
UNHK	㽱
UGNV	㽲
UDYI	㽴
UPQV	㽸
URCI	㽹
UBYI	㽺
UFCI	㽻
UXHK	㽼
UBMK	㽾
URCY	㽿
USYI	㾁
UCKD	㾂
UPXV	㾃
UMFD	㾆
UGMI	㾊
UDMJ	㾍
UVKD	㾒
UKED	㾓
UJFD	㾖
UGJR	㾘
URDH	㾙
UHXF	㾚
UDWW	㾜
UHHE	㾟
UFCB	㾡
UPWA	㾤
UHGC	㾥
UUKD	㾦
UJSI	㾧
UDSK	㾨
UTFX	㾩
UITH	㾪
UYNA	㾫
UXXR	㾬
UTOI	㾭
URGD	㾮
UWFQ	㾱
UUQV	㾳
USJG	㾴
UYFK	㾵
UMED	㾶
URHW	㾷
UHXS	㾹
UBWS	㾻
UVEP	㾼
UWNP	㾽
UUVO	㾾
UYVB	㾿
URDF	㿁
UMGT	㿂
UAQH	㿃
UATC	㿄
UTYE	㿆
UNRD	㿇
UXTY	㿈
UAQJ	㿊
UKKS	㿋
UFAM	㿎
UVTG	㿏
UFHQ	㿐
UNWY	㿑
UFNF	㿒
UDWH	㿓
ULLL	㿔
UUQE	㿕
UHAL	㿖
UTWM	㿗
UOOK	㿘
ULXY	㿚
UGMX	㿛
RQIU	㿡
JERF	㿢
RDWJ	㿤
HCVY	㿪
XXHC	㿫
RYHC	㿭
YWRC	㿰
RRHC	㿱
HCVL	㿳
DBHC	㿴
HCDD	㿵
YUPC	㿶
UGAC	㿷
HCJC	㿸
HCFP	㿹
GALF	㿼
WGNL	㿽
PSLF	㿾
IBLF	䀀
PNTL	䀄
PYFL	䀅
DRML	䀇
VCAL	䀈
TDKL	䀉
INWL	䀊
FTHL	䀋
UJFL	䀍
HGNN	䀎
HCYY	䀑
HVYY	䀓
HXHH	䀕
HGDY	䀖
HGAH	䀘
HAVT	䀙
HQBJ	䀚
HQRT	䀛
QRHF	䀜
HXXN	䀝
HUFH	䀞
HXJH	䀟
HHKG	䀡
HTDY	䀢
HNTT	䀣
QHHF	䀤
HTNI	䀥
HTDG	䀨
HTKG	䀩
HTGS	䀪
HWGG	䀬
HYNW	䀭
HYNK	䀮
HGEY	䀯
HWWK	䀰
HTDH	䀱
HTXY	䀲
HGKI	䀳
HGVA	䀴
HCTD	䀵
HYVE	䀶
HFCE	䀷
RRHF	䀸
HDWW	䀹
HMGN	䀻
HDFE	䀼
HTHP	䀽
DCHF	䀾
HRRH	䀿
HRRJ	䁀
HYKI	䁁
HFUF	䁄
HBLG	䁅
HDJN	䁆
PNTH	䁇
YNAH	䁉
HCYH	䁊
HANS	䁋
HLEG	䁌
HYKS	䁎
HSVG	䁏
HAMD	䁐
HJGR	䁑
HKBG	䁒
HRBT	䁓
HEGC	䁔
HNNJ	䁕
HMGU	䁗
HERM	䁘
HJPV	䁙
HKMY	䁚
HRQC	䁛
HJIQ	䁜
OOPH	䁝
WWWH	䁞
HUGA	䁟
HUVO	䁠
HUWY	䁡
HYTH	䁢
HGJF	䁣
HYUD	䁤
HAAK	䁥
HAKW	䁧
HYKB	䁨
HQOY	䁩
HLRH	䁪
HLFO	䁫
HULJ	䁬
HDYY	䁭
HAQJ	䁮
HFFQ	䁱
HLMY	䁲
HYLG	䁴
HLGE	䁵
HRYT	䁶
HMAE	䁸
HNKF	䁹
HLFF	䁺
HRXS	䁻
HVLN	䁽
LFOH	䁿
HUGY	䂀
HQKY	䂁
HELF	䂃
HHHC	䂄
HYXJ	䂅
CNHY	䂆
DAHS	䂋
TDVK	䂏
TDBM	䂐
TDHX	䂑
TDFK	䂒
TDFF	䂔
TDXE	䂕
GWKF	䂖
EKDF	䂟
DHXN	䂣
DNNA	䂥
DLDY	䂩
DTAH	䂫
DOFG	䂯
DTJH	䂰
DUKQ	䂱
FCED	䂲
DFCE	䂶
DTFX	䂷
DQOY	䂹
DJSY	䂺
DDEY	䂻
DSWW	䂾
DGVV	䃀
DJXX	䃂
DMUN	䃃
DYKI	䃄
DULH	䃅
DXXR	䃈
DNNJ	䃉
DAEG	䃊
DUEY	䃍
DJTG	䃏
DTEC	䃑
DAMF	䃓
OOPD	䃕
DWNO	䃖
DVIJ	䃗
DAHF	䃘
DONX	䃙
DYTD	䃚
DLPY	䃛
YKBD	䃞
DAET	䃟
DQQW	䃢
DVFJ	䃤
BTGD	䃧
DXKJ	䃨
DMAE	䃩
DYLG	䃪
DQDY	䃫
DMRC	䃬
DFUP	䃮
DRIS	䃯
DPWI	䃰
DTEL	䃲
DVLN	䃳
DYCE	䃵
DUGI	䃹
DFAE	䃻
PYHY	䃼
PYXX	䃾
PYAY	䄀
PYAN	䄁
UDFI	䄅
PYKG	䄇
PYGU	䄈
PYDN	䄋
PYCC	䄌
PYAJ	䄍
PYAD	䄏
PYQJ	䄑
PYRG	䄓
PYIL	䄕
PYJG	䄗
PYLV	䄛
PYYC	䄜
PYWI	䄞
PYYG	䄠
PYYJ	䄢
PYFM	䄣
PYGM	䄤
TAYY	䄩
TTFH	䄭
TMWY	䄲
TGXW	䄺
TGMG	䄼
TJXT	䄿
TGQJ	䅀
PVTU	䅁
TTKG	䅂
AWYT	䅃
TEEE	䅄
TUQW	䅆
UDTU	䅈
TOTA	䅊
TQKQ	䅋
TTBT	䅎
TNTN	䅏
THQN	䅐
TEVG	䅑
TAYN	䅒
TQKC	䅓
TNDG	䅕
TDJN	䅖
TJJG	䅛
TMEG	䅢
TTFE	䅤
TALG	䅦
TYJI	䅫
TUWL	䅬
TLDN	䅰
TMGU	䅱
TFPI	䅴
TUGO	䅵
TAUF	䅸
TLVG	䅹
TJLC	䅼
FNWT	䅽
TLFO	䆀
TLFF	䆁
TUQM	䆅
TKKS	䆆
TUXW	䆊
TQXG	䆋
TOLW	䆏
PWSJ	䆑
PWCQ	䆓
PWNW	䆕
PWDC	䆖
PWLJ	䆘
PWGH	䆙
PWKA	䆛
PWTT	䆤
PWGE	䆥
PWTV	䆧
PWJD	䆨
PWHD	䆩
IGQA	䆪
PWIC	䆮
PWCV	䆯
PWIO	䆱
PWOI	䆲
PWCK	䆷
PWHE	䆽
PWAB	䇀
UTNN	䇄
UUFH	䇆
UCFG	䇈
UOCY	䇊
UIEG	䇌
UKHY	䇍
UAJG	䇎
UYKB	䇏
UVIY	䇐
VCAU	䇒
EDMU	䇓
UFDJ	䇕
TQTR	䇖
TWCU	䇗
TXHJ	䇙
TWHU	䇚
TQWU	䇜
TAFF	䇞
TQER	䇟
TYGF	䇠
TPSJ	䇡
TTAH	䇨
TJXR	䇩
TAHH	䇫
TRIU	䇬
TLQU	䇱
TKEJ	䇷
TKGF	䇸
TVTK	䇹
TGKU	䇺
TKCB	䇼
TGKI	䇿
TMMJ	䈀
TUAJ	䈂
TIVK	䈃
TBIB	䈄
TECB	䈈
TUVF	䈉
TYNH	䈍
TNDO	䈐
TWCT	䈗
TCKN	䈚
THMC	䈛
TWVC	䈜
TYKJ	䈞
TMJJ	䈟
TCKS	䈢
TGHT	䈣
TQEE	䈥
TETO	䈧
TBVE	䈨
TXMW	䈫
TIGY	䈬
TRQC	䈭
TUQK	䈮
TEEF	䈱
TJNF	䈳
TSTK	䈷
TQEF	䈸
TPNM	䈼
TSIE	䈾
TPJW	䈿
TOAO	䉀
TBWC	䉁
TFUY	䉅
TADJ	䉇
TAET	䉈
TQEY	䉉
TCDL	䉊
TVNH	䉋
TBUE	䉌
TUNU	䉍
TIPS	䉎
TQEG	䉏
TTOL	䉒
TSJS	䉓
TGQA	䉔
TULJ	䉕
TLWC	䉖
TRKB	䉗
TSPI	䉘
TFFC	䉙
TTMD	䉛
TRWC	䉟
TTMT	䉠
TEQO	䉣
TOVT	䉤
TRTN	䉥
TSDP	䉦
TQYJ	䉧
TUEC	䉨
TSAK	䉩
TLLL	䉪
TOWC	䉬
TAHM	䉯
TMER	䉰
TPUK	䉱
TXGR	䉲
TUDF	䉸
TFKW	䉹
UXOU	䉾
OWGH	䊃
OQKG	䊅
OPSY	䊉
ONTN	䊊
OOXX	䊌
OUDB	䊎
OIMK	䊑
OMEG	䊘
DGAO	䊙
ORSC	䊛
OGJF	䊜
OTON	䊝
OYUD	䊞
OFPU	䊦
OXJM	䊧
OLHD	䊫
TJSO	䊬
OYFJ	䊰
SOUG	䊲
OOSD	䊳
XFTT	䊷
XGXG	䊺
YNXI	䋀
XMRY	䋄
XYNT	䋆
XNYY	䋇
VCXI	䋈
XPWY	䋉
XSKG	䋍
XJGG	䋎
XTHF	䋏
XGNY	䋐
XGMW	䋑
XCNT	䋒
XQVG	䋓
WTFI	䋕
XVGH	䋖
XDIY	䋘
YNCI	䋜
XIVG	䋝
XMRR	䋞
XGEY	䋠
XWGS	䋡
RRXI	䋢
XNDG	䋧
XUKG	䋨
XEQN	䋩
XBSK	䋪
XQVH	䋫
XGDN	䋬
XYCE	䋭
HDXI	䋰
XSWW	䋱
XKJN	䋲
XUXE	䋳
XCNS	䋴
XRFH	䋸
XGKL	䋹
XTOY	䋺
XFMF	䋻
XBCL	䋼
XDQQ	䋾
XTUF	䌀
XSVG	䌁
XGMC	䌄
XOVK	䌅
XRQC	䌆
XFPI	䌇
XJNG	䌈
XLGH	䌉
XERM	䌊
XAWK	䌋
XNRG	䌌
LTKI	䌎
XPNM	䌏
XEHQ	䌐
XAHF	䌑
XONX	䌒
TXWI	䌓
XOSS	䌕
XWYS	䌖
XRLO	䌗
XSOY	䌚
XOGI	䌜
XSSI	䌝
XNKF	䌟
DGKI	䌠
XMAU	䌡
XFWC	䌢
XEAN	䌥
XFNF	䌧
XAWI	䌨
XALY	䌩
XUQE	䌪
XUED	䌬
XAWO	䌭
XFSH	䌮
XAKY	䌯
XBBB	䌰
XATO	䌲
XNIJ	䌵
XJTL	䍀
RMGF	䍂
RMHK	䍄
RMWC	䍅
RMPS	䍆
RMKW	䍉
RMYR	䍊
RMUK	䍌
RMAO	䍎
MJGD	䍏
MRRF	䍑
LAHT	䍓
LDCU	䍔
LQNB	䍖
LTXU	䍙
LYVE	䍚
LLDF	䍛
LWYF	䍜
LIJF	䍝
MRRG	䍞
LRBT	䍟
LYRC	䍠
LRLO	䍢
LYUJ	䍤
LYRY	䍦
UGGH	䍨
UGGS	䍪
UGXY	䍭
UGQB	䍯
UGEQ	䍲
UGCC	䍳
UGTV	䍴
UGGI	䍶
UGKN	䍺
UGDH	䍽
GANG	䍾
MFNG	䎃
VKNG	䎄
TENG	䎇
NJXT	䎈
TKNG	䎊
TFKN	䎋
NKHY	䎌
NIJG	䎓
ULJN	䎖
VFJN	䎘
PGHN	䎙
FTXX	䎜
VDMJ	䎟
VYDJ	䎠
DINK	䎤
DIOO	䎦
DIUK	䎧
DIDN	䎨
DIVL	䎩
DIJF	䎪
DIRT	䎫
DITP	䎭
DIYD	䎮
DIAW	䎯
BJHH	䎶
BGKG	䎸
TOBF	䎹
BRMJ	䎺
BVIY	䎼
BQAJ	䎽
BTOY	䎿
BGKJ	䏀
BPUF	䏁
BEHC	䏂
BPJW	䏃
BPWF	䏄
BGMJ	䏆
BSFI	䏇
BXXI	䏈
VINN	䏋
EWYY	䏎
ENWY	䏐
QMWW	䏑
ETHN	䏒
MUFQ	䏓
ENFG	䏔
EXHH	䏖
ERNN	䏗
EAQN	䏘
EPQN	䏙
EITT	䏚
EQUG	䏛
EBYY	䏜
EGSY	䏞
ENTT	䏟
EFIY	䏡
EHCY	䏢
EMFG	䏥
ETDG	䏦
EQQY	䏧
EWNN	䏨
EWGK	䏩
EEIY	䏮
EVYN	䏰
ENNK	䏱
EUXT	䏲
EIEG	䏴
EXXF	䏶
EGKG	䏸
EHQN	䏹
ETDH	䏺
CEFC	䏻
EAAY	䏼
EUKG	䏽
EDWG	䏾
EDSK	䐀
EVIY	䐂
ELTY	䐃
ENTD	䐅
EESY	䐆
EQRJ	䐇
EFHG	䐈
EVLG	䐉
EJXX	䐊
EWCN	䐋
MAWE	䐌
EFKU	䐍
EJGH	䐎
EDWJ	䐏
ETOY	䐐
EANS	䐑
EDQQ	䐒
EYNA	䐔
EKBG	䐕
ENOY	䐖
EFTJ	䐗
EEGC	䐘
EVCB	䐚
EDBG	䐛
EIMY	䐝
EXUU	䐞
EAMF	䐟
YUHW	䐡
EKMY	䐣
EUGA	䐤
EFCL	䐦
EYKK	䐧
EWYB	䐪
ETWH	䐫
EGMJ	䐬
EAQH	䐭
EUTG	䐮
ELXI	䐯
EWHE	䐰
EYUD	䐱
ENRG	䐲
EQOY	䐳
VCAE	䐴
EAMW	䐵
EAQJ	䐶
EVFG	䐸
EVFJ	䐹
ESJF	䐺
EDUF	䐻
EDHI	䐼
EAMY	䐽
ETMD	䐿
ENKF	䑀
ERRE	䑁
EEGW	䑂
MUAE	䑃
ETHJ	䑄
EALQ	䑅
EUGE	䑆
ERXS	䑈
EYNY	䑉
EKHP	䑊
EYKE	䑋
EUGI	䑌
EMMV	䑍
AFPF	䑓
TDEG	䑚
AOOH	䑞
EPQG	䑟
TECY	䑡
TEGQ	䑢
TEET	䑣
TEBY	䑥
TEQK	䑦
TETB	䑨
TEQI	䑬
TEIA	䑭
TEPB	䑱
TEHF	䑲
TEJE	䑵
TEPI	䑸
TEYB	䑻
TEQT	䑼
TEJN	䑽
TEPJ	䑿
TENR	䒁
TENF	䒂
TEFM	䒈
WGNC	䒊
MDQC	䒋
PJYC	䒌
ADYC	䒎
ULJC	䒏
UYTG	䒑
ANGF	䒒
AGNB	䒓
ANFJ	䒖
ATNB	䒗
AITR	䒚
AXNB	䒛
ATGJ	䒜
ARRU	䒝
ADHJ	䒠
AXHJ	䒡
ATPU	䒦
APVY	䒯
ABIG	䒱
AVTA	䒲
AVBF	䒵
AJXR	䒶
ADIU	䒹
AXIU	䒺
AMNB	䒻
AMAF	䒼
AMRR	䒽
AYEU	䒾
APEF	䒿
AFFU	䓁
AKCB	䓃
AQTR	䓄
AIRJ	䓅
ARRJ	䓆
AFOU	䓇
ATWC	䓈
AGKF	䓊
AIQA	䓋
AFNU	䓌
ADHK	䓏
ADGN	䓐
AIGA	䓑
AQLF	䓒
AFTB	䓔
AFQP	䓕
ATFX	䓙
ANBM	䓛
AIQY	䓜
ABLF	䓝
AIJF	䓠
ALDF	䓢
AGMY	䓣
AQRN	䓤
AMAW	䓦
ABKG	䓧
APRM	䓨
ASFC	䓩
AJQR	䓪
ARSJ	䓭
AGXU	䓯
AHXS	䓱
AWUQ	䓲
ATVE	䓳
ADMD	䓴
AGKJ	䓶
AITS	䓷
AVVF	䓸
APFV	䓻
AVDY	䓼
AIIV	䓾
ACLF	䓿
AWTV	䔀
APUF	䔂
APYG	䔃
AERM	䔄
ASKK	䔅
AMGU	䔇
AAMU	䔈
AXIT	䔋
ARSG	䔌
ACOU	䔍
ABUK	䔒
AYTF	䔓
AUJQ	䔔
AEGY	䔕
ABFT	䔖
ARMG	䔘
AQQY	䔙
AXDM	䔛
ABMF	䔜
AHXI	䔝
AYXF	䔞
ASIE	䔠
AWWN	䔢
ATJG	䔣
ARDJ	䔤
AVOJ	䔥
ASTX	䔦
ATJS	䔧
AXTY	䔨
AGKT	䔩
APNH	䔭
APGL	䔰
ARKB	䔱
AQDO	䔳
ABMC	䔴
AUSU	䔵
ARJH	䔶
AGGN	䔷
ABUE	䔹
ABDE	䔺
AVYH	䔼
AIJN	䔽
ARJN	䔾
AUSF	䔿
AFFW	䕀
AHDS	䕁
ACKP	䕂
ABIL	䕄
AVEC	䕅
ASWJ	䕆
AORC	䕇
ANHS	䕈
ALFF	䕉
AYLG	䕊
AFOK	䕋
ATWY	䕌
AYEK	䕍
AJGL	䕎
AUGY	䕏
APYL	䕐
AXEV	䕑
APWI	䕓
AIJC	䕕
ABTP	䕖
ATHJ	䕗
AYDW	䕛
ANYF	䕜
ATEF	䕝
AUYE	䕞
AEMW	䕟
AOWC	䕠
AUKK	䕡
ADUA	䕢
APUN	䕣
AWWR	䕥
AEUI	䕨
ASDI	䕩
AILF	䕪
ARHT	䕫
AXGG	䕬
AOTL	䕰
AOYI	䕲
AXGR	䕳
AFKO	䕵
AOSI	䕷
ALFK	䕸
AOGC	䕺
AGMX	䕻
AAKY	䕼
AKHJ	䕽
AJMN	䖁
AYXR	䖂
AFKW	䖅
ASGE	䖆
ASRE	䖇
HAXV	䖈
HAWJ	䖌
HATI	䖍
BHAW	䖎
HAQY	䖏
HAGU	䖒
BMHW	䖓
HAWG	䖕
HAWL	䖖
HADY	䖗
HAWI	䖛
YNJU	䖟
JWYY	䖠
JNFG	䖡
JITT	䖢
JRHY	䖣
QBJU	䖤
JNTT	䖩
HXJU	䖪
JWFH	䖫
UDJU	䖭
FFJU	䖯
JREY	䖰
JPTA	䖳
TRXJ	䖸
JYCK	䖻
JFCB	䖼
TJJU	䖽
TQTJ	䖿
JFWT	䗀
JDSK	䗁
JHAW	䗂
JAAY	䗃
JWRR	䗄
JDEY	䗅
JPHN	䗆
JQOY	䗇
JAFS	䗋
JSFG	䗎
JPOC	䗏
YTBJ	䗐
JUOG	䗒
JFCL	䗘
PAWJ	䗙
JWHE	䗛
JQYL	䗜
PYJJ	䗝
GDJJ	䗞
ATDJ	䗟
AFJJ	䗣
JOVH	䗤
JTDP	䗦
JOVI	䗧
JDHY	䗩
OAOJ	䗪
JOSS	䗫
JKKN	䗭
JDRR	䗮
JXFM	䗰
JOGW	䗱
JWGU	䗳
JTTP	䗴
JGLG	䗵
JAJN	䗶
JUJN	䗷
JUXN	䗹
JTVB	䗻
XWYJ	䗽
JPNS	䗿
FWYJ	䘁
JFHY	䘂
JPDN	䘆
JDAE	䘈
JTLY	䘊
JWWG	䘋
AADJ	䘌
JYXX	䘎
TLVW	䘐
TLYI	䘑
TLCT	䘒
TLQE	䘓
TLPK	䘔
TYWS	䘕
TRMS	䘖
TMTS	䘗
TGXS	䘘
YEFJ	䘚
PUCG	䘞
PUXH	䘟
PUDR	䘠
XXYE	䘡
PUPS	䘢
PUHX	䘣
PUSY	䘤
PUNX	䘦
PUMD	䘧
PUQJ	䘩
PUYQ	䘪
VKYE	䘫
FWWE	䘮
PUIE	䘯
PUTP	䘰
PUSC	䘴
PUVI	䘵
PUYF	䘹
PUPH	䘺
PUPB	䘼
PUPN	䘾
PUNM	䘿
PUEE	䙀
PUSV	䙅
PURH	䙉
PUGH	䙊
PUPG	䙋
PUYL	䙒
PULC	䙓
PUYD	䙗
PUNG	䙙
PUWU	䙞
PUGD	䙣
PUMP	䙤
PUAQ	䙦
PUJE	䙨
PUAE	䙩
PUMV	䙬
PUNJ	䙱
SDNB	䙴
SPEY	䙶
HQFI	䙸
GAHQ	䙹
TNHQ	䙻
DUHQ	䙽
PXHQ	䙾
TEHQ	䚀
TMKQ	䚁
HMNQ	䚃
VIHQ	䚄
AMDQ	䚆
SFHQ	䚈
DHVQ	䚉
UWLQ	䚊
KMHQ	䚋
RDFQ	䚌
OQAQ	䚏
TDKQ	䚐
LMHQ	䚑
UJFQ	䚒
SJFQ	䚓
GMYQ	䚕
TQES	䚘
QEHX	䚠
QEHN	䚡
QEHU	䚥
YUFH	䚵
YGDY	䚶
YNFG	䚼
YQWY	䚿
YRCY	䛀
YMFG	䛁
YFQN	䛃
YQBN	䛄
YWKG	䛇
YDXY	䛋
YQNN	䛌
YXJH	䛍
YPWY	䛎
YNXN	䛏
NGKY	䛐
YNTT	䛑
JTYY	䛓
YDMJ	䛔
YJRY	䛕
YJXT	䛖
YTLR	䛜
YNFM	䛝
YJFH	䛞
YGKU	䛠
YQAK	䛡
YKHY	䛤
YRDH	䛥
YWWK	䛦
YPWX	䛪
YDEY	䛫
YFUF	䛭
YTHK	䛮
YJXX	䛰
YKHN	䛱
YDJN	䛳
YEPC	䛵
YDHS	䛶
YPQB	䛷
YOHK	䛸
YXGE	䛹
YLWJ	䛺
YRFH	䛻
YEAG	䛼
YTFE	䛽
YGXI	䛾
YGKH	䛿
YRDF	䜂
OSSY	䜆
YVJS	䜈
YSWI	䜉
YGMJ	䜊
YKHM	䜋
YDUI	䜍
YOOE	䜎
YBDE	䜏
BDAY	䜐
YGFN	䜑
YTMD	䜒
YAAS	䜓
YDAP	䜔
YAJY	䜕
YSMY	䜖
YDGN	䜗
YAQT	䜘
YJXO	䜙
YLIP	䜚
YQKQ	䜛
YHPH	䜜
YDET	䜡
YPDN	䜢
YAWY	䜤
YJGP	䜥
WWKV	䜪
HPGK	䜭
WWKF	䜰
GKUH	䜶
CNHU	䜼
GKUL	䝀
GEFG	䝅
QRGE	䝆
WQGE	䝇
GERB	䝈
GECC	䝌
GEPL	䝍
GEMJ	䝎
GELV	䝏
GEBE	䝐
GEBI	䝒
GEVN	䝓
GEAY	䝔
GEBB	䝕
ERHY	䝖
EARY	䝙
EHAW	䝞
EDHD	䝟
EDRI	䝠
EJLC	䝢
EIAS	䝣
ETLI	䝦
MQUG	䝧
JCMU	䝨
MWET	䝩
MNHY	䝪
MYGG	䝬
MYXY	䝮
MTBN	䝯
EEEM	䝱
MNYU	䝲
HQCM	䝳
MYKI	䝶
TDKM	䝷
MAFC	䝸
MPQB	䝹
YYMU	䝺
FHNM	䝾
EWMU	䝿
MWND	䞀
MAJV	䞁
MDMD	䞂
MIMY	䞆
METO	䞈
MUDM	䞉
MHAH	䞊
MUSQ	䞋
MTDG	䞌
MJJG	䞎
MLNY	䞏
FOAG	䞑
FOMK	䞒
FOGA	䞓
FHAY	䞖
FHTN	䞘
FHGN	䞛
FHDH	䞜
FHXJ	䞞
FHRD	䞟
FHRY	䞣
FHFF	䞨
FHWK	䞩
FHAR	䞪
FHTB	䞬
FHCT	䞭
FHEB	䞯
FHFO	䞰
FHCC	䞵
FHJR	䞶
FHRG	䞹
FHRH	䞺
FHXE	䞼
FHFI	䞽
FHUA	䟀
FHVS	䟁
FHJC	䟂
FHGM	䟄
FHLJ	䟉
FHHE	䟊
FHWA	䟑
KHSH	䟓
KHCY	䟕
KHMH	䟖
KHQA	䟗
KHAV	䟙
KHMW	䟜
KHTC	䟦
KHNA	䟨
KHTP	䟪
KHRG	䟬
KHTD	䟯
KHTS	䟰
KHYQ	䟲
KHRR	䟷
KHEF	䟹
KHMY	䟺
KHCC	䟾
KHVI	䟿
KHIK	䠀
KHCF	䠁
SSKH	䠂
KHLT	䠅
KHNM	䠇
KHRF	䠋
KHNC	䠍
KHHS	䠕
KHPY	䠚
KHEM	䠛
KHAB	䠜
KHKL	䠤
KHTJ	䠦
KHNJ	䠧
KHBI	䠫
KHWB	䠬
KHUO	䠮
TMDC	䠲
TMDW	䠹
LNHH	䡂
LFQN	䡇
LRRY	䡈
LXCY	䡏
TLGS	䡓
LQQY	䡔
LGWF	䡖
AWYL	䡗
LQLG	䡘
LRQN	䡚
LFWF	䡜
HWLJ	䡞
LHMY	䡠
LYNA	䡢
LPLH	䡣
FTJL	䡤
LPWK	䡥
LCCS	䡦
LWNO	䡧
LFHW	䡩
LTDP	䡫
LJLC	䡬
LUGF	䡭
LTWH	䡮
LTLN	䡯
FNWL	䡰
LKKL	䡲
LADR	䡳
LUEP	䡵
LNKF	䡶
LAFL	䡷
LALY	䡸
LFPH	䡹
LDHN	䡺
LTHY	䡻
LTFM	䡽
LHAY	䡾
LFKW	䡿
LTNN	䢀
CKSS	䢄
PWDF	䢆
ETLE	䢉
GJPK	䢋
GAPK	䢎
UFPK	䢏
EGPD	䢐
QAYP	䢑
YWRP	䢒
PGFP	䢓
DGXP	䢕
MAPD	䢗
PFPI	䢘
GJRP	䢚
MWKP	䢛
VPMP	䢜
GFGP	䢝
SSPI	䢞
YTPI	䢟
ANSP	䢡
WYVP	䢢
QYPD	䢣
TSYP	䢤
GHHP	䢥
YXIP	䢦
NWEP	䢧
TWWP	䢨
GKTP	䢩
TDKP	䢪
EPQP	䢬
UGUP	䢭
FLPD	䢮
OOQP	䢯
NWYP	䢰
FLMP	䢱
HHWP	䢲
TDBH	䢴
FCBH	䢵
MYBH	䢷
EGBH	䢸
ANBH	䢹
BMBH	䢺
AWBH	䢼
AWKC	䢽
PVBH	䢿
DIBH	䣂
GVAB	䣆
GIYB	䣇
KCKC	䣈
IITC	䣉
IMKB	䣊
TOBH	䣋
VLBH	䣎
WAWB	䣏
AMDB	䣐
KHGB	䣒
GKMB	䣓
IMBH	䣔
COBH	䣕
COKC	䣖
IPKB	䣘
MEEB	䣙
LVBH	䣚
HAEB	䣜
NFTB	䣝
KKUB	䣞
UGTB	䣡
DIAB	䣢
HHWB	䣤
SGET	䣦
SGAY	䣧
SGTA	䣨
SGGN	䣩
SGGH	䣪
SGFC	䣫
SGAN	䣰
SGCA	䣲
SGNK	䣳
SGRQ	䣴
SGTD	䣶
SGRI	䣷
SGWK	䣻
SGYI	䣼
SGAS	䤂
SGPC	䤇
SGNL	䤉
SGAB	䤊
SGHR	䤏
SGAW	䤑
SGXY	䤒
SGAE	䤓
ILRG	䤔
SGRS	䤕
UJFG	䤗
QNHH	䤛
QMFG	䤡
QQDB	䤥
QWAY	䤦
QLKG	䤧
QREY	䤨
QMWN	䤫
QIIT	䤬
QRDH	䤭
QHHT	䤮
QGAE	䤯
FQWQ	䤰
QMRH	䤱
QFOY	䤲
QBIB	䤴
QAJV	䤷
QXGE	䤸
QPOC	䤹
QDRH	䤺
QDAE	䤻
QLIY	䤽
QDHR	䤿
QBHJ	䥀
QCLF	䥁
QPFE	䥂
QDAJ	䥄
YHDQ	䥆
QADA	䥈
QPQY	䥉
QGMY	䥊
QYKO	䥋
PJJQ	䥌
FUFQ	䥍
QTRB	䥏
QSWQ	䥑
XCJQ	䥒
QADF	䥓
QUMT	䥕
QUSD	䥖
QWWJ	䥘
QBUE	䥙
WHHQ	䥚
QDHI	䥛
QUSY	䥜
QRJN	䥟
FKUQ	䥢
EAWQ	䥣
QUTO	䥥
QDAP	䥦
QHPH	䥧
QUKK	䥨
QJXO	䥪
GIYQ	䥭
QSAB	䥮
QLCX	䥯
QYNJ	䥰
QPEO	䥱
QAKW	䥲
QDET	䥳
QMWM	䥴
QJFQ	䥵
QDTH	䥶
QTHJ	䥷
XGWQ	䥸
QQRT	䥼
QRGQ	䥿
QDTB	䦁
QGJE	䦄
DCDA	䦈
DCLG	䦉
DCGT	䦋
UFQV	䦎
UUAK	䦕
UFKD	䦖
UTLD	䦗
UTDD	䦚
UFOI	䦝
UIGD	䦞
UIFC	䦢
UCCC	䦤
UEQV	䦧
UAMD	䦫
UTJD	䦭
UDWJ	䦮
UQJN	䦰
UETO	䦱
UXTB	䦳
UGWR	䦵
UJMY	䦸
BNWY	䦼
WNNQ	䦾
BKHH	䦿
BQKG	䧁
BVKG	䧂
BTKG	䧄
BGXW	䧅
BAWY	䧆
BYEY	䧇
BHQN	䧋
BEVG	䧌
BKEG	䧎
BYKB	䧐
BSWW	䧒
BAAY	䧖
BTJT	䧗
BXGE	䧘
BYKK	䧚
BYUY	䧛
BOVK	䧜
BCOY	䧞
BEEG	䧟
BGJF	䧠
BOVH	䧡
BAKK	䧢
BOGW	䧤
BGJN	䧥
BETO	䧦
BUGY	䧧
BOGI	䧨
BNBT	䧩
BODV	䧪
BYKE	䧫
BPGM	䧬
BPDN	䧮
BQKY	䧯
BQOI	䧰
PQWY	䧵
TFKY	䧼
TOWY	䧽
JPVY	䨃
DUJY	䨅
PGHY	䨈
MMVY	䨉
FTAB	䨋
FFQB	䨌
FXCU	䨎
FUQW	䨏
FGXW	䨑
FLKF	䨓
FIGF	䨕
FDEF	䨖
FEBF	䨗
FHQB	䨘
FSRJ	䨛
FEEF	䨜
FIFF	䨟
FBIB	䨡
FMPU	䨤
FUWC	䨧
FPYH	䨩
FSWQ	䨫
FFCE	䨭
FDHV	䨮
FBGI	䨯
FIAF	䨰
FOGF	䨴
FISF	䨵
FCHN	䨶
FSSC	䨷
FWHO	䨹
FFCC	䨺
GEAC	䨼
OHDD	䨾
GDHD	䨿
HDHM	䩀
DMJX	䩃
DMJC	䩅
DMJB	䩊
DMJS	䩋
DMJI	䩍
DMJW	䩎
NKAW	䪏
NKAT	䪐
NKAX	䪑
NKAG	䪒
NKAO	䪕
NKAC	䪗
TNHG	䪠
UJAG	䪦
UJQY	䪨
EKUJ	䪪
UJGA	䪫
UJQT	䪮
UJUN	䪰
GQDM	䪲
VTDM	䪳
PQDM	䪴
AHTM	䪵
EGDM	䪶
QKDM	䪷
CADM	䪻
KGNM	䪽
DMWE	䪾
VCDM	䫀
QQDM	䫂
DFEM	䫃
UKQM	䫄
PSDM	䫅
DNXM	䫆
EMFM	䫇
DHKM	䫊
ADWM	䫏
SSDM	䫐
DSKM	䫑
QAJM	䫒
DHVM	䫔
YUPM	䫕
NHFM	䫗
JQWM	䫘
FASM	䫙
MXXM	䫜
TJDM	䫝
UGOM	䫞
KMDM	䫟
EDHM	䫠
UVOM	䫡
RHAM	䫢
EXDM	䫣
PJYM	䫤
RQCM	䫥
FCLM	䫦
RDFM	䫧
LVDM	䫫
AQAM	䫬
VAKM	䫮
YDSM	䫯
DMOH	䫰
LQJM	䫳
SSFM	䫴
THPM	䫵
GKKM	䫷
WTJV	䫸
DCWJ	䫺
WTJX	䬁
UKQJ	䬇
WTJQ	䬈
WTJM	䬙
FNUH	䬠
FTJH	䬡
WYVT	䬢
WYTN	䬣
NWYE	䬤
DHWE	䬩
KVWE	䬭
WYHK	䬯
WYQK	䬲
WYGS	䬴
WYNP	䭀
RRWE	䭁
WYKC	䭂
WYLD	䭅
DEWE	䭌
WYGL	䭍
WYAS	䭎
WYUN	䭐
WYWP	䭔
LRWE	䭕
WYJI	䭘
WYDI	䭜
WYWJ	䭝
WYKP	䭤
WYAF	䭦
WYOI	䭧
QNJF	䭪
XJUH	䭫
UTHM	䭭
TJUI	䭱
TJDK	䭲
TVRJ	䭳
COFJ	䭴
COGJ	䭶
COWR	䭸
COWV	䭻
CORW	䭿
COCA	䮁
COGY	䮅
CODF	䮆
COVG	䮇
COQQ	䮈
COGW	䮊
COGK	䮏
COEF	䮑
COHF	䮓
COCC	䮕
COJJ	䮖
COMF	䮗
COEQ	䮘
COFT	䮚
COBF	䮛
COAS	䮜
CODJ	䮞
COPC	䮟
COTT	䮡
COPY	䮤
COME	䮩
COQS	䮪
COLV	䮫
COSQ	䮮
COGT	䮯
COYD	䮰
COGP	䮱
COWU	䮴
COLJ	䮷
COHY	䮹
COYJ	䮺
COFF	䮻
COOO	䮽
COUD	䮾
COPH	䮿
CGPV	䯃
CGKW	䯄
CGBC	䯅
MENN	䯆
MEET	䯇
MEQW	䯉
MESK	䯊
MEDY	䯋
MENV	䯌
MEWF	䯎
METD	䯏
MEIQ	䯑
METS	䯒
MEFF	䯓
MEPA	䯔
METP	䯕
MEYE	䯖
MEXF	䯗
MEPQ	䯘
MEGY	䯙
MEXE	䯚
MEPB	䯛
MEJR	䯜
MEDE	䯝
MEMK	䯞
MEUE	䯟
MEJL	䯠
MEUO	䯡
OSSE	䯢
MEKM	䯣
MEJO	䯥
YKPK	䯧
YKMD	䯨
YKLL	䯬
DCEV	䰀
DCEL	䰐
HGGN	䰗
HGGE	䰘
GKMC	䰙
RQCH	䰠
RQCS	䰢
GJIC	䰤
AKGC	䰥
IWEC	䰪
RQCQ	䰫
FDMC	䰰
QOSH	䰳
QOBG	䰵
QODH	䰷
QOCN	䰾
QOXE	䱂
QORW	䱃
QORY	䱄
QOGS	䱅
QOBB	䱆
QOEG	䱉
QOAH	䱌
QOGU	䱏
QOEB	䱐
QORR	䱑
QOKC	䱒
QOWT	䱔
QOTX	䱕
TJQO	䱘
QOAJ	䱜
QORF	䱝
QOND	䱟
QOAA	䱠
QOYF	䱣
RMHO	䱥
QOUB	䱧
QOMN	䱩
QODD	䱮
QOYH	䱱
QODF	䱳
QOME	䱻
QOLV	䱾
QOLR	䱿
QOVS	䲃
QOAR	䲉
QOBE	䲊
QOFW	䲌
TEUO	䲍
QOHE	䲐
QOUY	䲑
QOQG	䲒
QOWW	䲓
QOTS	䲗
QGWB	䲝
QGIG	䲤
QAWO	䲭
BYWO	䲯
YWWO	䲳
OWVO	䲴
ITWO	䲵
WJWO	䲸
YXWO	䲻
TGWO	䲼
AGNO	䲾
NXWO	䲿
XWVO	䳇
DCYO	䳊
JWVO	䳋
CEWO	䳌
EWVO	䳎
FFWO	䳏
FWVY	䳒
EBWO	䳕
MGNO	䳙
JFWO	䳚
JVWO	䳛
WGSO	䳜
UKWO	䳝
JEWO	䳟
TFAO	䳠
FQXO	䳣
PGJO	䳦
RGWO	䳨
SVWO	䳩
MDMO	䳪
VCBO	䳭
EYNO	䳮
BMFO	䳳
LIWO	䳴
LRWO	䳻
UJFO	䴀
PJMO	䴁
QKEO	䴂
FFFO	䴃
EPQO	䴄
FAMO	䴅
TMOO	䴈
LGKO	䴉
UGTO	䴊
PGRO	䴐
FKKO	䴒
HLOE	䴛
GODX	䴡
ONJV	䴧
SWWR	䴯
TXTS	䵈
MYAW	䵊
AMWE	䵋
AMWB	䵍
AMWL	䵐
TWIY	䵑
TWID	䵕
TWIL	䵗
TWIQ	䵙
TWIE	䵚
TWIF	䵛
GDLO	䵡
LFOG	䵣
GALO	䵤
LFOC	䵥
FLFY	䵧
TJLO	䵩
LFOR	䵮
LFOS	䵲
THDO	䵵
QKXG	䵶
FFXG	䵷
HNDV	䵻
WFFC	䵾
YUHV	䶒
HBCN	䶕
HBWN	䶖
HBSK	䶗
HBUG	䶘
GQJB	䶛
HBTK	䶜
HBDW	䶝
HBAW	䶞
HBQE	䶟
DGKB	䶠
HBMJ	䶡
HBDY	䶢
HBMU	䶣
HBME	䶤
HBHG	䶥
HBGM	䶦
HBFQ	䶧
HBWW	䶨
HBYJ	䶩
HBFY	䶪
HBKT	䶫
DXYG	䶭
VTXG	䶯
TUTX	䶱
OQWA	䶴
