g	一
h	上
i	不
k	中
o	为
y	主
b	了
u	产
w	人
c	以
v	发
m	同
t	和
l	国
d	在
f	地
a	工
q	我
j	是
e	有
n	民
r	的
x	经
s	要
p	这
dg	三
hg	上
gh	下
eg	且
kh	中
my	丹
qy	久
tc	么
pp	之
vt	九
bn	也
hk	乩
gk	事
fg	二
gf	于
gx	互
gg	五
wj	介
wb	他
wm	仙
wa	代
wo	伙
wl	佃
wu	位
wq	低
ws	何
sw	來
we	俘
wk	保
wy	信
wn	假
wd	做
wp	傢
wf	僥
wi	償
cq	允
kq	兄
yc	充
ig	光
ty	入
wg	全
wt	八
wc	公
yw	六
hw	具
uv	兼
po	冞
pr	冟
pq	冤
ui	冰
up	凕
uy	凜
bi	函
vn	刀
wv	分
gq	列
gc	到
nm	刷
mj	則
dq	剋
ue	前
mu	剛
en	力
ek	加
qn	包
wx	化
ux	北
fe	協
fm	南
qg	印
vc	即
ww	卻
dl	厙
dr	原
fc	去
ci	厼
cc	又
by	及
dc	友
bc	取
ke	另
kn	叫
sk	可
kr	史
dk	右
tk	各
qk	名
rg	后
kc	吧
ki	吵
ka	呀
ks	呆
kt	呼
ky	咬
km	員
kw	唸
kb	啊
uk	問
fk	喜
kp	喧
kx	喲
ko	嘛
kv	嘯
kf	噴
ku	嚨
kk	嚴
kl	囉
lh	四
ld	因
li	囦
cl	圅
lu	圈
la	國
ff	土
dh	在
fb	地
fx	坳
fr	垢
fd	城
fa	域
ad	基
fu	增
qh	外
qq	多
dd	大
gd	天
dy	太
md	央
rw	失
df	奔
vv	女
vb	好
vk	如
vi	妙
ev	妥
gv	妻
vx	姆
vm	姍
vd	姑
vl	姻
vq	婚
vr	婢
va	媒
vp	嫁
vu	嫌
vs	嫖
vy	孃
bb	子
pb	字
br	孤
pf	守
pv	安
ps	宋
ph	官
pm	宙
pg	定
pt	客
pk	宮
pd	害
pj	宴
pi	宵
pc	宻
pn	密
px	實
pe	寫
pa	寬
og	對
ih	小
it	少
id	尖
yk	就
ni	尿
nd	居
nf	屆
na	展
nl	屢
nu	層
mm	山
cm	岊
mb	岌
mv	岧
mi	峭
mc	峻
ms	崍
mw	崙
ml	嶄
mo	嶙
mk	巖
ab	工
da	左
an	巨
nn	已
cn	巴
ym	市
gu	平
rh	年
mx	幽
ox	庇
oc	序
oq	底
oh	店
ow	府
oa	度
ot	庭
oi	廠
vg	建
ca	弁
aa	式
xh	引
xu	弱
xd	張
xc	強
um	彆
xk	彈
ga	形
tv	很
tj	得
ny	心
nt	必
ne	忇
np	忱
nr	怕
ln	思
nc	怪
nv	恨
un	悶
nw	惟
ep	愛
ns	慄
nj	慢
nx	慣
on	慶
no	憐
nq	懈
dn	成
rn	所
rt	手
rs	打
ra	找
rc	把
rr	折
ru	拉
rx	指
rd	振
rv	掃
rj	提
rq	換
rk	損
rf	撓
ry	擁
lb	擊
ro	擴
rb	攝
re	攪
nh	收
gn	攷
yt	放
dt	故
mt	敗
nb	敢
ae	散
lv	數
ou	料
us	新
yy	方
jj	日
vj	旭
je	明
dw	春
jt	昨
jf	時
ji	晃
jq	晚
jd	晨
uo	普
jy	景
jp	暈
ju	暗
lr	暫
ja	暴
jl	曙
jo	曠
ma	曲
vf	書
jb	最
ee	月
de	有
eb	服
gs	末
sg	本
fq	朮
sb	李
sf	村
sr	析
sp	枕
ss	林
js	果
iv	染
sj	查
sq	柳
sv	根
st	格
hj	桌
sc	桶
wh	條
se	棚
sl	楞
sx	楷
sa	模
su	樣
so	樸
si	檔
qw	欠
uq	次
hh	止
hx	此
hf	歧
ef	毀
xx	比
ii	水
gi	求
ia	江
ib	池
iq	沒
is	河
im	油
ri	泉
if	法
in	泥
iu	洋
ir	派
iy	流
io	淡
ij	湯
il	溫
ic	滲
ix	漲
iw	潑
ik	潰
oo	火
vo	災
qo	炙
om	炯
rl	無
qd	然
or	煌
os	煙
jv	照
of	燒
ok	燥
ov	燼
wr	爺
tq	物
qt	犯
yx	率
gy	玉
gt	玫
gw	珍
gr	珠
gj	理
gp	琛
go	璞
gl	環
ua	瓶
tg	生
yd	產
eh	用
ll	田
mh	由
jh	申
le	男
ql	甸
lw	界
cd	畚
ip	當
uc	痛
ur	痺
dj	百
hc	皮
cw	皴
vh	盡
hs	盯
sh	相
hy	眩
hv	眼
ht	睡
hr	睥
ho	瞇
hp	瞎
hu	瞳
ct	矣
td	知
dv	碌
dp	確
du	磁
ds	礎
dx	礙
do	礦
fi	示
py	社
bm	祟
tb	秀
tu	科
ti	秒
tr	稀
te	稱
ta	穫
pw	空
uu	立
uh	站
tx	第
tf	等
tw	答
tl	箇
tp	管
oy	米
ob	籽
oe	粗
oj	糧
ol	糰
xn	紀
xq	約
xa	紅
xm	納
xg	純
xi	紗
xb	級
fp	索
sn	紮
xl	細
xe	組
xf	結
xv	絕
xw	給
xy	統
ah	緊
xr	線
hi	縣
xp	縮
xs	縹
xt	總
xo	纏
lc	罷
lx	羅
dm	而
di	耗
db	耷
bo	耿
ba	聀
bk	聖
ub	聞
fn	聲
bu	職
ie	肖
ec	肥
he	肯
eq	胸
ce	能
ex	脂
eo	腑
es	腰
ew	腳
ej	腸
et	腹
ei	膛
ey	臍
ea	臟
el	舅
em	興
yv	良
qc	色
ap	芝
aw	花
as	苯
am	英
ac	茅
ay	荒
al	菌
ag	華
aj	萬
ai	落
ar	蒐
ao	蓆
au	蔽
av	蕭
af	藝
aq	蘇
ax	蘊
ha	處
kg	號
cy	蚤
jw	蛤
jr	蝗
jn	蝦
jc	螞
jk	蟬
ts	術
tn	衛
tt	衝
ye	衣
fy	裁
rm	製
pu	襬
ch	覌
fw	規
qe	解
ys	訂
yf	計
yn	記
yr	訴
yb	詘
yq	詢
yi	誚
yj	課
yh	誹
yp	誼
yo	談
yg	請
yl	謂
yu	議
ya	護
mg	豈
er	貌
hm	貞
qm	負
mr	販
xj	費
sm	賈
fl	賣
mq	贍
fo	赤
fh	起
tm	身
pl	軍
lq	軟
lm	軸
ls	軻
ly	較
lj	輥
lo	轆
lt	轎
ud	辦
qb	迎
rp	近
mp	迪
sy	述
lk	迴
op	迷
ve	退
lp	連
mf	週
jm	遇
mn	過
ut	道
nk	避
lg	還
th	邊
ng	那
ck	邰
ft	都
at	醫
to	釋
jg	量
qs	釘
qv	銀
qi	銷
qx	錄
qp	錠
qa	錢
qr	錦
qj	錫
qu	鐘
qf	鐵
ug	開
uj	間
ul	閘
uw	閤
bh	阯
bs	阿
bt	降
bv	限
bx	陛
bp	院
bl	陣
bg	陳
bq	陷
bf	陸
bj	陽
bw	際
bd	隨
be	隱
kj	雖
fv	雪
fj	電
fs	霜
ge	青
hd	非
ak	革
sd	頂
kd	順
ed	須
gb	頓
cf	頚
od	類
jx	顯
uf	養
hq	餐
co	馬
eu	騰
cg	驲
me	骨
vw	鳩
hl	鹵
gm	麗
lf	點
hn	鼎
hb	齡
ggl	一
sgh	丁
gnv	丂
agn	七
dgt	丆
dgg	三
hgd	上
ghi	下
gjk	丌
dhi	不
ghn	丐
egd	且
anv	世
gkg	丗
rgd	丘
gmw	丙
big	丞
gcu	丟
uxg	丠
gja	丣
hhl	丨
nhk	丩
uhk	丫
khk	中
njh	丱
kkh	串
kkj	丳
yyl	丶
uyt	丷
myd	丹
ygd	主
fjy	丼
rty	乂
nyi	乄
qyi	久
nwi	乆
tav	乇
tcu	么
tur	乊
ppp	之
tpu	乏
rgt	乒
rgy	乓
rfm	乕
tfu	乖
tux	乘
nnl	乙
nnv	乜
vtn	九
tnb	乞
tun	乥
hkn	乩
nld	乪
ekn	乫
dnb	乭
ebn	乳
rrn	乴
bxi	乸
iyg	乼
exi	乿
qjj	亀
ecm	亂
qhj	亇
guv	亊
gkv	事
fgg	二
gsj	亍
gfk	于
fnv	亐
gxg	互
fjj	亓
ggh	五
fjk	井
hxf	些
gkj	亜
gfg	亞
bkc	亟
ynv	亡
ywb	亢
yjj	亣
ywr	交
you	亦
yki	京
ykp	亮
ykj	亯
yji	亰
ywj	亱
wnv	亾
wfh	什
wfg	仁
wsh	仃
wvn	仇
wwy	仈
wwn	仉
wyn	今
wjj	介
wwu	仌
wbt	仍
wcy	仏
wfj	仐
wuu	仒
wbg	仔
wbn	他
wfy	付
wmh	仙
wmj	仚
wta	仛
wag	仜
waf	仝
wvy	仞
wtn	仡
wyc	令
wiy	仦
hgw	仧
wtc	仫
wit	仯
wqb	仰
weg	仴
wtg	件
wtf	任
wwv	份
wgx	仾
wwc	伀
whf	企
wxh	伄
wgb	伅
wqr	伆
wvt	伊
wby	伋
wdb	伌
wgg	伍
wfc	伎
wdy	伏
way	伐
wsy	休
wrh	伒
wfw	伕
wdc	伖
woy	伙
wlh	伡
wah	伢
wmq	伣
wqu	伨
wyy	伩
wvc	伮
wrg	伯
wdg	估
wwi	伱
wnx	伲
wan	伳
wjh	伸
wng	伺
wgu	伻
wny	似
wek	伽
wkw	伿
wck	佁
wgh	佂
wlg	佃
wjg	但
wps	佇
wdm	佈
whc	佊
wvk	佋
whx	佌
wug	位
wqa	低
wda	佐
wmd	佒
whk	佔
wsk	何
wpx	佗
wrw	佚
wth	作
wfv	佞
wtu	佟
wwm	佡
whg	佧
wqn	佨
wlk	佪
wtk	佫
wft	佬
wff	佳
wua	併
wve	佷
wuq	佽
wgk	使
wga	侀
wot	侂
wqq	侈
wdf	侉
wig	侊
wgq	例
wri	侏
wpv	侒
wmg	侗
wpt	侘
waa	侙
wqj	侚
waw	供
wte	侜
wye	依
wsg	価
wtx	侮
wnt	侯
wvp	侵
wkt	侶
wfp	侼
wle	侽
wgj	便
wev	俀
wkn	俁
wkh	促
wtr	俄
wgi	俅
wqt	俇
wcw	俊
wkc	俋
wwe	俎
wie	俏
wtj	俐
wce	俑
wpf	俒
wgv	俓
whq	俔
web	俘
wrd	俙
wjf	俚
wks	保
wct	俟
wyg	信
wux	俤
whw	俱
wec	俷
wdj	俺
wrt	俾
wha	俿
wpq	倇
wld	個
wph	倌
wuk	倍
wgc	倒
woo	倓
wnb	倔
wfu	倖
wee	倗
wim	倘
whn	候
wds	倚
wmf	倜
waj	借
wyt	倣
wpw	倥
wud	倦
wnd	倨
weq	倪
wwg	倫
whj	倬
wtv	倭
wjs	倮
wjx	倱
wes	倸
wbb	倻
wuv	倿
wam	偀
wem	偁
wue	偂
wnh	假
wjq	偈
wnu	偋
wad	偌
wut	偐
wwt	偑
wxx	偕
wdt	做
wyk	停
wsv	偠
wto	偢
wus	偤
wvg	健
wdq	偧
wqm	偩
wkb	偮
wln	偲
whm	偵
wjm	偶
whv	偼
weh	傁
wge	傅
wdr	傆
wab	傇
wkm	傊
wco	傌
wyu	傍
wex	傒
www	傘
wat	備
wjn	傝
wpg	傢
wfl	傤
wme	傦
wcc	傪
wmw	催
wov	傭
wtw	傱
wgm	債
wtl	傻
wxd	傾
wlv	僂
wsf	僄
wak	僅
wlp	僆
wnw	僇
wjl	僈
wsd	僊
wlt	僌
wqk	像
wtd	僑
wog	僕
wdu	僚
wet	僞
wep	僢
wul	僧
wfa	僨
woq	僯
wsq	僲
wso	僳
wgl	僵
wxg	僶
wss	僸
wsm	價
wnk	僻
wpa	僿
wma	儂
wuj	億
waq	儆
wqd	儋
wry	儌
wob	儍
wfd	儒
wfn	儔
wxt	儗
wvh	儘
wal	儚
wrl	儛
wpn	儜
wgw	儞
wip	償
wll	儡
woa	儣
wja	儤
won	儦
wde	優
wae	儰
wyf	儲
wlx	儸
wkk	儼
gqv	兀
cqb	允
fqb	元
kqb	兄
ycq	充
qii	兆
rbq	兇
tfq	先
wcq	兊
wkq	兌
qkq	免
tkq	兎
hjq	児
eqb	兒
fqc	兘
dqf	兙
dqt	兛
dqd	兢
tyi	入
wgf	全
gmh	兩
wty	八
wcu	公
ywu	六
wgn	兮
ubj	兯
awu	共
gwu	兲
rgw	兵
hwu	具
maw	典
ula	兾
urv	兿
uxl	冀
mhn	冂
dmb	冇
mfd	冉
mak	冊
mkd	冋
gmf	再
mwk	冏
jef	冐
jhf	冒
pyn	冖
pqv	冘
pmj	冚
pou	冞
prx	冟
pfe	冡
pbc	冣
pqk	冤
pjy	冥
pss	冧
uyg	冫
duu	冭
uiy	冰
uah	冴
uck	冶
uwy	冷
utf	冼
ugq	冽
uvg	冿
uqk	凂
usw	凇
uev	凈
umf	凋
uqg	凎
umg	凒
upj	凕
umw	凗
ulf	凙
uyl	凜
uxt	凝
uta	凞
ufl	凟
wyi	凡
twv	凢
nwv	凥
wsi	凩
whd	凪
fbk	凷
hnm	凹
ibk	凼
bib	函
vnt	刀
ngd	刁
jhh	刂
vyi	刃
vwi	刅
wvr	分
avt	切
rjh	刈
tnj	刉
fjh	刊
tdj	刋
qrj	刎
myj	刐
fqj	刓
nwj	刔
ejh	刖
gqj	列
xjj	刜
puv	初
egj	刞
vkj	刟
ckj	刣
kqj	別
fcj	刦
fcv	刧
tjh	利
maj	刪
gjg	刯
fjv	刱
ffj	刲
dfn	刳
bsj	刴
bjh	刵
nmh	刷
udv	券
gmi	刺
ynt	刻
gud	刾
wsj	剁
mjh	則
kej	剈
iej	削
dqj	剋
uej	前
rsy	剎
uav	剏
ukj	剖
aaj	剗
mum	剛
xgi	剝
ooj	剡
gey	剢
gkl	副
pdh	割
utt	剷
hag	劇
yuh	劑
qkx	劖
ent	力
enn	劜
aet	功
ekg	加
ret	劤
ege	助
vce	努
fce	劫
rwe	劮
det	劯
ffe	劸
dqe	勀
gva	勁
fpb	勃
udb	勌
uke	勏
ble	勐
cnh	務
kme	勛
oop	勞
gme	勣
akg	勤
tgl	勳
daj	勵
qtn	勹
qfd	勻
qvv	勼
qwi	勽
qci	勾
qre	勿
qri	匁
qxv	匂
qnv	包
qry	匆
qqi	匇
qrb	匈
qgu	匉
qoi	匊
qdj	匎
qgk	匐
qvc	匓
xtn	匕
wxn	化
uxn	北
abv	匜
amh	匝
ark	匠
alk	匣
agy	匤
aca	匥
aiw	匯
akh	匱
aaw	匶
aqv	匹
aad	匿
fgh	十
nfk	卂
gkk	卅
vfj	卆
tfj	午
faj	卉
ugk	半
faf	卋
glk	卌
nhg	卍
yww	卒
hjf	卓
fee	協
fmu	南
ilj	単
fge	博
yhu	卞
khy	卟
hgh	卡
hmn	卣
hlr	卥
bnh	卩
qbh	卬
qdb	危
vcb	即
qqb	卶
rhb	卸
wwk	卻
swi	厀
qdr	厃
dta	厇
dfk	厈
ddx	厐
dkx	厑
drm	厒
dgc	厔
ddn	厖
dlk	厙
djb	厚
dkr	厛
dtf	厜
dri	原
dub	厥
dgq	厫
djt	厬
dim	厰
idn	厳
cny	厶
ccy	厸
vcu	厹
fcu	去
ciu	厼
gmc	叀
ccc	參
byi	及
dcu	友
rci	反
nhc	収
tdc	叐
hgi	叔
bcy	取
epc	受
ugr	叛
poc	叜
fcb	叝
ehc	叟
dgh	古
qkd	句
ker	另
kvr	叧
kvt	叨
kbh	叩
knh	叫
vkf	召
kwy	叭
ksh	叮
skd	可
kxn	叱
kri	史
dkf	右
akd	叵
ngk	司
ket	叻
bkf	叾
kag	叿
tkf	各
kkg	吅
kxy	吆
kbg	吇
fkf	吉
kfy	吋
mgk	同
qkf	名
rgk	后
gkr	吏
kfg	吐
kuh	吖
ykf	吝
gdk	吞
kdy	吠
nkf	吢
kny	吣
kwj	吤
dhk	否
kcn	吧
kwv	吩
kwx	吪
kyw	吭
kcq	吮
kdc	吰
kfc	吱
kxh	吲
knd	吳
kit	吵
kmt	吶
knw	吷
kby	吸
kqw	吹
kqr	吻
kbn	吼
ktg	吽
gkf	吾
kah	呀
kqu	呁
kdb	呃
bdf	呄
kyy	呅
ksu	呆
ikf	呇
kgf	呈
kfw	呋
kuf	呌
kty	呚
kyx	呟
knn	呡
knx	呢
kxe	呦
kqa	呧
kkq	呪
klg	呬
kgu	呯
hxk	呰
krc	呱
kfi	味
kqk	呴
ksk	呵
klh	呷
krw	呹
kjh	呻
ktu	呼
kjg	呾
keg	咀
kam	咂
kwb	咃
kbm	咄
ukf	咅
kqn	咆
kxj	咈
tkg	和
kck	咍
thk	咎
krs	咑
kkw	咒
kdg	咕
kek	咖
kda	咗
kpx	咜
kga	咞
kbf	咠
kig	咣
kgc	咥
kgx	咦
kgq	咧
koy	咪
nyk	咫
ktk	咯
kud	咲
kyn	咳
kdo	咴
ktd	咶
kqi	咷
kpv	咹
kws	咻
yke	哀
kkk	品
ksg	哂
kmg	哃
kqq	哆
kff	哇
kwg	哈
fkx	哉
kde	哊
kfb	哋
kre	哌
kar	哎
kve	哏
kxw	哛
kmu	員
kdn	哤
sks	哥
ktr	哦
kie	哨
kjf	哩
kng	哪
rrk	哲
kke	哵
kev	哸
keb	哹
kge	哺
kgj	哽
kuk	哾
ktb	唀
kyg	唁
kmy	唄
kcw	唆
kkc	唈
kct	唉
kpf	唍
ktj	唎
krd	唏
ovh	唐
kww	唑
krf	唕
dck	唘
kqt	唙
kvp	唚
fck	唟
kra	唣
kii	唦
kvc	唧
kbe	唨
ktv	唩
kdw	唪
kqg	唫
knm	唰
kjj	唱
keq	唲
kyc	唷
kuv	唼
ksr	唽
ktf	唾
kmf	啁
yum	商
kbs	啊
kes	啋
ukd	問
kgv	啑
knb	啒
yna	啔
kqe	啗
kpq	啘
ynk	啟
krh	啣
krt	啤
kwf	啥
kru	啦
krr	啪
klq	啰
krq	啲
kih	啵
kyv	啷
kyu	啼
kto	啾
kpt	喀
kjm	喁
kfm	喃
ugu	善
kju	喅
kwn	喉
kan	喋
kky	喌
kmn	喎
ksv	喓
ksd	喖
kpl	喗
kmd	喘
kxg	喙
kqm	喚
kjq	喝
krx	喞
kle	喟
koa	喥
kpg	喧
kut	喭
kdj	喱
kxq	喲
ksj	喳
kal	喵
kdf	喹
kwt	喺
kqv	喼
kvk	嗈
kee	嗋
kuw	嗌
kub	嗍
kco	嗎
kpd	嗐
kcc	嗓
kfh	嗔
keh	嗖
kex	嗘
kft	嗜
kux	嗞
kug	嗟
ebt	嗠
kwc	嗡
kjl	嗢
kma	嗣
kfp	嗦
ekw	嗧
kim	嗩
kaw	嗬
kjs	嗮
kld	嗯
kwl	嗰
kwr	嗲
kce	嗵
kja	嗶
klp	嗹
kmw	嗺
kgk	嗽
kkn	嘂
kov	嘃
kgm	嘈
ksf	嘌
klv	嘍
kdh	嘎
dnh	嘏
kla	嘓
kgh	嘕
kos	嘛
ksw	嘜
kak	嘞
kpn	嘧
kvo	嘨
klm	嘪
kqd	嘫
kjb	嘬
koo	嘮
kvf	嘯
kxx	嘰
kfj	嘲
khx	嘴
kad	嘶
krl	嘸
kdu	嘹
kfk	嘻
klf	嘿
kus	噂
kul	噌
kka	噐
koq	噒
etn	噕
kog	噗
kva	噚
kfu	噠
ktm	噢
kss	噤
kkd	器
kuj	噫
kta	噬
kry	噭
kep	噯
kfa	噴
kaj	噶
kgb	噸
kpa	噻
knk	噼
kli	嚃
kfd	嚅
kay	嚆
kfo	嚇
kfn	嚋
kvh	嚍
kip	嚐
kpw	嚓
kqo	嚕
khb	嚙
ktq	嚟
kqy	嚠
kdt	嚦
kue	嚨
kuq	嚪
kmm	嚶
kyk	嚷
krm	嚹
klu	嚺
kel	嚼
kbb	囁
kyr	囄
kaf	囈
klx	囉
gkh	囊
kaq	囌
kni	囑
kau	囒
ktl	囖
mnv	囘
mng	囙
lwi	囚
lci	囜
lbd	囝
ldi	因
lvd	囡
lfi	団
lgb	囤
lii	囦
mwm	囧
lfc	囩
tlr	囪
lqr	囫
mjd	囬
lwx	囮
lgd	囯
lur	図
lwf	囶
lti	囷
ldd	固
lck	囼
lde	囿
lyd	圁
clu	圅
lud	圈
lak	國
lmd	圌
lnk	圍
lcm	圎
lly	圐
lfk	園
lkm	圓
lcf	圗
lwd	圙
llg	圜
lyx	圝
fyi	圡
fhy	圤
dfd	圧
dhf	在
fgf	圩
ftn	圪
fta	圫
fff	圭
fnn	圯
fbn	地
fkh	圳
fmh	圸
frh	圻
fqr	圽
fby	圾
fwj	圿
frc	坂
ffq	坃
fwc	坄
fty	坆
fqu	均
fpw	坈
fgb	坉
fyt	坊
fwv	坋
wvf	坌
fqw	坎
wwf	坐
fyw	坑
xxf	坒
iff	坔
fqf	坖
fgx	坘
gvf	坙
fhc	坡
feg	坥
fjg	坦
fdg	坧
fgu	坪
fhk	坫
fnx	坭
fdh	坯
fmk	坰
fmd	坱
fxj	坲
fxe	坳
fxy	坶
fsk	坷
fdc	坺
fqa	坻
fry	坼
fps	坾
ftu	垀
ftd	垁
tfa	垂
fug	垃
fdx	垅
fmg	垌
ftk	垎
fvg	垏
fqq	垑
fyn	垓
fqi	垗
fwd	垘
fws	垛
fbs	垜
fpt	垞
fve	垠
frg	垢
fgj	垣
fgc	垤
fwg	垥
fua	垪
fdp	垯
fpv	垵
feb	垺
fmy	垻
irf	垽
foc	垿
fmw	埁
fct	埃
byf	埅
fqe	埆
fcw	埈
fdw	埉
mif	埊
fyv	埌
fdn	城
fth	埏
rrf	埑
fef	埒
fkg	埕
fwn	埠
fud	埢
frt	埤
fpq	埦
fqv	埩
fim	埫
fvi	埭
foo	埮
fdj	埯
fes	埰
fjq	埸
fuk	培
adw	基
fds	埼
fvp	埽
bcf	埾
fjs	堁
yyf	堃
fyc	堉
fld	堌
fqk	堍
ffw	堎
fjx	堒
fvt	堖
fsf	堙
fpl	堚
fgl	堜
fmn	堝
fan	堞
fxg	堟
fwk	堢
fjm	堣
fxx	堦
fng	堩
fad	堪
frb	堫
fft	堵
fda	堶
fwt	堸
flw	堺
flg	堽
lif	塁
fay	塃
fly	塄
fyo	塆
fiw	塉
frq	塊
fjn	塌
ubt	塑
fpj	塓
faw	塔
iwg	塗
fov	塘
fxh	塡
ikg	塣
fkm	塤
fgk	塥
fuw	塧
ffh	填
fdr	塬
ftm	塮
fme	塴
fon	塶
fhl	塷
lrf	塹
flv	塿
fni	墀
fjl	墁
fuj	境
faq	墆
fcc	墋
rxa	墍
fiv	墚
ful	增
fha	墟
fwx	墢
fog	墣
fto	墦
fus	墫
bxg	墬
fsj	墰
frl	墲
fag	墷
nku	壁
fyl	壇
ffl	壊
fip	壋
ftg	壎
fah	壏
dje	壓
ffd	壖
fvh	壗
foa	壙
fuq	壛
fue	壠
fbx	壣
fyk	壤
fdl	壥
ffa	壩
fyx	壪
tfd	壬
fbj	壭
fpg	壹
fpf	壺
fna	壽
fll	夁
tou	夈
yot	変
dht	夏
dhh	夒
qhy	外
qqu	多
vqu	夛
ywt	夜
qqf	夡
alp	夢
ycl	夣
jsq	夥
gny	夨
gdi	天
dyi	太
tdi	夭
mdi	央
der	夯
djj	夰
rwi	失
dfj	夲
ddy	夶
gxw	夷
dkj	夼
dcb	夿
djn	奄
dsk	奇
dfi	奈
ffg	奊
hkd	奌
dff	奎
dwg	奏
dhv	契
dqq	奓
dfa	奔
yod	奕
ddc	套
cdj	奙
exd	奚
dft	奢
gdj	奣
tmt	奧
uef	奨
dak	奩
dwy	奪
ddj	奭
vvv	女
vcy	奴
vsh	奵
vbt	奶
vbn	她
vvg	奻
vta	奼
vbg	好
vmh	奾
vyv	奿
nvg	妀
vqy	妁
vkg	如
vnn	妃
vag	妅
vtf	妊
vga	妍
vwj	妎
vyy	妏
vwc	妐
vfc	妓
vkh	妕
vwy	妗
vit	妙
vdh	妚
vnw	妜
jvf	妟
vmw	妠
vrh	妡
vxx	妣
evf	妥
vfq	妧
vyt	妨
vdc	妭
vnx	妮
vmg	妯
vvk	妱
vjg	妲
qbv	妴
vyx	妶
vrw	妷
vsk	妸
vfi	妹
vgs	妺
gvh	妻
vjh	妽
uvf	妾
ekv	妿
vty	姀
vtp	姂
vug	姅
vxy	姆
vgm	姉
vck	始
vmf	姌
vma	姍
vmd	姎
veg	姐
vdg	姑
vny	姒
vtg	姓
tvf	委
hxv	姕
van	姖
vua	姘
vwt	姙
vqi	姚
vri	姝
vtm	姠
vyw	姣
vrg	姤
vft	姥
vgx	姨
vgc	姪
vah	姬
vgj	姮
vig	姯
vqj	姰
vwg	姵
vde	姷
vgd	姸
vld	姻
vqq	姼
vqd	姽
vad	娀
dgv	威
vaw	娂
vff	娃
vhq	娊
vie	娋
vdn	娍
rrv	娎
veb	娐
vtx	娒
vdq	娔
vle	娚
vng	娜
vev	娞
vke	娟
vdf	娠
vfn	娡
vux	娣
vtr	娥
vuk	娧
vqk	娩
vfh	娬
vct	娭
vyg	娮
vwn	娰
vtj	娳
vbc	娵
bcv	娶
vjj	娼
vvi	娽
vbs	婀
lvf	婁
vrm	婂
vpf	婃
vqo	婅
ves	婇
vpq	婉
vge	婊
vha	婋
vds	婍
vtv	婑
voo	婒
vhd	婔
vgv	婕
veq	婗
vud	婘
vqv	婙
vqa	婚
vfu	婞
vph	婠
vsw	婡
vrt	婢
vhj	婥
vvp	婦
ssv	婪
vjx	婫
vet	婬
vgf	婭
vnd	婮
vgl	婳
vyk	婷
vsv	婹
vfm	婻
vnh	婿
vjm	媀
vnk	媁
vdm	媆
vpl	媈
vue	媊
vdw	媋
val	媌
vqm	媍
vaf	媒
vhm	媜
tov	媝
vda	媠
viv	媣
vln	媤
vmn	媧
vhv	媫
vwk	媬
vqb	媰
ver	媱
vtl	媲
vth	媳
vab	媶
vlw	媼
vco	媽
vam	媾
vrq	媿
vpg	嫁
veh	嫂
vdr	嫄
vpw	嫆
vpj	嫇
vut	嫉
vxu	嫋
vuv	嫌
vee	嫍
dhs	嫑
vat	嫕
vsf	嫖
vlx	嫘
vjl	嫚
vuj	嫜
vov	嫝
vaa	嫟
vyu	嫡
vgh	嫣
vaj	嫫
voa	嫬
vrl	嫵
vbd	嫷
vus	嫻
voq	嫾
vfp	嬄
vfk	嬉
vkk	嬋
vtd	嬌
vto	嬏
vry	嬓
vyl	嬗
vfw	嬙
vpn	嬣
vos	嬤
vvh	嬧
vfd	嬬
vgw	嬭
mmv	嬰
lev	嬲
vxr	嬵
vpt	嬸
vem	嬹
vlh	嬽
vfs	孀
vww	孅
vmm	孆
vni	孎
vau	孏
bbb	子
bgd	孒
bnn	孔
bbf	孕
bbg	孖
pbf	字
dhb	存
ebf	孚
bty	孜
bnu	孞
blf	孟
bck	孡
bqn	孢
tbf	季
brc	孤
xeb	孧
byn	孩
btx	孫
bmy	孭
err	學
bfd	孺
bvh	孻
btw	孼
bmm	孾
pvb	宄
pta	宅
pxb	宆
pgf	宇
pfu	守
pvf	安
pdy	宊
psu	宋
pfq	完
pyw	宍
ptd	宎
pdc	宏
pfj	宑
ptf	宒
pdf	宕
pxc	宖
pfi	宗
phn	官
pmf	宙
pgh	定
pqb	宛
peg	宜
pdw	実
pgj	宣
pgc	室
pah	宦
pqi	宨
pdn	宬
pvt	宭
pkt	宮
pft	宯
puf	宰
pks	宲
pjv	宴
pie	宵
pww	容
pkg	宺
pes	寀
pgv	寁
phg	寂
pds	寄
pgm	寅
pge	寈
phm	寊
pgk	富
pqm	寏
pnh	寐
pjm	寓
pjg	寔
pdl	寕
piv	寖
pfh	寘
prc	寙
paj	寞
pwf	察
plv	寠
pde	寡
pnw	寥
pxf	實
pnl	寧
pto	審
pet	寪
peq	寫
pdu	寮
plg	寰
pxt	寲
pgq	寳
pgr	寶
pmd	寷
ffu	寺
efu	寽
yfy	対
usg	尊
vak	尋
ogu	對
iht	小
ite	少
wiu	尒
tiu	尓
biu	尕
idu	尖
imk	尚
idi	尜
dnv	尢
dny	尤
dnq	尥
dne	尨
wqg	尩
dnw	尬
dnt	尰
dnm	尳
dnk	尵
vte	尹
nvv	尻
nxv	尼
ntf	尾
nii	尿
nxx	屁
nmi	屃
npw	屄
ndd	居
nfb	屆
nbm	屈
ngc	屋
nkm	屌
ngq	屍
noi	屎
nua	屏
nie	屑
ndf	屒
rgn	屔
nae	展
nbs	屙
nta	屜
nan	屟
nft	屠
nlv	屢
nth	屣
ntt	履
ntl	屨
npd	屪
nil	屬
nmm	屭
bhk	屮
mmm	山
tmj	屲
tym	屳
mer	屴
mdr	屵
mvr	屶
mbt	屷
mag	屸
mtn	屹
mnn	屺
mvy	屻
mgq	屼
mfh	屽
mmh	屾
mmj	岀
meg	岄
mqb	岇
mah	岈
mqr	岉
cmj	岊
mby	岌
mga	岍
mwv	岎
mfq	岏
mfc	岐
mrh	岓
mwj	岕
tdm	岙
mcb	岜
mth	岝
mmd	岟
man	岠
msk	岢
mqk	岣
mhc	岥
muf	岦
mvk	岧
mxj	岪
mmg	岫
mlh	岬
mpx	岮
mxe	岰
mdg	岵
mrg	岶
mna	岷
mdf	岸
mqa	岻
mgu	岼
mmf	峀
ipm	峃
mca	峅
mqj	峋
mgc	峌
mvg	峍
mve	峎
mgx	峓
mpv	峖
mff	峙
mwh	峜
mat	峣
myw	峧
mtr	峨
mie	峭
mvt	峮
mtd	峰
mtj	峲
mhq	峴
mcw	峻
mdw	峽
irm	峾
myv	崀
mqe	崅
mpw	崆
mpf	崇
mij	崉
mss	崊
mnd	崌
msw	崍
mds	崎
mjx	崑
mmu	崗
mwg	崙
mfw	崚
mqf	崟
mgj	崠
mbi	崡
mev	崢
mrd	崤
mrt	崥
mdj	崦
mgv	崨
mee	崩
mld	崮
mqg	崯
mvl	崰
mjg	崵
mus	崷
myt	崺
mln	崽
msv	崾
msy	嵀
mut	嵃
mtu	嵊
mnh	嵋
maf	嵌
mjm	嵎
mrb	嵏
mwt	嵐
mlg	嵔
msj	嵖
mqq	嵚
mex	嵠
mwc	嵡
mov	嵣
mqy	嵧
myk	嵩
mux	嵫
mrq	嵬
mug	嵯
miw	嵴
mxu	嵶
mtw	嵷
mxk	嵹
mnw	嵺
maq	嵽
mcc	嵾
msd	嵿
mlv	嶁
muj	嶂
mlr	嶄
mgm	嶆
mkw	嶉
mrw	嶊
mnr	嶍
mnf	嶎
mto	嶓
msa	嶘
moq	嶙
mdu	嶚
mlf	嶧
mma	嶩
mog	嶪
mkb	嶯
tmo	嶴
mtm	嶶
mxt	嶷
moo	嶸
mfn	嶹
mwy	嶺
mqt	嶽
mda	巁
mue	巃
mha	巇
mwn	巋
mid	巌
mtv	巍
mtf	巑
mxh	巓
muw	巕
mkk	巖
kth	川
vpv	巡
vjs	巢
ijs	巣
aaa	工
daf	左
and	巨
aww	巫
aef	巭
uga	差
nng	己
rgc	巵
ckx	巼
mhk	巾
mhs	帄
mhw	帆
qam	帋
rdm	希
mhp	帎
vcm	帑
mhr	帕
mhh	帖
vpm	帚
yup	帝
yom	帟
emh	帠
udm	帣
vkm	帤
mhi	帩
mhd	帳
aqp	帶
mhj	帽
mhg	幅
mhe	幍
mhl	幗
mho	幞
mht	幡
mhu	幢
mhf	幬
guf	平
gdf	幵
xnn	幻
xet	幼
mxx	幽
xxd	幾
oxv	庀
osk	庁
owi	庂
oci	広
otc	庅
oxx	庇
ogb	庉
osi	床
ofc	庋
oah	庌
ork	庍
owj	庎
oqa	底
oqn	庖
olk	庘
ovw	庚
ohx	庛
oye	庡
ogc	庢
oqi	庣
ows	庥
oac	度
oww	座
orf	庪
odn	庬
oua	庰
ofw	庱
osw	庲
ort	庳
ovi	康
ove	庸
owc	庺
oxd	庼
ojm	庽
oew	庾
oal	庿
opo	廀
omj	廁
osh	廂
ovc	廄
orq	廆
odh	廈
ouv	廉
oyv	廊
oeh	廋
oak	廑
ogq	廒
oyk	廓
olv	廔
obw	廕
onw	廖
oaq	廗
oon	廘
ofk	廚
ojf	廛
onf	廜
oad	廝
oqq	廞
ofj	廟
oim	廠
orl	廡
owx	廢
oam	廣
oqe	廨
oyl	廩
oen	廫
omm	廮
oqo	廯
obf	廰
ovk	廱
pny	廴
thp	延
tfp	廷
vgp	建
spd	廼
agt	廾
agh	廿
caj	弁
gaj	弄
wva	弅
fca	弆
yoa	弈
umi	弊
ayi	弋
afy	弍
aay	式
xng	弓
xhk	弔
xhh	引
xgf	弖
xjk	弗
xcy	弘
xbn	弛
xcn	弝
xqw	弞
uxh	弟
xwf	弣
xrc	弧
vcx	弩
xbg	弭
xux	弱
xde	張
xcj	強
xdj	弼
xil	弾
xsk	彁
ogx	彂
xja	彃
xue	彅
xkk	彈
xam	彉
xgw	彌
xgd	彑
xgt	彘
xgp	彙
vow	彛
xgo	彝
vox	彞
vfa	彟
ett	彡
gae	形
yee	彣
mye	彤
sse	彬
jyk	影
tqy	彴
tbn	彵
tyt	彷
twc	役
tgg	彺
thc	彼
txj	彿
tyg	往
tgh	征
tsg	徆
tqj	徇
tve	很
tvg	律
twg	徐
tuh	従
tap	徔
tpf	徖
tjg	得
thh	徙
tim	徜
tww	從
tsw	徠
taj	徣
tnh	徦
trg	徨
trf	循
tyu	徬
tmg	微
tni	徲
tum	徶
tfl	德
tyc	徹
try	徼
tjb	忁
nte	必
net	忇
fnu	忈
nvt	忉
nsh	忊
nnn	忋
nnu	忌
vyn	忍
hgn	忐
any	忒
ntn	忔
ndy	忕
nfy	忖
nyn	忙
nbn	忚
oni	応
gdn	忝
ynu	忞
nyy	忟
khn	忠
nkh	忡
gnu	忢
nby	忣
nfq	忨
nwc	忪
nnw	快
ncn	忬
nyh	忭
nqa	忯
nvf	忰
nrb	忷
nnh	忸
ngg	忹
nqw	忺
nrh	忻
qrn	忽
nqn	怉
nvk	怊
ndh	怌
thf	怎
nqk	怐
vcn	怒
ngh	怔
nrg	怕
ndm	怖
dnu	怘
ndg	怙
neg	怚
njg	怛
lnu	思
ckn	怠
nck	怡
nrw	怢
rwn	怣
qvn	急
ngu	怦
ntg	性
qbn	怨
nnx	怩
ncf	怪
nxj	怫
nlg	怬
nnt	怭
nxe	怮
nfc	怯
nyx	怰
ngm	怲
nkq	怳
ngn	怴
nsy	怵
syn	怸
nkw	怾
nqq	恀
nqj	恂
nff	恃
nct	恈
nee	恊
nqi	恌
nig	恍
awy	恐
nqd	恑
nsg	恓
vkn	恕
nws	恘
ffn	恚
nlk	恛
naa	恜
nrd	恡
ndo	恢
bny	恥
nve	恨
ldn	恩
ntk	恪
nmg	恫
ntd	恬
awn	恭
thn	息
nwg	恰
yjn	恴
gmn	恵
wsn	恷
nce	悀
nke	悁
nls	悃
nwk	悅
nux	悌
njf	悍
ndw	悏
nkc	悒
ntx	悔
ncw	悛
nkg	悜
nkn	悞
tjn	悡
nyv	悢
tlq	悤
wqi	您
nir	悩
npf	悰
uni	悶
ntb	悸
nph	悺
nfu	悻
ngv	悽
srn	惁
njx	惃
nge	情
nmf	惆
njs	惈
ihk	惉
npq	惋
nqg	惍
tkn	惒
noo	惔
njq	惕
nmu	惘
nqr	惚
nim	惝
nwy	惟
gjh	惠
nxy	惤
noh	惦
nda	惰
npl	惲
shn	想
nmd	惴
njt	惺
nto	愀
ton	愁
npg	愃
nnk	愇
nqm	愌
ntj	愎
ujn	意
npt	愘
jmh	愚
epn	愛
nad	愜
dgk	感
nln	愢
nly	愣
nam	愥
nrq	愧
ngx	愫
ner	愮
nji	愰
nme	愲
hhn	愳
nxu	愵
nxh	愼
nrn	愾
nex	慀
nss	慄
ncy	慅
nuv	慊
cex	態
nay	慌
nlw	慍
nfh	慎
npj	慏
nsf	慓
ncc	慘
lrn	慙
nlr	慚
nmw	慛
ndr	慡
njl	慢
nxf	慣
dhd	慧
nvc	慨
nlp	慩
nak	慪
gus	慭
nfi	慰
ngj	慱
nah	慳
nnr	慴
nov	慷
uca	慿
dep	憂
nip	憆
nha	憈
nul	憎
nwf	憏
noq	憐
nkk	憚
nsj	憛
nso	憟
nfa	憤
nue	憪
nuy	憫
njy	憬
ndu	憭
nrl	憮
naq	憯
pgl	憲
nva	憳
nxg	憴
nuj	憶
nma	憹
nry	憿
nat	懂
nqe	懈
ntm	懊
nlf	懌
nfw	懎
nep	懓
nfo	懗
nea	懚
nxt	懝
nap	懞
nos	懡
nfn	懤
nfd	懦
npn	懧
ndj	懨
nja	懪
nrr	懫
noa	懭
nde	懮
nqy	懰
nal	懵
nyl	懷
nww	懺
nhh	懼
nbb	懾
gnx	戉
dgx	戌
dyx	戍
ade	戎
trx	我
aak	戒
aau	戔
dha	戛
may	戝
ujx	戠
kbx	戢
ila	戦
dea	戫
kkl	戰
fla	戴
rnd	戶
gnr	戸
ynd	戾
yny	房
rnr	所
ynq	扅
yno	扊
rtg	手
rgh	扌
rvn	扏
rwy	扒
rsh	打
rbt	扔
rfg	扗
rdy	扙
rag	扛
rnf	扟
rbn	扡
rtn	扢
rgq	扤
rta	扥
rvy	扨
rnh	扭
rwv	扮
rhg	扯
rby	扱
rrc	扳
rwj	扴
rfw	扶
rxx	批
rqa	扺
rqw	扻
rdb	扼
ray	找
bdi	承
rfc	技
rcq	抁
rgg	抂
ryh	抃
rit	抄
ryy	抆
rjg	抇
rcn	把
rny	抋
rpq	抌
rfq	抏
rqb	抑
rdh	抔
rwc	投
ruf	抖
ryw	抗
rrh	折
rqu	抣
rgm	抦
rkw	抧
rgu	抨
rmf	抩
rhc	披
rck	抬
rqn	抱
rsk	抲
rrw	抶
rtp	抸
rgs	抹
rfi	抺
rlh	押
rmg	抽
rna	抿
rkq	拀
rek	拁
ryg	拄
rry	拆
rxy	拇
rhk	拈
rug	拉
rdn	拋
rrg	拍
vcr	拏
raf	拑
ran	拒
rdg	拓
rdc	拔
rpx	拕
rtb	拖
rxe	拗
rqk	拘
rbm	拙
rvk	招
rtw	拠
roc	拡
rsg	拪
rve	拫
rtd	括
raa	拭
rfk	拮
rbi	拯
rwt	拰
awr	拲
udr	拳
rvq	拶
rft	拷
ree	拹
rdo	拻
rua	拼
rjx	拽
rwg	拾
rre	挀
rff	持
rig	挄
rbs	挅
rws	挆
rxj	指
rpv	按
rtk	挌
vkr	挐
rqi	挑
rpt	挓
rye	挔
rbg	挕
rgx	挗
igw	挙
rgo	挜
rvf	挦
rct	挨
rwk	挩
rww	挫
rfp	挬
rdf	振
rkg	挰
rii	挱
rtx	挴
rga	挵
rdt	挷
rhq	挸
rkc	挹
rgi	捄
rce	捅
rfo	捇
rkh	捉
reb	捊
ref	捋
rie	捎
rjf	捏
rke	捐
rcw	捘
rqg	捦
rdw	捧
rwf	捨
row	捬
rrt	捭
rjs	捰
rud	捲
rgv	捷
rvi	捸
rtv	捼
rph	捾
rrq	掀
roh	掂
rvp	掃
rmu	掆
rcc	掇
rep	授
rhj	掉
ruk	掊
roq	掋
rds	掎
rqr	掏
rqe	掐
rhd	排
rnb	掘
rev	掙
req	掜
res	採
ruv	接
rpw	控
rdj	掩
raj	措
rbc	掫
rqo	掬
ryn	掮
rhe	掯
rbl	掹
rcj	掻
ruo	掽
rxg	掾
rgl	揀
rhm	揁
rln	揌
ral	描
rea	揑
rtf	插
rkb	揖
rqm	換
rng	握
rmd	揣
rvc	揤
tor	揫
rjq	揭
rpl	揮
reg	援
rvg	揵
rux	揹
rdi	揼
rjl	揾
ram	搆
rkm	損
rge	搏
ryk	搞
rub	搠
ruw	搤
rxu	搦
rjn	搨
rov	搪
rte	搬
raw	搭
rss	搮
rme	搰
rlw	搵
rld	摁
rrs	摋
rla	摑
ryx	摔
raq	摕
ryu	摘
rlp	摙
ryr	摛
rxf	摜
ron	摝
rlx	摞
rlv	摟
rtl	摠
rdr	摤
rtj	摥
rmw	摧
rni	摨
rlr	摲
rgj	摶
rvj	摷
rsf	摽
rxk	摾
rlt	撂
lwc	撃
rum	撇
roo	撈
rva	撏
rae	撒
rjy	撔
rad	撕
ruj	撞
rsj	撢
ryc	撤
rwx	撥
rxq	撧
rdu	撩
rcd	撪
rrl	撫
rto	播
rjb	撮
rbd	撱
rog	撲
rqq	撳
rfu	撻
rfl	擂
ryl	擅
rlf	擇
rlq	擉
lbw	擊
rip	擋
rkk	操
rai	擓
rqd	擔
rtm	擙
rje	擝
rfn	擣
rfd	擩
rxt	擬
rpg	擯
rpn	擰
rut	擱
rus	擲
roa	擴
ros	擵
rtu	擶
rvl	擸
rlc	擺
rrx	擽
rde	擾
srr	攀
rll	攂
rue	攏
rpa	攐
rmm	攖
rbb	攝
rak	攤
rth	攥
rer	攪
rhh	攫
rah	攬
hcu	攴
nht	收
gnt	攷
nty	改
aty	攻
yty	放
ght	政
qkt	敂
dty	故
oty	敉
tkt	敋
giy	救
gkt	敔
mty	敗
ftb	教
nbt	敢
ooh	敥
ukt	敨
aqk	敬
jgq	敭
gki	整
lvt	數
hpt	敹
yyg	文
ybf	斈
yjf	斉
yhq	斍
yyv	斏
gyg	斑
yje	斔
ouf	料
ccp	斚
kkp	斝
ewu	斞
rtt	斤
ryi	斥
wrr	斧
qkr	斪
drh	斫
lrh	斬
ajr	斮
usr	新
xxg	斷
ytw	斻
ytb	施
yci	旀
ytr	旂
yte	旅
yrm	旆
yyc	旈
yrn	旊
ytn	旋
ytt	族
ytq	旐
yds	旑
yti	旓
yvg	旔
yto	旙
yts	旚
ytu	旞
vca	既
jgf	旦
xjf	旨
jfj	早
jvt	旫
vjd	旭
vjf	旮
jvb	旯
jfh	旰
jdu	旲
jqy	旳
jmj	旵
jnr	旸
jgg	旺
jyu	旻
jgb	旽
jqu	昀
jqb	昂
jrc	昄
jby	昅
jta	昇
jyt	昉
jgd	昊
jjf	昌
jjg	昍
jeg	明
qaj	昏
jwv	昐
jqr	易
ajf	昔
jrh	昕
jyr	昘
thj	昝
jtg	星
jmd	映
jbm	昢
jwe	昣
dwj	春
jdj	昦
jfi	昧
jth	昨
jgs	昩
jca	昪
jae	昮
juf	昱
jxj	昲
jrw	昳
jqt	昴
jlf	昷
jab	昻
jdx	昽
joc	昿
jqi	晁
jig	晃
gcc	晉
jtm	晌
jpv	晏
jwy	晗
jcw	晙
jqk	晚
jux	晜
jrd	晞
jdn	晟
jrr	晣
jgk	晤
jpf	晥
jtx	晦
jdf	晨
uog	普
jsr	晰
jeq	晲
srj	晳
jge	晴
jjj	晶
tdk	智
jss	晽
jty	暀
jfa	暁
jhd	暃
jpg	暄
jnh	暇
jpl	暈
jdm	暊
jnk	暐
jft	暑
jjt	暒
jgl	暕
juj	暗
jer	暚
jhj	暢
jrn	暣
jjp	暥
jwf	暩
lrj	暫
jtw	暰
jaa	暱
jaw	暴
joq	暽
jfp	曀
jvi	曃
jsj	曋
jxt	曏
jry	曒
jaq	曔
jep	曖
jog	曗
jnw	曜
jja	曝
joa	曠
jpd	曢
jha	曥
jue	曨
jgm	曬
jni	曯
jhn	曰
mad	曲
gjr	更
jxy	曵
gmj	曺
jqa	曻
jlc	曼
ulj	曾
fwf	替
jbc	最
jbe	朂
jhg	朄
eee	月
def	有
efq	朊
eeg	朋
ewv	朌
ebc	服
ewy	朎
ebm	朏
eqk	朐
mua	朑
eqi	朓
eyv	朖
yvc	朗
ecw	朘
ynj	朚
yne	望
eyk	朜
fjf	朝
eam	朠
erb	朡
muo	朥
eap	朦
eue	朧
fii	未
gsi	末
sgd	本
snn	札
fqy	朮
snb	朰
wsu	朵
bsu	朶
svt	朷
svn	朹
sxn	朼
ssh	朾
sfn	杇
scy	杈
set	杉
skh	杊
sbg	杍
sbf	李
skf	杏
sft	材
sfy	村
svy	杒
sta	杔
sdy	杖
yns	杗
nsi	杘
say	杙
stn	杚
sfg	杜
sbn	杝
smh	杣
sit	杪
sfq	杬
gji	東
jsu	杲
sjf	杳
sqw	杴
scn	杷
swc	杸
swx	杹
sny	杺
wcs	枀
squ	枃
xxs	枈
sgg	枉
sqb	枊
syt	枋
swv	枌
smf	枏
srh	析
spq	枕
ssy	林
smw	枘
sdb	枙
sty	枚
jsi	果
sfc	枝
smq	枧
shk	枮
sdg	枯
sck	枱
cks	枲
skw	枳
skv	枴
skg	枵
eks	架
sek	枷
sqn	枹
san	枻
ans	枼
fas	枽
sfj	枾
sfa	枿
shc	柀
spx	柁
stb	柂
sug	柆
stp	柉
smd	柍
swf	柎
srg	柏
afs	某
saf	柑
ias	柒
ivs	染
svk	柖
swk	柗
slh	柙
smg	柚
sjh	柛
sth	柞
sqa	柢
srw	柣
sjg	查
src	柧
saq	柩
sxe	柪
sxj	柫
gli	柬
sdc	柭
sbm	柮
ssk	柯
syg	柱
snt	柲
sqt	柳
hxs	柴
sma	柵
slg	柶
skq	柷
ske	柺
sym	柿
sxy	栂
ips	栄
sqj	栒
sqq	栘
sud	栚
sua	栟
syw	校
sdj	栢
sui	栤
suq	栨
sng	栩
sri	株
sqc	栬
swa	栰
saw	栱
sld	栶
sve	根
stk	格
fsx	栽
stg	桁
sff	桂
sqi	桃
sig	桄
sqd	桅
vks	桇
pvs	案
spv	桉
uds	桊
hjs	桌
sdf	桍
sgc	桎
sab	桏
sfk	桔
seg	桕
stl	桖
sbs	桗
sct	桙
svq	桚
sdx	桟
sii	桫
sfp	桲
scd	桳
seb	桴
sev	桵
sce	桶
sqe	桷
sgi	梂
ssg	梄
stx	梅
sdt	梆
suf	梓
smy	梖
shq	梘
wht	條
sie	梢
pwc	梥
sgk	梧
tjs	梨
svp	梫
scw	梭
sux	梯
saa	械
sls	梱
syc	梳
ssw	梵
hkc	梷
stj	梸
slp	梿
ycg	棄
srm	棉
sad	棋
ses	棌
sjx	棍
shd	棑
sdw	棒
spf	棕
sde	棖
see	棚
slt	棞
svi	棣
sqv	棦
soo	棪
sss	森
sgv	棲
scc	棳
sjs	棵
bcs	棸
sph	棺
ssp	棾
seq	棿
suv	椄
sds	椅
shw	椇
syk	椋
sfh	植
swy	椎
snd	椐
srt	椑
svl	椔
sjj	椙
fwm	椝
srs	椞
sow	椨
sov	椩
suo	椪
sul	椫
spe	椬
sbb	椰
snk	椲
swd	椴
srb	椶
sti	椼
sxg	椽
spt	楁
ssj	楂
smn	楇
sut	楌
spl	楎
slw	楐
sln	楒
swt	楓
sdh	楔
sda	楕
svg	楗
ssn	楚
sly	楞
sfm	楠
snh	楣
sqr	楤
spg	楦
shm	楨
skb	楫
sjq	楬
srf	楯
sew	楰
sbk	極
sxx	楷
sto	楸
sbc	楹
ris	楽
skk	榀
svc	概
ssl	榃
sjl	榅
spy	榊
svv	榋
snu	榌
suw	榏
sna	榐
sxu	榒
syv	榔
syu	榜
sdr	榞
spu	榟
spj	榠
ser	榣
sji	榥
sco	榪
stm	榭
sot	榳
sqy	榴
spw	榷
sjn	榻
sex	榽
sme	榾
sxh	槇
sam	構
swn	槌
srq	槐
kks	槑
syx	槒
srd	槔
shj	槕
fpd	槖
sdk	槗
ssm	槚
snr	槢
lrs	槧
sla	槶
sgm	槽
stw	樅
syr	樆
swh	樇
sxf	樌
shl	樐
siv	樑
slv	樓
svj	樔
son	樚
soa	樜
suj	樟
saj	模
sat	樥
sni	樨
sfv	樰
sva	樳
sjb	樶
sog	樸
sus	樽
stq	橁
srl	橅
stf	橇
soq	橉
std	橋
sep	橓
syq	橠
sqk	橡
sbd	橢
sag	橫
seu	橳
shx	橴
sae	橵
sru	橷
sfu	橽
syl	檀
sry	檄
sfl	檑
sea	檓
sip	檔
swg	檢
sfw	檣
sap	檬
sxr	檰
spn	檸
sah	檻
sfd	檽
snw	櫂
ssd	櫏
sll	櫑
sqo	櫓
sal	櫗
suk	櫚
stv	櫛
srx	櫟
sof	櫥
syf	櫧
sha	櫨
sue	櫳
sav	櫹
smm	櫻
sai	欂
sak	權
shh	欋
slx	欏
sau	欗
qwu	欠
vkq	欩
bmq	欪
ldq	欭
fkq	欯
hma	欳
qqw	欽
ffi	款
qeq	欿
tfe	歃
jqw	歇
uvo	歉
hhg	止
ghd	正
hxn	此
hhr	步
fhn	武
hfc	歧
hhu	歨
dhg	歪
han	歫
hte	歬
hob	歯
htg	歱
hdg	歲
hgm	歵
hxj	歶
dtt	歷
gqi	歹
hqu	歺
gqx	死
gqm	殃
gqc	殆
gqq	殉
gqr	殊
gqe	殍
gqd	殎
gqu	殕
gqf	殖
gqa	殘
gqb	殛
gqh	殩
gqk	殫
gql	殬
gqp	殯
gqw	殲
wdw	段
ygw	殶
rsw	殺
naw	殿
efw	毀
uew	毅
xfd	毌
txf	毎
txu	每
fxd	毐
gxu	毒
xxn	比
lxx	毗
tfn	毛
xxt	毞
itt	毟
ekt	毠
jht	毷
dae	毻
jnt	毾
qav	氏
nav	民
rnj	氘
rnm	氙
rnk	氚
rnw	氛
rnx	氟
rnt	氡
rno	氣
rnl	氤
rns	氥
rnu	氧
rnp	氨
rnv	氯
bii	氶
yii	氷
yni	永
ihy	氺
iwu	氼
ivn	氿
ish	汀
ign	汅
icy	汊
ikh	汌
iqy	汐
itn	汔
imh	汕
miu	汖
ifh	汗
igf	汙
inn	汜
ivg	汝
aiu	汞
iag	江
ibn	池
ifg	汢
iqa	汦
iga	汧
ijg	汨
igg	汪
fji	汬
iqu	汮
idc	汯
idy	汰
irc	汳
iyh	汴
iyy	汶
ity	汷
inw	決
itg	汼
irn	汽
iwv	汾
icn	汿
iny	沁
irh	沂
ifq	沅
icq	沇
ipq	沈
igb	沌
iav	沏
isy	沐
iqc	沒
ijf	沓
igh	沔
ixx	沘
iit	沙
ihg	沚
igm	沛
iiy	沝
igs	沫
ifi	沬
ieg	沮
ipx	沱
itb	沲
isk	河
ixj	沸
img	油
ick	治
ivk	沼
idg	沽
iwk	沿
ikq	況
ilw	泅
irw	泆
iek	泇
itu	泈
riu	泉
irg	泊
int	泌
ibm	泏
ibe	泐
ixe	泑
ixc	泓
iaf	泔
ifc	法
ilg	泗
igu	泙
ihx	泚
iqn	泡
ihc	波
iug	泣
inx	泥
inv	泦
iwf	泭
ina	泯
ilf	泴
diu	泵
ive	泿
iyo	洂
ido	洃
ilk	洄
iwd	洑
iri	洙
ita	洚
itk	洛
tki	洜
ipv	洝
ict	洠
ioy	洣
iaw	洪
itl	洫
iqi	洮
ibg	洱
iyt	洲
iua	洴
iqj	洵
igc	洷
iig	洸
igj	洹
itd	活
ire	派
iyc	流
iud	浂
iqv	浄
iwa	浌
iut	浐
igi	浗
irr	浙
ipd	浤
ikc	浥
itf	浩
iyv	浪
ieb	浮
itj	浰
iww	浴
itx	海
ivp	浸
ink	浺
iqk	浼
ifo	浾
imy	浿
ise	涁
ils	涃
iie	消
ihh	涉
itr	涐
ivt	涒
ike	涓
imw	涔
ikm	涢
iuk	涪
iph	涫
ifu	涬
inm	涮
idf	涯
iyw	液
ibi	涵
ild	涸
ind	涺
iij	涾
iuv	淁
ivl	淄
isr	淅
ird	淆
iqe	淊
iss	淋
iim	淌
imf	淍
ijj	淐
igv	淒
ifw	淕
ihj	淖
iqr	淘
ipf	淙
iec	淝
ioo	淡
iqg	淦
iev	淨
iet	淫
iwy	淮
ipw	深
iyk	淳
ijx	混
idj	淹
iaa	淺
igd	添
iii	淼
qiu	淾
ihd	渄
ige	清
iyj	済
ids	渏
irt	渒
iqm	渙
ift	渚
ioa	渡
iwt	渢
ifp	渤
ing	渥
imn	渦
imj	測
ile	渭
ixb	渳
ijq	渴
ial	渵
ihi	渺
ipl	渾
inh	湄
igl	湅
idw	湊
imd	湍
idm	湎
ikb	湒
iue	湔
ide	湖
iad	湛
ihm	湞
ijm	湡
ijt	湦
ice	湧
ius	湭
ifm	湳
iuo	湴
iea	湼
imt	溄
ivc	溉
ibc	溋
igo	溍
iov	溏
idr	源
ipj	溟
iuw	溢
ico	溤
ifs	溨
iuf	溬
iub	溯
ieh	溲
irv	溵
ixu	溺
ijn	溻
igx	溼
irq	溾
ilu	溿
ibw	滁
iwc	滃
iji	滉
iux	滋
iwh	滌
ibh	滍
iwr	滏
ime	滑
ipu	滓
iee	滔
ier	滛
iyn	滬
iaq	滯
icc	滲
iyu	滴
ihl	滷
iam	滿
iqo	漁
isf	漂
ivj	漅
isw	漆
ion	漉
ilv	漊
ibt	漋
itw	漎
inf	漏
ixk	漒
inr	漝
iip	漟
iaj	漠
ilp	漣
iqt	漪
ijl	漫
ilx	漯
igk	漱
ixd	漲
imp	漴
ilr	漸
ini	漽
xid	潁
imu	潂
ium	潎
iwx	潑
idh	潔
irl	潕
ito	潘
ivf	潚
ieq	潟
iuy	潣
iso	潥
iul	潧
isj	潭
ifj	潮
iva	潯
iti	潲
iae	潵
itv	潷
inb	潺
ioq	潾
iln	潿
ivy	澀
ifk	澎
iuj	澗
ixg	澠
ikk	澡
ima	澧
iuq	澬
iog	澲
itm	澳
iyl	澶
iqd	澹
iry	激
ilq	濁
iou	濂
ihw	濉
ihn	濎
ipn	濘
iap	濛
ivh	濜
ifd	濡
ifn	濤
iqp	濥
iah	濫
ihp	濬
iwo	濮
ixw	濰
ipg	濱
iia	濷
irx	濼
iha	濾
ida	濿
ifl	瀆
inp	瀈
ipe	瀉
ipt	瀋
ioj	瀍
ija	瀑
idt	瀝
ibd	瀡
ihq	瀣
iao	瀳
imm	瀴
iol	瀵
inl	瀷
ipa	瀽
iur	灁
iel	灂
ibb	灄
ill	灅
iak	灌
iuu	灍
iyr	灕
ios	灖
ijy	灝
ifa	灞
iau	灡
iyx	灣
rir	灥
ooo	火
oqb	灮
dou	灰
ovt	灱
ojh	灲
oag	灴
ofg	灶
oaj	灷
qyo	灸
ota	灹
obn	灺
oqy	灼
vou	災
wvo	炃
jou	炅
oyy	炆
oqw	炊
orc	炍
oou	炎
ooy	炏
osy	炑
oit	炒
aou	炗
orh	炘
qou	炙
joy	炚
oyh	炞
olh	炠
ogh	炡
oxj	炥
odc	炦
otb	炧
opx	炨
obm	炪
oyx	炫
oan	炬
mdo	炭
omk	炯
qno	炰
cko	炱
ock	炲
omd	炴
oyg	炷
oth	炸
odg	炻
okq	炾
otu	烀
otl	烅
gao	烎
ote	烐
oaa	烒
dgo	烕
fox	烖
oaw	烘
otk	烙
opt	烢
odo	烣
oft	烤
ord	烯
oeb	烰
omw	烱
rro	烲
ogv	烴
opf	烷
otx	烸
otd	烽
oof	烾
omy	烿
ofo	焃
oke	焆
oie	焇
ghg	焉
ocw	焌
ogk	焐
ols	焑
owy	焓
oqh	焔
onn	焗
ouk	焙
sso	焚
uoi	焛
ojx	焜
opw	焢
bco	焣
opq	焥
wyo	焦
oje	焨
oee	焩
ojq	焬
ohj	焯
oyc	焴
omu	焵
qdy	然
jjo	焸
ojt	焺
ojj	焻
ofa	焼
jeo	焽
odf	煃
owd	煅
opl	煇
owt	煈
ogl	煉
opg	煊
onk	煒
osf	煙
hho	煛
oju	煜
qvt	煞
ole	煟
oaf	煤
oqm	煥
jvk	照
odm	煩
ous	煪
vgq	煭
omn	煱
ofm	煵
oyn	煽
old	煾
oji	熀
orn	熂
olw	熅
okm	熉
ouw	熌
opk	熍
oer	熎
opj	熐
ahk	熙
onr	熠
onu	熤
oce	熥
oiw	熦
otq	熪
ooa	熫
gqt	熬
xod	熲
ojl	熳
oyu	熵
ojb	熶
oul	熷
ovf	熽
ouj	熾
osj	燂
oqd	燃
qeo	燄
owg	燈
odu	燎
ooq	燐
off	燒
oto	燔
aku	燕
ova	燖
ouy	燘
oun	燜
ojy	燝
otm	燠
okk	燥
ohq	燦
ory	燩
oea	燬
olq	燭
oep	燰
ojv	燳
ofu	燵
oma	燶
otg	燻
ofn	燽
oja	爆
ovl	爉
orx	爍
opd	爎
odt	爏
oha	爐
ouq	爓
oog	爜
oel	爝
ohh	爠
oip	爣
oau	爤
osr	爩
rhy	爬
evh	爭
emf	爯
elv	爵
wru	父
wrc	爸
wrq	爹
wrb	爺
rru	爻
drr	爽
gwm	爾
thg	片
aht	牙
tgk	牛
txn	牝
ctg	牟
tfg	牡
ptg	牢
tvy	牣
ttf	牦
tty	牧
tyw	牨
tqr	物
tay	牫
tlg	牭
tdg	牯
tsk	牱
ttg	牲
txy	牳
tqa	牴
udt	牶
tpb	牸
yxp	牽
nit	犀
tuk	犃
tds	犄
tgt	犇
tud	犈
thw	犋
ttu	犐
trn	犔
tat	犕
tpd	犗
tcc	犙
xkj	犟
tvl	犣
tlc	犤
tug	犧
tut	犪
dcy	犮
qtb	犯
qtc	狁
qtg	狂
qto	狄
hdy	狊
qtr	狐
qtx	狒
qtq	狗
qte	狙
qtv	狠
qty	狼
qti	猀
qtt	猁
jed	猒
qtj	猖
qtw	猴
qtu	猶
qts	猹
qtm	猾
qtl	獨
qtp	獰
qta	獲
yxu	玄
yxy	玆
yxi	率
gyi	玉
ggg	王
gsh	玎
get	玏
gag	玒
gfh	玕
gqy	玖
ggf	玗
gwc	玜
gfw	玞
gyy	玟
gwj	玠
gwv	玢
gyh	玣
gdh	玤
gnw	玦
gcq	玧
gfq	玩
gty	玫
gwb	玱
gwy	玲
gwa	玳
gan	玴
gaf	玵
ggu	玶
ghk	玷
gqn	玸
gyx	玹
ghc	玻
ghx	玼
glh	玾
gvk	玿
grg	珀
gsk	珂
gck	珆
gek	珈
gna	珉
gmm	珊
gwe	珍
gvg	珒
gyw	珓
gig	珖
gte	珘
gaw	珙
gld	珚
gug	珜
gng	珝
gtk	珞
gri	珠
gve	珢
grm	珤
gbg	珥
gtm	珦
gtg	珩
gff	珪
gdg	珬
gyt	班
gft	珯
giv	珰
gye	珳
gtr	珴
gux	珶
ggk	珸
gtx	珻
gmy	珼
ghq	現
gtn	琁
gke	琄
gjf	理
gtb	琇
geb	琈
gyc	琉
gah	琊
gtj	琍
gfj	琎
gie	琑
gtd	琒
gpg	琔
grt	琕
gaa	琖
gnd	琚
gpw	琛
gsw	琜
gge	琢
guk	琣
gha	琥
gds	琦
gjx	琨
gjj	琩
gad	琪
gdw	琫
gpq	琬
gvi	琭
gpf	琮
gph	琯
goo	琰
gss	琳
ggw	琴
ggx	琵
ggc	琶
ghj	琸
ggs	琹
gif	琺
gqg	琻
glw	琾
gpl	琿
gjt	瑆
gcn	瑈
gnk	瑋
gnh	瑕
gwd	瑖
geg	瑗
gbb	瑘
gvt	瑙
gde	瑚
gam	瑛
gwg	瑜
gmd	瑞
ggn	瑟
gwn	瑡
gim	瑣
gjl	瑥
ggo	瑨
gco	瑪
gov	瑭
gyv	瑯
grq	瑰
gpr	瑸
gip	瑺
gxf	瑻
ggj	瑼
gtw	瑽
gak	瑾
gtl	璁
gyr	璃
gvj	璅
ggq	璈
glp	璉
guj	璋
grl	璑
gat	璓
gul	璔
gia	璖
goq	璘
gog	璞
gjy	璟
gto	璠
gxx	璣
gaq	璥
gry	璬
gyl	璮
glg	環
gfn	璹
gyu	璾
ghp	璿
gfd	瓀
gll	瓃
grx	瓅
grr	瓆
gtq	瓈
gbd	瓍
gue	瓏
gdt	瓑
gyk	瓖
gtf	瓚
rcy	瓜
gnn	瓦
ygn	瓬
pqg	瓭
dgn	瓳
ckg	瓵
uag	瓶
dcg	瓺
ukg	瓿
tog	甃
lvg	甊
afd	甘
tda	甜
tgd	生
ydt	產
ehk	用
env	甩
geh	甫
dhe	甭
pne	甯
lll	田
lhn	甲
jhk	申
ler	男
qld	甸
mgn	甹
lsh	町
lsj	甼
lkh	甽
vlf	甾
lyn	甿
lqy	畂
ylc	畆
lqu	畇
lrc	畈
lfw	畉
lty	畋
lwj	界
olg	畑
lug	畔
llf	畕
ykl	畗
lmf	畘
qyv	留
cdl	畚
yxl	畜
ylq	畝
flq	畞
lwt	畟
jaf	畢
ltk	略
lff	畦
olf	畨
lye	畩
vfl	畫
ltx	畮
lcw	畯
law	異
lpe	畳
ipk	當
lds	畸
lpq	畹
ljg	畼
ltg	畽
xxa	畿
lip	疂
luj	疃
lgl	疅
xfg	疆
lfn	疇
nhi	疋
nhy	疏
xtd	疑
ube	疓
usk	疔
uxv	疕
uad	疘
utn	疙
ufi	疛
ugh	疜
umk	疝
udn	疣
ucv	疤
uwj	疥
uwc	疫
uhc	疲
uaf	疳
uhx	疵
uan	疶
uwe	疹
utp	疺
ukw	疻
utu	疼
ueg	疽
utd	疾
uxj	疿
uyx	痃
ugm	病
unx	痆
uwg	痊
uji	痋
ugx	痍
uqq	痑
uve	痕
utx	痗
ugv	痙
uce	痛
utw	痜
uie	痟
ucw	痠
utj	痢
ufn	痣
uww	痤
uuk	痥
ujh	痩
uee	痭
uph	痯
uoo	痰
usf	痲
uss	痳
utb	痵
uma	痶
urm	痸
urt	痺
uld	痼
ubs	痾
uyw	瘁
ucd	瘆
utg	瘇
uwt	瘋
ujg	瘍
umn	瘑
upl	瘒
uqm	瘓
unh	瘕
ucy	瘙
uli	瘝
udw	瘞
ujl	瘟
uiw	瘠
urq	瘣
uqy	瘤
ueh	瘦
uha	瘧
uaw	瘩
uxd	瘬
ucc	瘮
ulx	瘰
unw	瘳
uuj	瘴
uwf	瘵
uek	瘸
unf	瘺
ulv	瘻
uam	癀
udu	療
uue	癇
uwx	癈
ubw	癊
ukk	癌
ugy	癍
ulg	癏
unk	癖
uen	癙
una	癜
uyu	癠
uuf	癢
utv	癤
utm	癥
uqo	癬
umm	癭
uhh	癯
uvk	癰
uak	癱
ufh	癲
ull	癳
wgd	癸
wfq	発
wxw	發
rrr	白
djf	百
rnn	癿
rxb	皀
rfj	皁
rab	皂
rqy	的
xxr	皆
rgf	皇
rhx	皉
rif	皐
rtr	皒
djd	皕
rpf	皖
rrd	皞
rri	皡
rel	皭
hci	皮
hcf	皯
hcq	皰
plh	皸
hcp	皹
qbt	皺
hae	皻
hlf	盀
gfl	盂
dhl	盃
xhl	盄
khl	盅
wvl	盆
dyl	盇
bcl	盈
tlf	盉
uwl	益
fcl	盍
mdl	盎
dol	盔
dnx	盛
iqw	盜
vil	盝
aal	盞
jel	盟
vhg	盡
eil	盥
xfu	盭
hhh	目
hsh	盯
hfh	盰
hgf	盱
ynh	盲
hyn	盳
fhf	直
htn	盵
hfq	盶
shg	相
hgb	盹
hrh	盺
hwv	盼
rfh	盾
hyy	盿
heg	眀
ith	省
hqa	眂
hrc	眅
hyt	眆
hpq	眈
nhd	眉
rhf	看
har	眍
hfi	眎
hmd	眏
hxe	眑
hjh	眒
liu	眔
hwe	眕
hkq	眖
hqk	眗
duh	眘
hck	眙
hgs	眜
hps	眝
fhw	真
hna	眠
hrw	眣
hnx	眤
hxh	眥
hvk	眧
htp	眨
hyx	眩
hug	眫
hdx	眬
hff	眭
hmg	眮
hgc	眰
hgx	眱
hbg	眲
hqj	眴
hqq	眵
udh	眷
hct	眸
hud	眹
hqi	眺
hve	眼
hre	眽
lww	眾
wwh	睂
hie	睄
hpf	睆
hux	睇
hkg	睈
hww	睉
hke	睊
htr	睋
hhq	睍
hrd	睎
hls	睏
hoo	睒
hdf	睚
hge	睛
hev	睜
hsw	睞
hyw	睟
htf	睡
hlg	睤
hrt	睥
hfw	睦
heq	睨
hvi	睩
lfu	睪
hgv	睫
hes	睬
hmf	睭
had	睰
hnh	睱
hjt	睲
hpl	睴
hfk	睵
hdw	睶
hvg	睷
hft	睹
hwn	睺
hjg	睼
hpg	睿
hrf	瞃
hal	瞄
hto	瞅
hop	瞇
hwc	瞈
hov	瞊
heh	瞍
hpd	瞎
hpj	瞑
hyk	瞓
htw	瞛
hlv	瞜
hyr	瞝
ham	瞞
hsf	瞟
hkk	瞣
hwy	瞧
hog	瞨
hwg	瞪
hsj	瞫
hep	瞬
hdu	瞭
hyc	瞮
hnb	瞰
hcn	瞲
huj	瞳
hrl	瞴
hoq	瞵
hqd	瞻
hhp	瞾
hhw	瞿
htm	矀
hpn	矃
hnw	矅
hap	矇
hrp	矈
hxr	矊
hda	矋
hoa	矌
hqm	矎
hth	矏
hha	矑
hue	矓
hip	矘
hun	矙
hni	矚
tdu	矢
ctd	矣
qdt	矦
tdx	矧
tdt	矯
tdl	矲
dsh	矴
dbg	矷
dfh	矸
dtn	矻
dag	矼
dqy	矽
dit	砂
dmy	砃
dfw	砆
dyy	砇
ddb	砈
dav	砌
dqw	砍
dby	砐
dah	砑
dxx	砒
dwc	砓
dga	研
dvf	砕
dgb	砘
dwr	砜
dgs	砞
dth	砟
deg	砠
dgy	砡
dpx	砣
dqa	砥
hxd	砦
dxj	砩
dxy	砪
dyg	砫
dug	砬
dtp	砭
vcd	砮
dgu	砰
dqn	砲
ddg	砳
dhc	破
drg	砶
djh	砷
dam	砸
dar	砹
dwa	砼
deh	砽
doc	砿
dca	硁
dig	硄
dtl	硇
dvg	硉
dtk	硌
dve	硍
dgd	硏
dmg	硐
dua	硑
dsg	硒
dmn	硙
dtd	硚
dyo	硛
die	硝
dyv	硠
dpd	硡
ddw	硤
dlh	硨
dtr	硪
dyc	硫
dgj	硬
dhq	硯
dls	硱
dfo	硳
dmw	硶
dsw	硹
dge	硺
dee	硼
dqv	碀
dpf	碂
dlt	碅
dmf	碉
daa	碊
dms	碋
dvi	碌
dyw	碎
drt	碑
dqg	碒
dds	碕
dpq	碗
dma	碘
duk	碚
dan	碟
djq	碣
dyn	碥
dpt	碦
grd	碧
dlg	碨
ddm	碩
dad	碪
dwd	碫
djg	碭
dvt	碯
dmd	碳
dsj	碴
dhm	碵
ddh	碶
drf	碷
dpg	碹
dpw	確
dco	碼
dna	碾
dni	碿
dux	磁
dov	磄
dyu	磅
dme	磆
drq	磈
ddd	磊
dex	磎
duv	磏
dkm	磒
dwn	磓
dfc	磕
dnr	磖
lrd	磛
dwf	磜
ddr	磢
dcc	磣
drv	磤
dlx	磥
dsf	磦
dgm	磧
oss	磨
dtw	磫
ddf	磭
doo	磱
dul	磳
deq	磶
dus	磸
dto	磻
dkk	磾
due	礀
dip	礃
dyk	礅
dtm	礇
dry	礉
dlf	礋
dfl	礌
dss	礎
dog	礏
dgl	礓
djx	礘
dxt	礙
dap	礞
dal	礣
daw	礤
doa	礦
dll	礧
dda	礪
drx	礫
ddt	礰
dos	礳
dfs	礵
fiu	示
pyf	社
pyb	祁
pyc	祃
pyr	祈
pyd	祐
pyv	祒
pye	祖
pyq	祗
fif	祘
pyt	祚
pyk	祝
pyj	神
bmf	祟
pyu	祥
sfi	票
wfi	祭
pyl	祵
pya	祺
pyx	祿
ssf	禁
pyp	禈
pys	禋
pyg	福
pyo	禟
pym	禮
pyy	禳
mci	禸
tkm	禹
ttt	禾
tqb	禿
tbr	秀
tcy	私
twu	秂
tbg	秄
tta	秅
tmh	秈
tgv	秉
tfc	秐
tit	秒
txx	秕
tnx	秜
teg	租
tgu	秤
dwt	秦
trw	秩
tan	秬
ttn	秭
tgc	秷
twt	秹
tpt	秺
tqq	移
tpe	秾
trd	稀
tyv	稂
teb	稃
tcw	稄
twk	稅
tls	稇
tie	稍
trt	稗
twy	稚
tlt	稛
tfw	稜
toj	稥
tle	稩
ttj	稪
trb	稯
tem	稱
tuv	稴
tlw	稷
tyx	稸
tnu	稺
tee	稻
tpg	稼
tdn	稽
tyk	稿
tri	穆
tnw	穋
qot	穌
tma	穠
tea	穩
tgw	穪
taw	穫
toa	穬
tqo	穭
tel	穱
pwu	穴
pwv	究
pwx	穹
pws	穼
pwa	穿
pwd	突
pwh	窅
pwg	窒
pwq	窕
pwt	窗
pwn	窟
pwj	窠
pwm	窩
pwi	窪
pwo	窲
pwl	窶
pwb	窿
pwe	竄
pwr	竅
uuu	立
uwn	竌
uaj	竎
ukh	竒
uwv	竕
ups	竚
uug	竝
ujq	竟
uct	竢
upd	竤
uhj	竨
upe	竩
uqv	竫
unu	竮
uul	竲
uus	竴
ukq	競
tht	竹
tff	竺
ter	竻
tgf	竽
tbb	竾
taf	笁
tga	笄
trr	笅
tcb	笆
tyh	笇
tby	笈
tqu	笉
tmw	笍
ttd	笑
tny	笖
tlj	笚
tmf	笛
tbm	笜
tck	笞
tuf	笠
tqn	笣
tvk	笤
tng	笥
twf	符
tmm	笧
txh	第
tqk	笱
tca	笲
tek	笳
tib	笵
tak	笸
tab	笻
ttk	笿
tqi	筄
twa	筏
tag	筐
tgm	策
trk	筘
tiv	筜
tps	筞
trc	筢
thq	筧
tce	筩
tal	筪
tmu	筫
tth	筵
tnn	筷
tts	筿
tbc	箃
tic	箈
taa	箋
tra	箍
tev	箏
tge	箐
tvi	箓
tir	箔
tad	箕
tha	算
tpw	箜
tjx	箟
tph	管
tpq	箢
tih	箥
tue	箭
tsh	箱
tde	箶
tft	箸
txq	箹
ttv	箻
tkb	箿
tvc	節
tlb	範
txg	篆
tyn	篇
tia	篊
tto	篍
thi	篎
tsa	篐
tbi	篜
tij	篞
twh	篠
tco	篤
tss	篥
ttl	篦
tbw	篨
twn	篩
tqf	篯
tja	篳
ttw	篵
trq	篼
ttr	篽
ttq	簃
tnt	簈
tlv	簍
tvo	簘
tkk	簞
tsj	簟
tuj	簡
tuy	簢
tlm	簤
tam	簧
too	簩
taq	簪
tya	簱
tpy	簶
tip	簹
tpa	簺
tmn	簻
tig	簿
tah	籃
teu	籐
tsq	籕
tqv	籙
trl	籜
tyr	籬
tlx	籮
oyt	米
ofh	籵
own	籶
ovg	籹
otn	籺
obg	籽
ovy	籾
ofy	籿
oqr	粅
owv	粉
xxo	粊
oxh	粌
ony	粎
ocn	粑
oug	粒
org	粕
ogs	粖
oeg	粗
ohk	粘
omg	粙
voj	粛
osg	粞
sou	粟
xox	粥
odj	粨
ivw	粱
ogj	粳
oyw	粹
oge	精
ojs	粿
onh	糈
orb	糉
ode	糊
oux	糍
oxu	糑
oat	糒
ocy	糔
oov	糖
otf	糙
occ	糝
ola	糞
ogm	糟
oae	糤
ojg	糧
oxk	糨
ofd	糯
oda	糲
tyo	糴
bmo	糶
xiu	糸
xsh	糽
xnh	糾
xvt	糿
xfy	紂
xkh	紃
xqy	約
xag	紅
xvy	紉
xyy	紋
xdn	紌
xmw	納
xdy	紎
xuf	紏
xdh	紑
xwj	紒
xgb	純
xxh	紖
xit	紗
xqa	紙
xby	級
xwv	紛
xfc	紜
xpq	紞
gxi	素
xyt	紡
fpx	索
xrh	紤
xrw	紩
xhx	紪
hxx	紫
xmg	紬
snx	紮
xlg	細
xdc	紱
xan	紲
xjh	紳
xhc	紴
xps	紵
xyg	紸
xvk	紹
xaf	紺
xmd	紻
xxj	紼
xpx	紽
xwe	紾
xck	紿
xbm	絀
xtb	絁
xtu	終
xeg	組
xmk	絅
xug	絆
xrg	絈
xoc	絋
xcf	経
xwt	絍
xtg	絎
xfk	結
xvc	絕
xig	絖
xlk	絗
xuq	絘
xgh	絚
xyw	絞
xtk	絡
xqj	絢
xua	絣
xsg	絤
xwg	給
xad	絨
xqi	絩
xld	絪
vkx	絮
xyc	統
xxi	絲
xta	絳
xqc	絶
xhq	絸
xke	絹
xrd	絺
xgk	綀
xdt	綁
xie	綃
xvp	綅
xdw	綊
xpd	綋
xfp	綍
xev	綏
xuk	綐
xls	綑
xgv	經
xfn	綕
xon	継
xpf	綜
xss	綝
xmf	綢
xud	綣
xaa	綫
xep	綬
xwy	維
xqr	綯
xph	綰
xmu	綱
xcc	綴
xes	綵
xjs	綶
xth	綹
xds	綺
xpg	綻
xrt	綼
xhj	綽
xfw	綾
xrm	綿
xoo	緂
xjx	緄
xbc	緅
xvl	緇
ahn	緊
xhd	緋
xtv	緌
xwc	総
xvi	緑
xft	緒
xyj	緕
xdg	緘
xak	緙
xri	線
xkb	緝
xwd	緞
xyu	締
xal	緢
xwk	緥
xln	緦
xus	緧
xyn	編
xdm	緬
xle	緭
xtj	緮
xnk	緯
xwn	緱
xhi	緲
xgl	練
xrb	緵
xpl	緷
xjg	緹
xmn	緺
xgc	緻
xhm	緽
xve	縁
xuw	縊
xub	縌
xqb	縐
xuv	縑
xdr	縓
xlw	縕
xex	縘
xab	縙
xee	縚
xge	縛
xkm	縜
xfh	縝
xyk	縞
xpu	縡
hit	縣
xgx	縤
xwh	縧
xji	縨
xyr	縭
xpw	縮
xtw	縱
xlx	縲
xgj	縳
xyx	縴
xjl	縵
xlv	縷
xaj	縸
xsf	縹
xlp	縺
xtl	總
xgm	績
txt	繁
xme	繃
xvj	繅
xnw	繆
erm	繇
xxc	繈
xfo	繊
xvo	繍
xqd	繎
xul	繒
xjb	繓
xuj	織
xae	繖
xoq	繗
xto	繙
xdu	繚
xff	繞
xvf	繡
xxk	繦
xaq	繱
xqe	繲
xry	繳
xyl	繵
xma	繷
xlf	繹
xqv	繺
xxx	繼
xwo	纀
xat	纄
xrx	纅
oxi	纇
xoa	纊
xfl	續
xoj	纏
xha	纑
xmm	纓
xqk	纔
xww	纖
xtf	纘
gxh	纛
xah	纜
xll	纝
xdf	绔
xim	绱
rmk	缶
rmb	缷
rmo	缹
rmn	缺
rmq	缼
rmr	缿
rmx	罆
rms	罈
rmi	罉
mmr	罌
rmj	罎
rma	罐
mri	罓
muy	罔
ldh	罘
lyg	罜
lcn	罞
ldf	罟
lux	罤
lke	罥
leb	罦
lss	罧
ldj	罨
lhj	罩
lhd	罪
lyj	罰
lfm	罱
lft	署
lln	罳
lco	罵
lce	罷
lnw	罹
lvj	罺
lnf	罻
lja	罼
ldo	罽
lul	罾
mrr	羀
lxk	羂
laj	羃
lxh	羄
lxw	羅
ugj	羊
ufq	羌
ghh	羐
ugw	羚
ugp	羜
ugn	羞
vtk	群
ugg	羥
ugc	羧
ugi	羨
ugt	義
ugo	羹
nny	羽
nag	羾
naj	羿
wcn	翁
dcn	翃
fcn	翅
ndc	翇
lng	翈
ung	翊
nug	翋
nuf	翌
nrf	習
fkn	翓
mqn	翙
nyw	翠
nwn	翭
nla	翼
igq	耀
ftx	老
fte	耂
ftj	者
ftq	耇
ftt	耉
dmj	而
mdm	耑
dii	耒
dis	耓
dib	耔
dif	耕
dic	耙
dih	耜
diw	耠
dij	耦
did	耨
dia	耩
diy	耪
dil	耬
dix	耭
dio	耱
bgh	耳
bsh	耵
bbh	耶
dbf	耷
bfc	耺
bpq	耽
bdc	耾
boy	耿
bay	聀
bwv	聁
bwe	聄
bxe	聈
bbm	聉
bqt	聊
bqi	聎
bdm	聏
bfk	聐
btd	聒
bkg	聖
bmg	聘
bge	聙
bci	聚
bpw	聜
bak	聝
ubd	聞
bua	聠
bwc	聡
bpg	聢
beq	聣
byk	聤
btk	聥
btl	聰
fnw	聲
bfl	聴
bkh	聵
bqd	聸
bpn	聹
nbf	聼
bgf	聽
vgk	聿
vhk	肀
dcv	肆
mww	肉
eet	肋
ewn	肌
evn	肍
pef	肎
evy	肒
ief	肖
evg	肗
efy	肘
kef	肙
efg	肚
eag	肛
efh	肝
ecy	肞
efn	肟
ewc	股
efc	肢
ecn	肥
eyt	肪
egb	肫
edn	肬
emw	肭
hef	肯
edc	肱
yce	育
erh	肵
exx	肶
eqw	肷
ewf	肸
egm	肺
hpe	肻
efj	肼
edy	肽
lef	胃
erw	胅
erg	胉
muq	胊
erc	胍
eck	胎
mub	胐
enx	胒
egu	胓
eug	胖
ewe	胗
edh	胚
elh	胛
eqa	胝
eqn	胞
exy	胟
esk	胢
etb	胣
txe	胤
nhe	胥
emd	胦
eai	胨
ehg	胩
eld	胭
eta	胮
edf	胯
egx	胰
eig	胱
eyn	胲
etk	胳
egc	胵
eqr	胸
epv	胺
eua	胼
eff	胿
exj	脂
eqc	脃
edo	脄
eqd	脆
ere	脈
iwe	脊
ers	脎
eoy	脒
efp	脖
egi	脙
egv	脛
etf	脡
etx	脢
ean	脦
muc	脧
erd	脪
ewk	脫
eeb	脬
eev	脮
eni	脲
eir	脳
ede	脹
ert	脾
ejs	腂
eoo	腅
ema	腆
etv	腇
eeq	腉
eyw	腋
ecc	腏
owf	腐
eow	腑
end	腒
ehd	腓
epw	腔
epq	腕
epf	腙
epg	腚
eng	腛
exg	腞
edw	腠
emn	腡
ejm	腢
ejt	腥
evt	腦
efm	腩
epl	腪
etg	腫
eln	腮
erf	腯
esv	腰
eww	腳
enh	腵
ewd	腶
ejg	腸
etj	腹
eri	腺
eve	腿
eyu	膀
euv	膁
elw	膃
eeh	膄
eov	膅
egk	膈
euw	膉
eiw	膌
eex	膎
eak	膒
eon	膔
ela	膕
etd	膖
esf	膘
exk	膙
eip	膛
esw	膝
enw	膠
efv	膤
gsd	膥
eoq	膦
muu	膧
efk	膨
eaf	膩
edu	膫
ekh	膭
eto	膰
erl	膴
eay	膵
ext	膷
eda	膸
efa	膹
eyx	臃
elq	臅
euj	臆
ewg	臉
ekk	臊
eny	臎
efd	臑
eaw	臒
eah	臔
epa	臗
evl	臘
eha	臚
ehh	臞
ead	臟
dnd	臧
thd	自
ths	臬
gcf	至
fkp	臺
eth	臼
qef	臽
ewi	臾
eef	舀
eaj	舁
dwe	舂
eqo	舄
ele	舅
emg	興
egn	舉
tdd	舌
tdq	舐
wfk	舒
tdo	舕
nvp	舝
rlg	舞
tei	舟
tec	舥
ted	舦
tey	航
tew	般
tex	舭
tep	舵
tes	舸
tej	艃
tet	艇
ten	艉
teo	艔
tef	艝
teh	艣
teq	艪
vei	艮
yve	良
qcb	色
xjq	艴
uaq	艵
mdh	艷
btb	艸
asj	艼
avb	艽
aru	艾
abr	艿
avr	芀
awb	芁
avy	芄
acy	芆
afj	芉
atf	芊
agf	芋
afn	芌
aqy	芍
axb	芎
aff	芏
anb	芑
bhb	芔
aqu	芕
adu	芖
afw	芙
agb	芚
apu	芝
arn	芞
aqw	芡
abn	芤
awj	芥
aby	芨
afq	芫
awv	芬
acb	芭
amw	芮
anu	芯
awx	花
ayr	芳
aqc	芶
ahf	芷
arj	芹
aah	芽
aav	苆
aaq	苉
adb	苊
axh	苐
aqb	苑
ack	苔
amf	苖
alf	苗
amk	苘
auf	苙
aeh	苚
ask	苛
aux	苝
aqn	苞
ana	苠
adk	若
adf	苦
aps	苧
anx	苨
arf	苩
alw	苬
axe	苭
awm	苮
asg	苯
axc	苰
amd	英
aeg	苴
arw	苵
awi	苶
aaf	苷
axu	苺
ant	苾
axj	茀
abm	茁
adx	茂
aek	茄
acn	茅
ahx	茈
ags	茉
arg	茊
atk	茖
avv	茘
ave	茛
asf	茜
avg	茟
apb	茡
aqq	茤
auq	茨
aiy	茫
adh	茬
awd	茯
ari	茱
axx	茲
aia	茳
ald	茵
aws	茶
awa	茷
abf	茸
avk	茹
ayc	茺
amg	茼
aqj	荀
apv	荌
agc	荎
awt	荏
agx	荑
ayn	荒
aua	荓
aee	荔
adp	荙
amj	荝
axf	荮
akw	荶
afp	荸
aev	荽
acw	荾
ake	莂
age	莆
atj	莉
agi	莍
aii	莎
aip	莐
agv	莖
alj	莗
awh	莜
apf	莞
atb	莠
ahq	莧
ayv	莨
atr	莪
ajd	莫
avc	莭
ale	莮
abk	莻
axg	莼
ady	莽
apq	菀
aph	菅
abc	菆
avd	菇
avi	菉
aqo	菊
alt	菌
ajx	菎
ais	菏
avl	菑
ajs	菒
aeb	菔
ajj	菖
arm	菗
aes	菜
ard	菝
aih	菠
aud	菤
asr	菥
arp	菦
aoq	菧
auk	菩
apd	菪
aiv	菬
aic	菭
aov	菮
aga	華
ahd	菲
aqf	菳
adj	菴
avp	菷
aie	菹
ass	菻
aoo	菼
ahg	菽
agd	菾
ayw	萃
aqr	萄
art	萆
aec	萉
asw	萊
aje	萌
atv	萎
aqe	萏
ape	萓
arv	萔
aeq	萖
asp	萙
aiq	萢
ajm	萬
aqm	萯
apg	萱
amn	萵
aew	萸
ait	落
ajt	葃
awk	葆
aan	葉
axa	葒
ati	葕
aft	著
ash	葙
ajq	葛
aqg	葡
atg	董
alg	葨
arc	葩
agq	葬
axq	葯
adg	葳
awg	葵
apl	葷
aln	葸
akb	葺
arb	葼
asv	葽
asy	蒁
ayu	蒂
air	蒎
arq	蒐
afh	蒖
afi	蒜
adr	蒝
ate	蒩
axm	蒳
aub	蒴
aex	蒵
axw	蒶
akm	蒷
abi	蒸
auv	蒹
aut	蒺
aop	蒾
ayk	蒿
abt	蓀
apj	蓂
ayx	蓄
ame	蓇
apw	蓉
awc	蓊
afc	蓋
atl	蓖
aow	蓙
ace	蓪
aod	蓭
atw	蓯
ath	蓰
afu	蓻
anw	蓼
aja	蓽
ahl	蓾
axk	蔃
aif	蔆
aoj	蔊
agk	蔌
ajl	蔓
aoa	蔗
acc	蔘
anf	蔚
aho	蔝
ayt	蔟
awf	蔡
apn	蔤
alu	蔨
alr	蔪
anh	蔬
abw	蔭
ala	蔮
abg	蔯
ars	蔱
ada	蔵
aum	蔽
ava	蕁
aeu	蕂
ato	蕃
aun	蕄
ann	蕊
agw	蕐
alm	蕒
aqt	蕕
agj	蕙
ajb	蕞
afa	蕡
aep	蕣
aed	蕦
att	蕧
aij	蕩
arl	蕪
avf	蕭
adc	蕻
ama	蕽
afl	蕾
aoe	蕿
ail	薀
ary	薂
aig	薄
atm	薇
axt	薌
auj	薏
agl	薑
aqd	薝
aon	薦
abu	薩
aus	薪
aog	薱
aej	薶
afk	薹
aly	藅
apa	藆
ahw	藈
adi	藉
avh	藎
adn	藏
aer	藐
atq	藜
add	藞
all	藟
arr	藠
alc	藣
arx	藥
alv	藪
aur	藱
asa	藲
adt	藶
ayj	藹
auw	藺
aik	藻
aha	蘆
axl	蘊
ahh	蘋
afe	蘎
aye	蘐
aos	蘑
ank	蘗
aat	蘙
abe	蘟
amm	蘡
aue	蘢
aam	蘣
are	蘤
atx	蘩
aug	蘭
alb	蘻
alx	蘿
aem	虋
hav	虍
haw	虎
haa	虐
hay	虔
hat	處
haj	虛
hak	虞
kgn	號
has	虨
jsh	虰
jhy	虲
jbn	虵
jbg	虸
jag	虹
jtn	虼
jdb	蚅
jcn	蚆
jny	蚇
jga	蚈
yju	蚉
jyy	蚊
jmw	蚋
jdh	蚌
jxh	蚓
jfq	蚖
jkh	蚛
jah	蚜
jsy	蚞
wvj	蚠
jwc	蚣
cyj	蚤
jwr	蚥
jwj	蚧
jfw	蚨
jqn	蚫
jnx	蚭
jwa	蚮
jmg	蚰
jgu	蚲
jxe	蚴
jsk	蚵
jmf	蚺
snj	蚻
jhc	蚾
jyg	蛀
jdc	蛂
jdg	蛄
jpx	蛇
nhj	蛋
jma	蛐
jct	蛑
jtk	蛒
jlk	蛔
jff	蛙
jri	蛛
jve	蛝
jyw	蛟
jee	蛠
jng	蛡
jua	蛢
jwg	蛤
jqq	蛥
jgx	蛦
jmr	蛧
jgc	蛭
jgv	蛵
jgi	蛷
jie	蛸
jce	蛹
jdw	蛺
jwk	蛻
jlh	蛼
jmy	蛽
jtr	蛾
lqj	蜀
jtd	蜂
jhq	蜆
rrj	蜇
jkg	蜈
jeb	蜉
jke	蜎
jtb	蜏
jtf	蜓
jql	蜔
jsw	蜙
jnd	蜛
pnt	蜜
jyc	蜟
jlt	蜠
jbl	蜢
jjx	蜫
jbi	蜬
jqe	蜭
jak	蜮
ecj	蜰
jrt	蜱
jtv	蜲
jjs	蜾
jpq	蜿
jcc	蝃
jmu	蝄
jiw	蝋
jtu	蝌
jvc	蝍
jjh	蝐
wyj	蝕
jrg	蝗
jyn	蝙
jqm	蝜
jle	蝟
jus	蝤
nfj	蝨
jrb	蝬
jtj	蝮
jde	蝴
jan	蝶
jmn	蝸
jjl	蝹
jfm	蝻
uqf	螀
jyv	螂
jwn	螄
jex	螇
jdr	螈
juv	螊
jeh	螋
gkm	融
jut	螏
jtl	螕
jme	螖
jov	螗
jrq	螝
jco	螞
jpj	螟
juw	螠
jwh	螩
jon	螰
jpw	螲
jip	螳
jsf	螵
anj	螶
jlr	螹
jlx	螺
jlv	螻
jyx	蟀
jla	蟈
jav	蟏
jad	蟒
jhx	蟕
jfk	蟛
jia	蟝
jto	蟠
jnn	蟤
jam	蟥
jkk	蟬
jrl	蟱
jva	蟳
jbk	蟶
gej	蟸
jyl	蟺
jug	蟻
jfu	蟽
jqd	蟾
juq	蠀
jxg	蠅
jlg	蠉
jlq	蠋
jjq	蠍
joo	蠑
jap	蠓
jfd	蠕
jal	蠛
jll	蠝
jvl	蠟
jda	蠣
jyf	蠩
ejj	蠫
jat	蠮
jmm	蠳
aqa	蠶
tld	血
tln	衄
tli	衆
tla	衊
tgs	行
tsy	術
tnk	衛
tvd	衟
tqd	衡
yeu	衣
puc	衩
pub	衪
pue	衫
pup	衴
fke	袁
eky	袈
yqn	袌
puq	袍
pux	袎
pum	袖
yrw	袠
puh	被
xye	袰
yqq	袲
fye	裁
puk	裎
yem	裔
puw	裕
ykc	裛
pug	補
yqg	裦
pur	裨
puj	裸
rmh	製
jse	褁
puy	褊
yrq	褢
pud	褥
yco	褭
yli	褱
puo	褲
pun	褶
yfw	褻
ykk	襄
put	襖
pus	襟
pui	襠
pua	襪
pul	襬
puu	襯
svf	要
stt	覆
hqb	見
chq	覌
fwh	規
hqr	覐
ehq	覓
pyh	視
hkh	覘
qih	覙
reh	覛
foh	覝
hqh	覞
tvh	覣
ush	親
hao	覷
hqt	覹
akk	觀
qeh	角
tqe	觕
hxq	觜
udq	觠
qmf	觴
yyy	言
ysh	訂
yhy	訃
vyd	訄
yvn	訅
qyd	訇
yfh	計
ynf	訊
yqy	訋
yag	訌
ycy	訍
ygf	訏
ybn	訑
ykh	訓
myf	訔
ymh	訕
yta	託
ynn	記
uyd	訚
ywx	訛
ywv	訜
yah	訝
yxh	訠
yrh	訢
yrr	訤
ymw	訥
ypq	訦
yhg	訨
yyt	訪
yit	訬
ywc	設
yga	訮
yby	訯
ygb	訰
ytf	許
yry	訴
ylg	訵
ysk	訶
ysy	訹
ywe	診
ygh	証
hxy	訾
yhx	訿
yhk	詀
ydg	詁
ywf	詂
yyx	詃
yqa	詆
ymd	詇
lyf	詈
ykq	詋
yxe	詏
ypx	詑
yck	詒
yfc	詓
yvk	詔
ygu	評
yhc	詖
ymk	詗
ybm	詘
ydc	詙
yjg	詚
yeg	詛
yps	詝
yng	詡
yqj	詢
yxj	詣
ywn	詤
yaa	試
yff	詩
ypt	詫
yrg	詬
yqd	詭
yfk	詰
ytd	話
yug	詳
yoy	詸
qdw	詹
ytk	詻
ydo	詼
ybg	誀
yua	誁
yqi	誂
ydi	誄
yri	誅
ydf	誇
ygc	誈
yfn	誌
yvy	認
yqt	誑
yct	誒
yth	誕
yfp	誖
ytj	誗
ygv	誙
yie	誚
yvp	誛
ycw	誜
ygk	語
ydn	誠
ykg	誤
ytx	誨
ywk	說
yuk	説
yjs	課
ypf	誴
yrd	誵
yyw	誶
ymu	誷
yhd	誹
ysw	誺
yij	誻
ype	誼
yeq	誽
ymf	調
yrt	諀
ycc	諁
yqe	諂
yss	諃
yoo	談
ytv	諉
yqo	諊
yge	請
yqv	諍
ybc	諏
ywg	論
ypg	諚
yew	諛
yan	諜
ypl	諢
ymn	諣
ytg	諥
ygl	諫
yuq	諮
yln	諰
ysf	諲
yfm	諵
yft	諸
yut	諺
yad	諾
yaf	謀
yjq	謁
yle	謂
yjt	謃
yqb	謅
yay	謊
yop	謎
yeh	謏
yex	謑
yha	謔
ylw	謖
yyu	謗
yuv	謙
yuw	謚
yam	講
ydr	謜
ytm	謝
yqr	謠
yer	謡
ytl	謥
yyr	謧
yaj	謨
ygm	謮
ylp	謰
ylv	謱
yxf	謴
ynr	謵
ygq	謸
yak	謹
yjl	謾
yfj	謿
yul	譄
ycn	譎
yus	譐
yrl	譕
yaq	譖
yuj	識
ysj	譚
yuo	譜
yxg	譝
yma	譨
yea	譭
ylf	譯
yfd	譳
yog	譵
yaw	護
yue	譾
ydh	譿
yfl	讀
yqm	讂
yll	讄
yxx	變
yqk	讒
yyk	讓
ybe	讔
ybb	讘
yip	讜
yyn	讠
ypj	谉
gku	豆
gei	豕
ueu	豙
gew	豛
gec	豝
geq	豞
qke	象
gev	豤
ger	豨
gen	豭
ged	豲
mge	豳
ety	豸
eqy	豹
eft	豺
evk	貂
ews	貅
ete	貈
edj	貊
erq	貌
ejf	貍
eal	貓
etl	貔
hmu	貞
cmu	貟
qmu	負
mft	財
amu	貢
aym	貣
mbn	貤
wvm	貧
wxm	貨
mrc	販
xfm	貫
gmu	責
mps	貯
anm	貰
hxm	貲
afm	貳
khg	貴
cdm	貵
mtp	貶
lmu	買
mtg	貹
mkq	貺
xjm	費
mck	貽
ekm	賀
fam	賁
mtk	賂
myn	賅
uqw	資
smu	賈
mtl	賉
mof	賍
mdx	賎
mmy	賏
mwf	賒
pnm	賔
mgi	賕
mjq	賜
muk	賠
flm	賣
maa	賤
rrm	質
mde	賬
mpl	賱
muv	賺
mam	購
paw	賽
mmt	贁
mdy	贆
mul	贈
mqd	贍
mvh	贐
mdn	贓
mfl	贖
mip	贘
fww	赍
fou	赤
foq	赥
fot	赦
foj	赨
fof	赫
fhu	走
fuy	赱
fhh	赴
fhm	赸
fhr	赾
fhe	趄
fhv	超
fhg	越
fhj	趕
fhi	趟
fhb	趣
fhp	趤
fhq	趨
fht	趲
khu	足
khw	趴
khh	趾
khr	跌
khq	跑
kha	距
khv	跟
khd	跨
khi	踏
khj	踢
khe	踩
kho	踱
khc	踴
lrk	蹔
kht	蹤
khm	蹦
khf	躊
khs	躚
khp	躥
tmd	身
lgh	車
lnn	軋
lvn	軌
plj	軍
lkf	軎
lgq	軏
ldy	軑
lfh	軒
lvy	軔
lmh	軕
lgg	軖
lhc	軙
ldb	軛
lmw	軜
lqa	軝
ltf	軞
lqw	軟
lkq	軦
lxe	軪
lwe	軫
lag	軭
lgu	軯
lqn	軳
ldc	軷
lmg	軸
lkw	軹
lvk	軺
lsk	軻
lrw	軼
laa	軾
lua	軿
ldm	輀
awl	輂
lyw	較
lig	輄
lte	輈
flx	載
lgc	輊
lie	輎
lsg	輏
lpf	輐
lbn	輒
lqk	輓
lge	輔
lgv	輕
leq	輗
lbc	輙
lgm	輛
lvl	輜
lcc	輟
ljs	輠
lqe	輡
ljx	輥
lph	輨
hdh	輩
lyk	輬
lkb	輯
ldw	輳
ljq	輵
lus	輶
lwg	輸
ltj	輹
ljl	輼
lcd	輽
lna	輾
elg	輿
llw	轀
lpd	轄
lon	轆
lgj	轉
llp	轋
lfv	轌
lyc	轍
ltd	轎
lnb	轏
log	轐
ldu	轑
lfa	轒
lto	轓
loq	轔
lfd	轜
lah	轞
lrx	轢
ldt	轣
lha	轤
lau	轥
ldg	轱
ltu	轷
ufj	辛
duf	辜
cku	辝
thu	辠
ude	辦
udx	辮
udy	辯
dfe	辱
ehu	辵
gpd	辷
bpe	辸
vpe	辺
fpk	辻
typ	込
mpk	辿
gfp	迂
fnp	迃
tnp	迄
nfp	迅
bpv	迆
npe	迉
epd	迌
qbp	迎
dyp	迏
rpk	近
ywp	迒
rcp	返
gdp	迗
hkp	迠
nxp	迡
anp	迣
mkp	迥
ekp	迦
jhp	迧
ckp	迨
mpd	迪
rpd	迫
ygp	迬
rwp	迭
qhp	迯
syp	述
pxp	迱
fcp	迲
lkp	迴
opi	迷
uap	迸
qqp	迻
qjp	迿
vep	退
udp	送
qip	逃
fbp	逇
tmk	逈
iep	逍
tbp	透
gep	逐
wgs	途
ypd	這
ceh	通
gkp	逜
rrp	逝
kgp	逞
tfk	造
cwt	逡
tdh	逢
lpk	連
ajp	逪
vip	逮
mfk	週
wyp	進
tvp	逶
uep	遂
hmp	遉
plp	運
ynm	遍
mnm	過
nhf	遐
rgp	遑
nka	違
rha	遞
fkw	遠
jnp	遢
gma	遭
oao	遮
lvp	遱
sdn	遷
nna	選
kku	遻
duj	遼
ryt	邀
lgk	還
vlr	邋
kcb	邑
sbh	邒
nbh	邔
vkc	邕
mbh	邖
fbh	邗
gfb	邘
vbh	邚
abh	邛
fwb	邞
wvb	邠
ybh	邡
gab	邢
ngb	那
rbh	邤
dtb	邦
obh	邩
qkb	邭
afb	邯
ckb	邰
rgb	邱
vkb	邵
uxb	邶
qay	邸
ffb	邽
rib	邾
fkb	郆
qjb	郇
thb	郋
ffk	郌
kkb	郘
gkb	郚
ebb	郛
fob	郝
ukb	部
ykb	郭
oob	郯
bcb	郰
uab	郱
ssb	郴
hnv	郻
ajv	郾
nhb	郿
uxe	鄁
kkf	鄂
sfb	鄄
plb	鄆
xty	鄉
xtr	鄕
kmb	鄖
kfl	鄙
xbh	鄳
sgs	酊
sgq	酌
sgn	配
sgb	酏
isg	酒
sgr	酗
sgw	酚
sgp	酡
fsg	酨
sgx	酯
sgf	酵
sgt	酷
sge	酹
sgu	醅
sgy	醉
sga	醋
sgj	醒
tos	醔
sgo	醚
sgl	醞
atd	醫
toi	釆
tom	釉
tol	釋
tgj	重
jfc	野
jgj	量
fit	釐
qqq	金
qnn	釓
qjh	釗
qsh	釘
qet	釛
wrf	釜
qfh	針
qwy	釟
qwn	釠
wqf	釡
qqy	釣
qiy	釥
qkg	釦
qkh	釧
qbg	釨
qag	釭
qvy	釰
qcy	釵
qfg	釷
qvg	釹
qrh	釿
qcn	鈀
qyt	鈁
qpq	鈂
qga	鈃
qeg	鈅
qwc	鈆
qfw	鈇
qmw	鈉
qny	鈊
qwx	鈋
qnw	鈌
qgb	鈍
qxh	鈏
qrc	鈑
qby	鈒
qit	鈔
qnh	鈕
qwv	鈖
qcq	鈗
qfc	鈘
qsy	鈢
qgh	鈣
qjg	鈤
qoy	鈥
qfq	鈨
qyy	鈫
qnx	鈮
qbm	鈯
qym	鈰
qsk	鈳
qgm	鈵
qck	鈶
qdg	鈷
qdc	鈸
qhc	鈹
qhn	鈻
qdm	鈽
qmg	鈾
qlg	鈿
qlh	鉀
qwe	鉁
qrw	鉄
qan	鉅
qhk	鉆
qpx	鉈
qyx	鉉
qqn	鉋
qnt	鉍
qrg	鉑
qyg	鉒
qaf	鉗
qqt	鉚
qwf	鉜
qug	鉝
qgn	鉞
qmd	鉠
qsg	鉢
qxy	鉧
qek	鉫
qhg	鉬
qjy	鉵
qyw	鉸
qtk	鉻
qua	鉼
qct	鉾
qve	銀
qqj	銁
qyc	銃
qdi	銇
qwt	銋
qmm	銏
qgd	銒
qgx	銕
qqk	銘
tqg	銜
qws	銝
qfi	銢
qvk	銣
qye	銥
qig	銧
qpv	銨
qde	銪
qqc	銫
qdx	銭
qxi	銯
qar	銰
qjf	銲
qwk	銳
qgi	銶
qie	銷
qux	銻
qww	銼
qqa	銽
qai	銾
qce	銿
qkk	鋁
quf	鋅
qmy	鋇
qfp	鋍
qpf	鋎
qpd	鋐
qcw	鋑
qtd	鋒
qev	鋖
qgv	鋞
qvp	鋟
qeb	鋢
qhq	鋧
qge	鋪
tjq	鋫
qdn	鋮
qdq	鋴
qbc	鋷
qnd	鋸
qjs	錁
qxg	錄
qud	錈
qee	錋
qrt	錍
qqe	錎
qbs	錒
qjx	錕
qvl	錙
qqv	錚
qdf	錛
qpg	錠
qds	錡
qaa	錢
qcc	錣
qrm	錦
qph	錧
qal	錨
qma	錪
qjq	錫
qgj	錬
qso	錰
qvi	録
qbl	錳
qsw	錸
qhe	錹
qqg	鍂
qxx	鍇
qgl	鍊
qmn	鍋
qoa	鍍
qrf	鍎
qnk	鍏
qpl	鍕
qmj	鍘
qwd	鍛
qjm	鍝
qhm	鍞
qjt	鍟
qdh	鍥
toq	鍫
qln	鍶
qft	鍺
qwh	鎀
qir	鎃
qlw	鎅
que	鎆
qjn	鎉
qyu	鎊
quv	鎌
qer	鎐
qpw	鎔
qim	鎖
qub	鎙
qji	鎤
qrs	鎩
quw	鎰
qth	鎳
qco	鎷
qpy	鎺
qvm	鎻
qmt	鎽
qhl	鏀
qvj	鏁
qxf	鏆
qlp	鏈
qjl	鏝
qut	鏟
qsf	鏢
qlv	鏤
lrq	鏨
qlr	鏩
qme	鏰
qul	鏳
qxk	鏹
qvf	鏽
qae	鏾
qff	鐃
qbj	鐊
qij	鐋
qus	鐏
qdu	鐐
qsj	鐔
qaq	鐕
quj	鐘
qva	鐞
quo	鐠
qxj	鐨
qlq	鐲
qfl	鐳
qfk	鐵
qlf	鐸
qfa	鐼
qfu	鐽
qep	鑀
qfn	鑄
qgw	鑈
qaw	鑊
mmq	鑍
qpn	鑏
qah	鑑
qrr	鑕
qll	鑘
qat	鑝
qrx	鑠
qhb	鑡
qon	鑣
qja	鑤
qqo	鑥
qpa	鑧
qha	鑪
qwg	鑰
qyk	鑲
qbb	鑷
qhh	鑺
qsr	鑻
qlx	鑼
qtf	鑽
qni	钃
qau	钄
qnr	钖
qak	钷
qkm	铞
qad	锘
qrq	锨
qqr	锪
quk	锫
deu	長
dcq	镹
dct	镺
dcr	镻
dcd	镽
uhn	門
ute	閁
ugd	閂
uwi	閃
udd	閆
ufk	閈
uft	閉
uye	閍
udc	閎
usi	閑
ued	閒
ujd	間
uyi	閔
uii	閖
ulk	閘
uym	閙
uud	閚
unt	閟
uyn	閡
utk	閣
uwa	閥
uff	閨
usd	閪
uls	閫
uyv	閬
uwk	閱
ujj	閶
rsu	閷
udj	閹
ujy	閺
uqe	閻
uqa	閽
usv	闄
uit	闊
ugl	闌
uri	闎
ufc	闔
uub	闕
uip	闛
uxx	關
umt	闝
unb	闞
ufu	闥
bet	阞
bnf	阠
bgq	阢
btn	阣
bbn	阤
biy	阥
buf	阧
bdb	阨
bdh	阫
byw	阬
bcq	阭
bfq	阮
bhg	阯
bfj	阱
byt	防
bqa	阺
bth	阼
bsk	阿
bpx	陀
bhc	陂
bwf	附
bqq	陊
bgm	陋
bdj	陌
bta	降
bri	陎
bde	陏
bve	限
bcw	陖
bie	陗
bgv	陘
bxx	陛
bdw	陜
bdt	陝
bhh	陟
bfh	陡
bpf	院
blh	陣
bwg	除
bqh	陥
buk	陪
bhd	陫
bbc	陬
bds	陭
bwy	陰
bqo	陱
btf	陲
bgj	陳
brt	陴
bfw	陵
bqr	陶
bqe	陷
bsf	陻
bft	陼
bjg	陽
bad	陿
baj	隁
bwd	隂
bjm	隅
btg	隆
bdg	隇
bda	隋
brg	隍
buv	隒
bgk	隔
bkm	隕
bwn	隖
brq	隗
buw	隘
bij	隙
bip	隚
buj	障
bvj	隟
bev	隠
but	隡
bff	隢
boq	隣
bnk	隦
bue	隧
btm	隩
bfa	隫
bgw	隬
byu	隮
bfn	隯
bjx	隰
bea	隱
bit	隲
bha	隵
dww	雁
dcw	雄
wys	集
tdw	雉
wyh	雋
hxw	雌
yxt	雍
egw	雎
tkw	雒
kjw	雖
mya	雘
wyw	雙
yrb	離
fvf	雪
fsu	雬
fyu	雯
fyr	雱
ffc	雲
fuf	雴
fwy	零
flf	雷
fqn	雹
fdm	需
fis	霂
fie	霄
fyf	霅
ftf	霆
fdf	震
fig	霈
ffo	霊
fgv	霋
fmf	霌
fuv	霎
fhd	霏
fix	霐
fih	霑
feq	霓
fiy	霔
fss	霖
fsh	霜
fnh	霞
fia	霟
fey	霡
fer	霢
fnr	霫
fae	霰
fbt	霳
fak	霸
fnk	霹
fma	霻
fej	霾
fap	靀
fdt	靂
fyj	靄
fkk	靈
fid	靋
gef	青
uge	靖
gee	靜
akf	革
pva	鞌
ujf	音
ujv	韶
ujb	韷
ujt	韸
ujr	韹
uja	韺
ujk	韻
dmu	頁
sdm	頂
adm	項
kdm	順
edm	須
hdm	頉
gdm	頊
dbd	頋
wcd	頌
fcd	頍
ywd	頏
fqd	頑
wvd	頒
gbn	頓
hcd	頗
cfd	頚
pvd	頞
tkd	頟
fkd	頡
hah	頥
qid	頫
fod	頳
xfi	頴
tbd	頺
hhd	頻
twd	頽
ehx	頿
wyd	顀
ood	顃
jsd	顆
lnd	顋
jgh	題
ptk	額
yde	顏
pld	顐
ody	類
ynw	顧
ylk	顫
jxx	顯
ghw	颪
dyd	飆
wrn	飏
wro	飚
nut	飛
wyv	食
wyr	飯
wyq	飲
wym	餇
ufw	養
wyb	餌
hqc	餐
wya	餞
wyl	餵
wyx	饑
qnb	饣
qnc	馂
qnj	馃
qns	馇
qnm	馉
qnf	馌
qna	馓
uth	首
tjf	香
tjw	馚
tjd	馛
tje	馟
tjj	馤
tjt	馥
tjp	馪
coi	馬
uco	馮
cor	駁
cov	駋
coy	駐
vcc	駑
coq	駒
coe	駔
ekc	駕
cok	駛
cop	駝
com	騁
coj	騍
cod	騎
eud	騰
coc	騷
coo	騼
col	騾
cos	驃
coa	驅
cof	驍
con	驏
cot	驕
cow	驗
cob	驟
coh	驢
cou	驥
cog	驪
cgj	驲
cgl	骃
cgc	骉
cgu	骍
cgv	骎
cgp	骔
cgw	骙
cgf	骦
mef	骨
meh	骳
mes	骵
meq	骶
mey	骸
met	骼
meu	骿
mej	髁
meo	髍
men	髎
mel	髏
mea	髒
med	髓
mem	體
mep	髖
ykm	高
dce	鬃
hgg	鬧
obx	鬯
rqc	鬼
fcr	魂
tvr	魏
qox	魮
qoj	魯
qod	魷
qoc	鮐
qoq	鮑
qow	鮒
qop	鯇
qom	鯛
qob	鯫
qov	鯽
qor	鰉
qok	鰐
qol	鰓
qoe	鰩
qos	鰾
qof	鱈
qoo	鱗
qog	鱷
qoh	鱸
qgs	鲄
qgg	鲆
qgt	鲊
qgr	鲌
qgf	鲼
qgy	鳊
qgc	鳋
qgo	鳙
vwv	鳩
cwv	鳮
wdh	鳳
wvw	鳻
dhw	鴀
pqw	鴆
vcw	鴑
ntw	鴓
caw	鴘
qbw	鴛
qkw	鴝
jgw	鴠
xew	鴢
dwv	鴣
lwv	鴨
xjw	鴲
pvw	鴳
qiw	鴵
riw	鴸
vkw	鴽
wsw	鵂
yow	鵉
evw	鵎
kew	鵑
eew	鵬
qew	鵮
ajw	鵲
oow	鶑
ujw	鶕
tow	鶖
dew	鶘
plw	鶤
nhw	鶥
pwy	鶴
mew	鶻
tuw	鷑
nwe	鷚
lvw	鷜
iex	鸂
mmw	鸎
wbq	鸧
alq	鹋
vij	鹔
nhq	鹛
qyn	鹱
hlo	鹹
onj	鹿
sww	麥
agm	黃
tqt	黎
twi	黏
lfo	黑
jfo	黒
xhn	黽
fqx	黿
fcx	鼁
ffx	鼃
rix	鼄
hnd	鼎
bhn	鼐
fku	鼓
qif	鼗
enu	鼠
thl	鼻
hbj	齒
hbx	齔
hba	齖
hbr	齗
hbh	齜
hbc	齝
hbe	齟
hbw	齡
hbq	齣
hbv	齦
hby	齩
hbk	齪
hbl	齫
hbd	齮
hbb	齱
hbt	齲
hbp	齳
hbu	齴
hbn	齷
hbf	齻
hbs	齼
hwb	龁
oue	龐
txd	龜
ttx	龝
lhk	㐃
vnb	㐇
fnb	㐊
enb	㐍
ynb	㐎
gnb	㐏
mnb	㐕
onb	㐘
oln	㐣
wkg	㐰
wer	㐱
wqy	㐴
wnn	㐶
wbm	㑁
wxy	㑄
wjc	㑠
wlq	㑩
rwu	㒵
phu	㓀
udg	㓈
uyc	㓍
ybk	㓙
ajh	㓚
hcj	㓟
hkj	㓠
vlj	㓯
soj	㔄
dxb	㔫
arh	㔸
fet	㔹
hlk	㔽
mbb	㕀
dud	㕇
ccu	㕕
cyy	㕚
wkf	㕣
kvn	㕤
knt	㕧
kyt	㕫
ksy	㕲
kgg	㕵
krg	㕷
ikx	㕾
kvg	㖀
kjx	㖂
wjk	㖋
koh	㖢
kbi	㖤
kvi	㖨
kbc	㖩
kec	㖬
kxm	㖰
qko	㗮
ksl	㘄
lee	㘞
llk	㘡
lij	㘤
fal	㙹
dbj	㚎
ddu	㚐
vdu	㚑
dsu	㚓
dqk	㚚
vvf	㚣
vot	㚧
vlg	㚼
vqn	㚿
vrc	㛂
vof	㛇
vsg	㛉
vws	㛊
vrd	㛓
vmy	㛝
vdj	㛪
vpo	㛮
vsj	㜁
vna	㜊
vea	㜒
vlq	㜛
lrv	㜞
vlv	㜢
vlm	㜥
vrx	㜰
vrr	㜱
vhh	㜹
vbf	㜽
pcu	㝊
pbj	㝋
pqy	㝌
ppu	㝎
pnc	㝕
pth	㝚
pam	㝤
pfk	㝨
gni	㝳
nci	㞋
nbd	㞌
ncv	㞎
nud	㞐
bhw	㞣
mwu	㞤
mbr	㞧
mbg	㞨
vmj	㞪
mpu	㞫
nmj	㞯
mjf	㞱
mkh	㞲
myu	㞵
myy	㞶
mxy	㟂
mwx	㟆
mku	㟕
mra	㟛
mvi	㟤
mcd	㟥
mll	㠥
hnn	㠯
mhx	㠲
mhv	㠴
oai	㡲
oud	㡴
okw	㡶
oyd	㢇
ods	㢊
obs	㢌
oxt	㢕
onl	㢞
hpv	㢟
xmh	㢫
xlr	㢴
xmq	㢷
xum	㢼
tdy	㣕
nyu	㣺
vnu	㣽
nyt	㤃
nrc	㤆
nvi	㥆
nbk	㥛
eav	㥯
nog	㦠
nrx	㦡
nlx	㦬
rvt	㧅
rxn	㧈
xjt	㪄
jst	㪙
ygj	㪯
ywy	㫃
jxb	㫐
jet	㫑
jaj	㫒
jbf	㫗
jkq	㫛
jbh	㫞
jqj	㫬
jrm	㫼
jim	㫾
jck	㬃
jpy	㬕
jul	㬝
jwi	㬰
sbt	㭁
siy	㭂
scq	㭇
asu	㭉
sca	㭓
slf	㭗
sqm	㭥
sle	㭷
hlw	㮚
scl	㮭
seh	㮴
xsd	㯋
slq	㯮
mqw	㰞
ckq	㰧
hsk	㱒
iwn	㲹
ian	㲺
piu	㲾
iot	㲿
iay	㳀
ilh	㳌
iye	㳖
isv	㴗
ibx	㶌
iuc	㶒
woi	㶡
ovb	㶢
oxe	㶭
oef	㷐
oyo	㷜
omt	㷨
obb	㸎
tfh	㸩
tkh	㸪
trh	㸫
tcn	㸭
tmy	㸽
gcy	㺨
ghy	㺪
gdu	㺯
gvo	㻏
gbc	㻓
glv	㻲
glq	㻿
drc	㼋
let	㽖
lwy	㽗
ufd	㽵
unv	㽶
upq	㽸
urc	㽹
umd	㾄
uhd	㾇
uqd	㾣
urh	㾷
rcu	㿝
hcv	㿪
psl	㿾
qhd	䀏
het	䀐
htx	䀲
hyv	䀶
hle	䁌
hsv	䁏
hkb	䁒
hrb	䁓
her	䁘
hjp	䁙
hkm	䁚
hrq	䁛
hji	䁜
hyu	䁤
hul	䁬
hlm	䁲
hyl	䁴
hnk	䁹
hel	䂃
tdv	䂏
dxn	䂗
dbh	䂙
day	䂝
tbh	䄦
tbt	䄧
stu	䅇
unn	䇃
uay	䇅
uvi	䇐
tau	䇝
tdf	䇢
tsf	䇴
tkc	䇼
tyf	䇾
tbv	䈨
eou	䊆
ops	䊉
ome	䊘
xvn	䊵
xhg	䊼
xsy	䊾
xmr	䋄
xvg	䋖
xoy	䋛
xnd	䋧
xqg	䋮
xsv	䌁
xov	䌅
xnr	䌌
xbb	䌰
lfj	䍐
lsu	䍒
lou	䍘
lld	䍛
lrb	䍟
ngf	䍿
dng	䎁
beg	䎳
tob	䎹
brm	䎺
bvi	䎼
bpu	䏁
vin	䏋
wef	䏌
cef	䏍
exh	䏖
eit	䏚
egs	䏞
eqq	䏧
ebg	䏪
eie	䏴
euk	䏽
eds	䐀
ejx	䐊
evc	䐚
eim	䐝
exu	䐞
etm	䐿
enk	䑀
atu	䒘
ayf	䓂
afo	䓇
abl	䓝
acl	䓿
avo	䔥
abd	䔺
aor	䕇
tju	䖝
jfy	䖞
jjy	䖵
juo	䗒
jos	䗫
sdu	䙲
pxh	䙾
ybt	䚮
yjh	䚯
yxn	䚰
yiy	䚱
yet	䚲
qyf	䚻
yrc	䛀
ylh	䛅
ymg	䛆
yvj	䜈
esy	䝗
eia	䝣
jcm	䝨
mim	䞆
mjj	䞎
lwn	䡄
lql	䡘
llh	䡛
lue	䡵
lth	䡻
leg	䢁
bpd	䢊
egp	䢐
mpi	䢙
wbh	䢳
vlb	䣎
qlk	䤧
qbi	䤴
qpo	䤹
qcl	䥁
pjj	䥌
qlc	䥯
qpe	䥱
qng	䦀
urk	䦐
bvk	䧂
blg	䧃
bsg	䧈
bhq	䧋
bke	䧎
bov	䧜
bog	䧤
fxc	䨎
fnf	䨒
ohd	䨾
pqd	䪴
kvw	䬭
cgk	䯄
cgb	䯅
liw	䳴
hbm	䶡
dggg	三
ghnn	丏
ghnv	丐
vygf	丒
dhgf	丕
gkgd	丗
uxgf	丠
gmmk	両
gjan	丣
hhll	丨
uygh	丬
njhg	丱
kkjk	丳
yyll	丶
fjyi	丼
ttll	丿
thff	乍
tufk	乎
rgyu	乓
rfmh	乕
tfux	乖
tgai	乗
nnll	乙
ghnb	乤
tunb	乥
ufnb	乧
cknn	乨
hknn	乩
eknb	乫
annb	乬
tufn	乯
ebnn	乳
rrnb	乴
ufnn	乵
gehn	乶
iitn	乷
rnrn	乺
ywun	乻
iygn	乼
fjfn	乾
exin	乿
qjjn	亀
oqan	亃
cnhj	予
guvh	亊
ghng	亙
hxff	些
gkjg	亜
cccf	亝
gfgd	亞
ywru	交
yntw	亥
ykbj	亨
yoyu	亪
ykbf	享
ykps	亭
ykpw	亮
ykjf	亯
yjiu	亰
ywjg	亱
ykpa	亳
ykpv	亴
ylkg	亶
utvo	亷
ykbl	亸
yemg	亹
wwww	人
wtan	仛
wvyy	仞
wtfh	仟
wtnn	仡
wqyy	仢
wayy	代
nywy	以
hgwu	仧
whgg	仩
wtcy	仫
wrcy	仮
witt	仯
wwyn	仱
wxxn	仳
wtgh	件
wtdy	仸
wdhh	仹
wagf	仺
wtfg	任
wwvt	份
wgxg	仾
wwcy	伀
wgmh	伂
wcnh	伃
wxhh	伄
wgbn	伅
wqrt	伆
wbyy	伋
wdbn	伌
wfcy	伎
wdyy	伏
wdhy	伓
wpwn	伔
wfwy	伕
wdcy	伖
wvfh	伜
waht	伢
wmqn	伣
wqug	伨
wnyy	伬
wvcy	伮
wwiy	伱
wnxn	伲
wann	伳
wugh	伴
wegg	伹
wngk	伺
wguf	伻
wnyw	似
wdhg	伾
wkwy	伿
whnn	佀
wckg	佁
wghg	佂
wafg	佄
wfiy	佅
wjgg	但
wpsh	佇
wdmh	佈
whcy	佊
wvkg	佋
whxn	佌
wmdy	佒
wntt	佖
wpxn	佗
wrwy	佚
wqkg	佝
wfvg	佞
wtuy	佟
wwmh	佡
wang	佢
wgny	佤
whgh	佧
wqnn	佨
wlkg	佪
wtkg	佫
wftx	佬
wtah	佭
wwgk	佮
wdjg	佰
wfhf	佱
wffg	佳
wuah	併
wfkg	佶
wvey	佷
wtdg	佸
wqdb	佹
wwgg	佺
wqiy	佻
wywr	佼
wuqw	佽
wgkr	使
wgaj	侀
wtfq	侁
wota	侂
wkkn	侃
wgxw	侇
wqqy	侈
wdfn	侉
wigq	侊
wync	侌
wffy	侍
wriy	侏
wtlg	侐
wdeg	侑
wpvg	侒
wvgh	侓
wctg	侔
wdmj	侕
wgma	侖
wmgk	侗
wpta	侘
waay	侙
wqjg	侚
wawy	供
wtey	侜
wdhb	侟
wgmf	侢
wftn	侤
wynv	侫
wnyu	侭
wntd	侯
wvtk	侰
wkgg	侱
wdfe	侲
wgnj	侴
wvpc	侵
wktk	侶
wnnk	侷
wtfp	侹
wmwn	侺
wukq	侻
wfpb	侼
wlet	侽
wftb	侾
wevg	俀
wknd	俁
wtxi	係
wtry	俄
wgiy	俅
wwgs	俆
wqtg	俇
wtfk	俈
wgkg	俉
wkcn	俋
wgey	俌
wweg	俎
wtjh	俐
wceh	俑
wpfq	俒
wgva	俓
whqn	俔
wpsy	俕
wdhk	俖
wwwk	俗
wrdh	俙
wjfg	俚
wqkq	俛
wmgn	俜
wgej	俞
wctd	俟
wdww	俠
wtet	俢
wuxt	俤
wfny	俧
wgus	俫
whwy	俱
wywe	俲
whdd	俳
whgc	俶
wecn	俷
wdwg	俸
wgfg	俹
wyce	俼
wrqw	俽
wrtf	俾
whaw	俿
wdey	倀
wtgf	倂
wthk	倃
wrde	倄
wywf	倅
wpqb	倇
wsww	倈
wyvk	倉
wwcn	倊
wphn	倌
wmaw	倎
whto	倐
wooy	倓
wfuf	倖
weeg	倗
wdsk	倚
wadw	倛
wmfk	倜
fjfw	倝
wyki	倞
wwyg	倠
wjjg	倡
wgvh	倢
wyty	倣
wfhn	値
wpwa	倥
wpfi	倧
wndg	倨
wgeg	倩
weqn	倪
wwga	倫
whjf	倬
wtvg	倭
wjsy	倮
wswc	倯
wfwt	倰
wjxx	倱
wgji	倲
wgkh	倳
wdfa	倴
wfhy	倵
whgw	倶
wdfi	倷
wesy	倸
wbbh	倻
wwfk	倽
wuvg	倿
wamd	偀
wemf	偁
wuej	偂
wdmd	偄
wdwj	偆
wjqn	偈
wnkh	偉
wtky	偊
wnua	偋
wadk	偌
wjgh	偍
wlge	偎
wyna	偏
wute	偐
wwtj	偑
wjgr	偒
wngf	偓
wftj	偖
with	偗
wkkk	偘
wyuh	偙
wtfe	偛
wuxe	偝
wans	偞
wrgg	偟
wsvg	偠
wadn	偡
wtoy	偢
wujg	偣
wusg	偤
wnhe	偦
wdqq	偧
whxs	偨
wqmy	偩
wtff	偫
wkbg	偮
wyke	偯
wdhd	偰
wrfh	偱
wlny	偲
wmdj	偳
wwgj	偷
wwgb	偸
whtl	偹
wthj	偺
whvh	偼
wyto	偽
wehc	傁
wrhw	傂
wgxi	傃
wduh	傄
wdri	傆
wabg	傇
wdff	傉
wkmy	傊
wamf	傋
wcoy	傌
wyuy	傍
wfhw	傎
wovk	傏
wykk	傐
wexd	傒
wynn	傓
wuvo	傔
wpwy	傕
wwyk	傖
wyxl	傗
wwwf	傘
wywt	傚
wpwk	傛
werm	傜
wjng	傝
wuga	傞
wyfy	傠
wuug	傡
wdwi	傣
wfly	傤
wmeg	傦
wcce	傪
wlxi	傫
wmwy	催
wgmj	傮
wtln	傯
wmee	傰
wtwh	傱
wgqt	傲
wakk	傴
wgmy	債
wtjr	傷
wdrr	傸
wujq	傹
wwfi	傺
wtlt	傻
wakw	傼
wxdm	傾
wgho	傿
waqh	僀
wton	僁
wlvg	僂
wsfi	僄
wakg	僅
wlpy	僆
wnwe	僇
wjlc	僈
wsdn	僊
wwym	僋
wlty	僌
wtge	働
wnnw	僎
wugk	僐
wtdk	僑
wkhm	僓
wusf	僔
wfkk	僖
wooe	僗
wimt	僘
wamw	僙
wdui	僚
wwgu	僜
wnbb	僝
weto	僞
wxxy	僟
wtol	僠
wgjn	僡
weph	僢
wfwj	僣
wkkl	僤
wyky	僦
wfam	僨
wueg	僩
wcnk	僪
wgfn	僫
wwyo	僬
waqj	僭
wujf	僮
woqh	僯
gmiw	僰
wyny	僱
wsqh	僲
wsoy	僳
wglg	僵
waas	僷
wssi	僸
wkks	僺
wnkf	僻
wmau	僼
wept	僾
wpaf	僿
wmae	儂
wylg	儃
wipl	儅
waqt	儆
wwgw	儉
wssh	儊
wqdy	儋
wryt	儌
wobt	儍
whqo	儏
wpgm	儐
wjxo	儑
wfkf	儓
wfnf	儔
wyuj	儕
wahl	儖
wxth	儗
wvhl	儘
wkhp	儙
walq	儚
wrlh	儛
wpns	儜
woos	儝
wgwr	儞
wvln	儠
wlll	儡
whan	儢
woaw	儣
wjai	儤
wflm	儥
wono	儦
wfwm	儧
wrrm	儨
wmjr	儩
wdet	優
wusq	儭
wdth	儮
wudo	儯
waeo	儰
wued	儱
wyfj	儲
wqky	儳
wmwk	儶
wgmx	儷
wlxy	儸
waky	儺
wipo	儻
wlli	儽
wgke	儾
tfqb	先
wcqb	兊
tkqy	兎
dhgq	兏
hjqb	児
aqaq	兓
hnmq	兕
fqck	兘
dqfk	兙
dqtf	兛
dqwv	兝
dqtn	兞
tfqq	兟
ruxq	兠
dqdj	兡
dqdf	兣
igqw	兤
tynv	兦
gmhy	兩
wgeb	兪
wgnb	兮
wvkx	兺
ulaw	兾
urvc	兿
mhgd	円
mnmb	冎
mwkd	冏
jkgf	冔
prxb	冟
pfeu	冡
pbcu	冣
pqky	冤
pjyw	冥
pssu	冧
pajh	冪
uaht	冴
uwyc	冷
uugh	冸
udcy	冹
unna	冺
utfq	冼
ugqj	冽
uvgh	冿
uqkq	凂
uwgs	凃
uldg	凅
uswc	凇
uevh	凈
ufwt	凌
ugji	凍
usfg	凐
umgu	凒
ussy	凓
upjw	凕
uwyf	凖
umwy	凗
uadr	凘
ulff	凙
uylt	凜
uxth	凝
utao	凞
uflm	凟
wmhk	凧
wfci	凨
wgjd	凬
wdjd	凮
wrgd	凰
wgkw	凳
ucow	凴
hghg	凸
bkcb	凾
tnjh	刉
tdjh	刋
qrjh	刎
rnjh	刏
myjh	刐
fqjh	刓
nwjh	刔
vvvr	刕
gqjh	列
xjjh	刜
puvt	初
egjh	刞
vkjh	刟
nnaj	刡
wycj	刢
ckjh	刣
fcjh	刦
fcvt	刧
fxyj	刬
gjgj	刯
gcfj	到
fjvw	刱
ffjh	刲
dfnj	刳
bsjh	刴
yntj	刻
fcvy	刼
gudj	刾
wsjh	剁
uxhj	剃
gvaj	剄
gkuj	剅
yvcj	剆
kejh	剈
wwfj	剉
dqjk	剋
gkij	剌
uejj	前
uavy	剏
ajjh	剒
tqtv	剓
jqrj	剔
aajh	剗
adwj	剘
uavw	剙
gkvj	剚
pqbj	剜
xgij	剝
dskj	剞
cccj	剟
ykij	剠
oojh	剡
geyj	剢
yjjh	剤
djnj	剦
dhdj	剨
oacj	剫
ngcj	剭
mnmj	剮
wgky	剱
mgkj	剴
uttj	剷
gjhj	剸
nwej	剹
meej	剻
akkj	剾
wyoj	劁
dubj	劂
twgj	劄
lqjj	劅
ouvj	劆
hagj	劇
nkuv	劈
kkkj	劋
hdgj	劌
wgkj	劍
wgkv	劎
yuhj	劑
rrmj	劕
qkxj	劖
tfqj	劗
ossj	劘
eeer	劦
qket	劬
vket	劭
rwet	劮
iper	労
uder	劵
uget	劷
ffet	劸
ywre	効
ctge	劺
aget	劻
fket	劼
ynte	劾
dqet	勀
tfke	勂
txet	勄
gkie	勅
cehe	勇
dqee	勊
udbe	勌
ykie	勍
uket	勏
blet	勐
swwe	勑
akfe	勒
xxre	勓
dmje	勔
jege	勗
cnhe	務
anme	勚
kmet	勛
wcne	勜
oope	勞
nwee	勠
sfie	勡
fwfe	勢
gmet	勣
xkje	勥
vjse	勦
rwye	勧
qkee	勨
tdke	勪
tole	勫
udxe	勬
hage	勮
ylke	勯
eeen	勰
ajme	勱
tgjo	勲
tgle	勳
tyce	勶
qwnv	匃
qynv	匄
qguf	匉
qrmk	匋
qdjn	匎
dfnn	匏
qgkl	匐
qtmx	匑
qawk	匒
qvcc	匓
qtmk	匔
xvtr	匘
jghx	匙
aqyi	匛
amhk	匝
aywv	匟
aqre	匢
agyi	匤
acak	匥
abhg	匩
aqrj	匫
alvv	匭
aiwy	匯
akkl	匰
akhm	匱
adkk	匲
atha	匴
aflm	匵
aawe	匶
ahhy	匷
awgk	匼
ajvd	匽
ayna	匾
akkk	區
aghh	卄
nhgh	卍
ywwf	卒
feee	協
fgef	博
yxxf	卛
hmng	卣
hlry	卥
ffhy	卦
hmnk	卨
rgbv	卮
qtbh	卯
qdbb	危
qqbh	卶
rhbh	卸
tlbh	卹
wwkb	卻
gqqb	卼
rxbh	卽
qtvb	卿
swib	厀
wgsb	厁
dtav	厇
ddxy	厐
dkxv	厑
drmk	厒
dffd	厓
dgcf	厔
ddny	厖
dufk	厗
dkrk	厛
dtfg	厜
dajd	厝
dhdd	厞
drii	原
dmjk	厠
dtti	厤
dubw	厥
dfhw	厧
dakg	厪
dgqt	厫
djtk	厬
dssy	厯
dimt	厰
dwgw	厱
idnt	厳
djel	厴
cccu	厽
nfci	厾
gmcu	叀
cccd	叄
fcec	叆
fcvp	叇
cccc	又
nhcy	収
nhcu	叏
tdci	叐
gkhc	叓
hgic	叔
nhfc	叚
pocu	叜
fcbc	叝
nfic	叞
ehcu	叟
hpgc	叡
kkkk	口
ktyy	叺
kngg	叼
ktfh	吀
ynkf	吂
gkri	吏
ktan	吒
kuhh	吖
kvtt	吚
knhf	吜
gdkf	吞
kdyy	吠
kxxn	吡
kwjh	吤
kwvt	吩
kwxn	吪
wynk	含
kdcy	吰
kfcy	吱
kxhh	吲
kmty	吶
knwy	吷
kwcy	吺
kqrt	吻
ktgh	吽
tgkf	吿
kaht	呀
kqug	呁
kdbn	呃
kngw	呉
tfkf	告
kfwy	呋
kufh	呌
knyy	呎
ktah	呏
tdkf	呑
kynn	呝
kngk	呞
kyxy	呟
ksgg	呠
knna	呡
kmfg	呥
kxet	呦
kqay	呧
kkqn	呪
khkg	呫
kann	呭
kkwy	呮
kguf	呯
hxkf	呰
krcy	呱
khxn	呲
kfiy	味
kqkg	呴
kvcy	呶
kdhg	呸
krwy	呹
kkgn	呺
kjgg	呾
kafg	咁
kamh	咂
kwbn	咃
kntt	咇
kxjh	咈
kmdy	咉
kthf	咋
kckg	咍
thkf	咎
kwfy	咐
krsh	咑
kgny	咓
khgh	咔
kdag	咗
kdmh	咘
ktuy	咚
kpxn	咜
kxxg	咝
kgah	咞
kdjg	咟
kkfn	咢
kigq	咣
kpta	咤
kgcf	咥
kgxw	咦
kgqj	咧
kugh	咩
kfkg	咭
kriy	咮
ktkg	咯
kqjg	咰
kudy	咲
kdoy	咴
kdfn	咵
ktdg	咶
kqiy	咷
kpvg	咹
kgjg	咺
kwsy	咻
mnmk	咼
kftx	咾
kkkf	品
kmgk	哃
kqrb	哅
kffg	哇
kwgk	哈
fkxy	哉
kdeg	哊
kfbn	哋
krey	哌
kvey	哏
kagg	哐
krhf	哖
ktgs	哘
kxwv	哛
kctg	哞
ktfk	哠
kgku	哣
kdny	哤
sksk	哥
ktry	哦
kfoy	哧
kjfg	哩
kkhy	哫
kwsk	哬
kptg	哰
kfpb	哱
rrkf	哲
krrh	哳
kyve	哴
kkej	哵
khgf	哶
kefy	哷
kevg	哸
kebg	哹
kgey	哺
kjfh	哻
kykb	哼
kukq	哾
eksk	哿
ktbt	唀
kwwk	唂
kqeh	唃
kkcn	唈
kdww	唊
kwgs	唋
kthp	唌
kpfq	唍
ktjh	唎
krdh	唏
kwwf	唑
kgkg	唔
krfh	唕
kfhy	唗
dckf	唘
kqto	唙
kvpc	唚
gskx	唜
kamy	唝
kruf	唞
fckx	唟
kgmw	唡
kran	唣
kuwc	唥
kiit	唦
kvcb	唧
kbeg	唨
ktvg	唩
kdwg	唪
khaw	唬
kadw	唭
knmj	唰
keqn	唲
kyny	唳
kufq	唴
kdjn	唵
kajg	唶
kyce	唷
kwyn	唸
kywu	唹
kmaw	唺
ksww	唻
kuvg	唼
ksrh	唽
kqrn	唿
kmfk	啁
kebn	啂
kheg	啃
yumd	啇
kfuf	啈
kssy	啉
kbsk	啊
kesy	啋
kpwa	啌
tfgk	啎
kywf	啐
kgvh	啑
knbm	啒
yntk	啓
ynak	啔
kqrm	啕
kqeg	啗
kpqb	啘
hxkk	啙
kflk	啚
kgvv	啛
ynkt	啟
khdd	啡
krhb	啣
kwfk	啥
krug	啦
kgeg	啨
kffh	啩
krrg	啪
klgy	啯
klqy	啰
kmdg	啱
krqy	啲
kudb	啳
kulh	啴
kihc	啵
kpgh	啶
kyvb	啷
kndg	啹
kjgr	啺
yupk	啻
kwga	啽
ktoy	啾
kadn	啿
kjmy	喁
kfmf	喃
uguk	善
kjug	喅
fkfk	喆
kxxr	喈
kdgy	喊
kkyh	喌
khxs	喍
kmnk	喎
kadk	喏
kdeb	喐
kujg	喑
kthj	喒
ksvg	喓
kngf	喔
kdmd	喕
ksdg	喖
kplh	喗
kxge	喙
kegc	喛
fkuk	喜
krxb	喞
kleg	喟
ktgf	喠
knkh	喡
ktfe	喢
kqko	喣
krgg	喤
koac	喥
kykw	喨
kwgb	喩
kdhd	喫
tdkk	喬
kute	喭
kdfa	喯
kwye	喰
kdjf	喱
kxqy	喲
ksjg	喳
kalg	喵
ipkk	営
gehx	喸
kdff	喹
kwti	喺
kwgj	喻
kqvn	喼
kkks	喿
krhw	嗁
kerm	嗂
kykk	嗃
kdht	嗄
kwyk	嗆
fwwk	嗇
kvkc	嗈
kgxi	嗉
keee	嗋
kuwl	嗌
kube	嗍
kcoy	嗎
kaws	嗏
kpdk	嗐
kfcl	嗑
kfhw	嗔
kehc	嗖
kmeg	嗗
kexd	嗘
kyuy	嗙
kuvo	嗛
kftj	嗜
kgkh	嗝
kuxx	嗞
kuga	嗟
ebtk	嗠
kwcn	嗡
kjlg	嗢
krdf	嗥
kfpi	嗦
ekwa	嗧
kitx	嗨
kdwt	嗪
kawk	嗬
fhkx	嗭
kjsg	嗮
kldn	嗯
kwld	嗰
kwgr	嗱
kwrq	嗲
kufc	嗴
kcep	嗵
kjaf	嗶
kgqt	嗷
gqtk	嗸
klpy	嗹
kmwy	嗺
koao	嗻
kajd	嗼
kgkw	嗽
kytd	嗾
kwym	嗿
kdhy	嘁
kknk	嘂
kovh	嘃
kwvs	嘄
kvcq	嘅
kcce	嘇
kmdf	嘊
kftt	嘋
ksfi	嘌
klvg	嘍
kdha	嘎
dnhc	嘏
knwe	嘐
khaf	嘑
kdhv	嘒
klag	嘓
kakk	嘔
kgho	嘕
kgmy	嘖
ipkj	嘗
kihv	嘙
ktjf	嘚
koss	嘛
kswq	嘜
kqef	嘝
kake	嘞
kftb	嘟
kdea	嘠
kipf	嘡
kmee	嘣
kwsv	嘦
kpnm	嘧
kvoj	嘨
klmy	嘪
kqdo	嘫
kjbc	嘬
kfke	嘭
kvfj	嘯
kxxy	嘰
kfje	嘲
kkhm	嘳
kffq	嘵
kadr	嘶
krlo	嘸
ktdk	嘺
kklk	嘼
kkkl	嘽
ksjf	嘾
klfo	嘿
knnw	噀
kgfn	噁
kusf	噂
ktol	噃
kdhi	噄
keto	噅
kaqj	噆
kujf	噇
kyky	噈
knbt	噉
kcnk	噊
kykt	噋
kulj	噌
kwyo	噍
kfpu	噎
kwgn	噏
kkak	噐
krif	噑
koqh	噒
khag	噓
kwgu	噔
etnk	噕
kggn	噖
kogw	噗
kduw	噘
kwyc	噙
kvaf	噚
khob	噛
kxxi	噝
kwgw	噞
owwk	噟
kfup	噠
kqdy	噡
ktmd	噢
klqj	噣
kssi	噤
kmae	噥
kajy	噧
kkdk	器
gkkk	噩
kujn	噫
ktaw	噬
kryt	噭
klge	噮
kept	噯
khae	噱
khad	噳
uthk	噵
kujw	噷
kgbm	噸
kipl	噹
kusr	噺
kpaf	噻
knkf	噼
fkug	噽
kpwj	噾
knyf	噿
kpns	嚀
kahl	嚂
klip	嚃
kawc	嚄
kfdj	嚅
kayk	嚆
kfoo	嚇
kdjy	嚈
kogf	嚉
kfnf	嚋
kyuj	嚌
kvhl	嚍
kfph	嚏
kipj	嚐
ktgo	嚑
kosx	嚒
kpwi	嚓
kqoj	嚕
kdhn	嚖
kjai	嚗
kdet	嚘
khbh	嚙
krxs	嚛
klff	嚜
koaw	嚝
ktqi	嚟
kqyj	嚠
kakf	嚡
kosr	嚤
kako	嚥
kdth	嚦
khal	嚧
kued	嚨
kxgf	嚩
kuqe	嚪
kusq	嚫
khhm	嚬
xtyk	嚮
kosd	嚰
errk	嚳
kkdt	嚴
kqky	嚵
kmmv	嚶
kyke	嚷
klfk	嚸
krmf	嚹
klup	嚺
kelf	嚼
kgqm	嚽
kaky	嚾
kawe	嚿
klgf	囀
kbbb	囁
kywy	囃
kyry	囄
kkle	囅
kajj	囆
kgmx	囇
kafc	囈
klxy	囉
gkhe	囊
ktfm	囋
kaqt	囌
kmuj	囎
akfk	囏
kaui	囒
kdhb	囓
kgke	囔
kahq	囕
ktly	囖
mngd	囙
lhng	四
tlri	囟
lgbn	囤
lywv	囥
mwmg	囧
ldhi	囨
lfci	囩
tlry	囪
mjdd	囬
lwxv	囮
lfjk	囲
luri	図
lwfd	囶
lghd	囸
lwyc	囹
lnna	囻
lckd	囼
lded	囿
lwye	圀
lgei	圂
lgkd	圄
cluf	圅
lged	圊
lakg	國
lmdj	圌
lnkh	圍
lcmi	圎
ludn	圏
llye	圐
lgef	圑
lfke	園
lfcl	圔
lvfj	圕
lcfd	圗
lwdd	圙
lkhm	圚
llff	圛
llge	圜
lyxx	圝
lyxs	圞
ffff	土
ftyy	圦
dhfd	在
fgfh	圩
ftnn	圪
ftan	圫
tdfg	圱
ftfh	圲
fqyy	圴
fhgg	圵
fqrt	圽
fbyy	圾
fwjh	圿
fqan	坁
frcy	坂
ffqn	坃
fwcy	坄
fqug	均
fpwn	坈
fgbn	坉
fwvt	坋
wvff	坌
wwfd	坐
fywn	坑
xxff	坒
rhyf	坕
fqff	坖
fgxg	坘
gvff	坙
fugh	坢
ipff	坣
fjhh	坤
fegg	坥
fpxn	坨
fafg	坩
fguf	坪
fhkg	坫
fnxn	坭
fckg	坮
fdhg	坯
fmkg	坰
fmdy	坱
fxjh	坲
fxet	坳
fwff	坴
frgg	坵
fskg	坷
fqkg	坸
fpwy	坹
fdcy	坺
fqay	坻
fryy	坼
fpsh	坾
fwfy	坿
ftuf	垀
ftdy	垁
tfag	垂
fdxy	垅
fhng	垇
wayf	垈
fqnn	垉
fnna	垊
fmgk	垌
fthg	垍
ftkg	垎
fvgh	垏
uqwf	垐
fqqy	垑
fynw	垓
rgkf	垕
fwnn	垖
fqiy	垗
fwdy	垘
figq	垙
fwsy	垛
fbsy	垜
fqdb	垝
fpta	垞
fvey	垠
waff	垡
frgk	垢
fgjg	垣
fgcf	垤
fwgk	垥
fpfy	垨
fuah	垪
fawy	垬
fdfn	垮
fdpy	垯
fhgh	垰
fivg	垱
ftgs	垳
fyrb	垴
fpvg	垵
fufh	垶
fhqn	垷
fpfq	垸
fdtb	垹
febg	垺
twcf	垼
irff	垽
foch	垿
tfuf	埀
fmwn	埁
fgjr	埂
ftdh	埄
byff	埅
fqeh	埆
fceh	埇
fcwt	埈
fdww	埉
miff	埊
fjfg	埋
fyve	埌
fkeg	埍
fdny	城
fthp	埏
fvpc	埐
rrff	埑
fefy	埒
fgey	埔
fkgg	埕
fawx	埖
fhht	埗
fmwk	埛
ssff	埜
fwyn	埝
fpgh	埞
fakg	域
fwnf	埠
fgfg	埡
fudb	埢
fywf	埣
frtf	埤
fgeg	埥
fpqb	埦
fhwy	埧
fwga	埨
fqvh	埩
fpwa	埪
fimk	埫
fgji	埬
fviy	埭
fooy	埮
fdjn	埯
fesy	埰
fhgc	埱
fdwg	埲
fqeg	埳
ffhg	埴
ftfg	埵
fufy	執
fjqr	埸
adwf	基
fykb	埻
fdsk	埼
fvph	埽
bcff	埾
inxf	埿
fnbm	堀
fjsy	堁
ipkf	堂
yyff	堃
feqn	堄
fwyg	堆
akgf	堇
fmum	堈
fyce	堉
gfgf	堊
feeg	堋
fldg	堌
fqky	堍
ffwt	堎
syff	堏
fdff	堐
fjxx	堒
fmdf	堓
fpws	堔
fvtr	堖
fudf	堘
fsfg	堙
fplh	堚
fgkl	堛
fgli	堜
fmnk	堝
fans	堞
fxge	堟
fwnd	堠
wksf	堡
fwks	堢
fjmy	堣
cnhf	堥
fxxr	堦
fdmd	堧
fjqn	堨
fngg	堩
fadn	堪
frbt	堫
fwgj	堬
fkkn	堮
fffq	堯
fajv	堰
fnhg	堳
fftj	堵
fdae	堶
fujg	堷
fwtj	堸
ftgf	堹
flwj	堺
ivgf	堻
flgh	堽
fdwj	堾
fdgy	堿
fnua	塀
liff	塁
fawn	塂
fayk	塃
flyt	塄
fwdc	塅
fyox	塆
fpgg	塇
vcaf	塈
fiwe	塉
oopf	塋
eudf	塍
fpwk	塎
fmgu	塏
fgxi	塐
ubtf	塑
fpjw	塓
fawk	塔
fwcn	塕
ftux	塖
iwgf	塗
fykk	塙
fpgy	塚
fssy	塛
fpfe	塜
fyuy	塝
agqf	塟
fwnp	塠
fxhw	塡
fwno	塢
ikgf	塣
fkmy	塤
fgkh	塥
blff	塦
fuwl	塧
ftkl	塩
fdri	塬
fjlg	塭
ftmf	塮
itxf	塰
yvcf	塱
ftjr	塲
ftdp	塳
fmee	塴
onjf	塵
fonx	塶
fhlo	塷
fakk	塸
lrff	塹
ossf	塺
fajd	塻
fgjf	塼
fdrr	塽
flvg	塿
fnig	墀
fjlc	墁
fsfi	墂
fdhy	墄
jfcf	墅
faqh	墆
fujf	墇
fade	墈
fovh	墉
fuff	墊
fcce	墋
foao	墌
rxaf	墍
ajdf	墓
fmwy	墔
fgho	墕
fwgl	墖
ffjn	墘
fivs	墚
fnff	墛
buef	墜
fulj	增
fhag	墟
fkkl	墠
fugk	墡
fwxc	墢
fogw	墣
fkhm	墤
ftol	墦
ftdk	墧
lfof	墨
fykt	墩
fusf	墫
bxgf	墬
fdnl	墭
ndaf	墯
fsjf	墰
fwgu	墱
frlo	墲
famw	墴
fffc	墵
ffup	墶
fagf	墷
fafj	墸
ftmd	墺
ffwk	墻
lbwf	墼
fryt	墽
flff	墿
nawf	壂
fglg	壃
scnf	壄
yxtf	壅
errf	壆
fylt	壈
fhae	壉
ffle	壊
fipl	壋
fywe	壌
ilrf	壍
ftgo	壎
fahl	壏
gwmf	壐
hpgf	壑
fafl	壒
djef	壓
ffnf	壔
ffdj	壖
fvhl	壗
lllf	壘
foaw	壙
fhal	壚
fuqe	壛
fjfc	壜
fkhp	壝
fued	壠
fbxg	壣
fyke	壤
fdlf	壥
faky	壦
fkkt	壧
fyxx	壪
fpxb	壱
fpkg	壷
fpgu	壹
fnhe	壻
fkun	壾
flld	夁
ttny	夂
tahj	夅
tdhj	夆
yotu	変
cwtu	夋
fwtu	夌
wwft	夎
dhtu	夏
qmwt	夐
yoot	夑
dhht	夒
edht	夓
utht	夔
qtny	夕
wgqi	夙
ywty	夜
qhkx	夞
qqfk	夡
yclq	夣
qpgw	夤
jsqq	夥
adwq	夦
dddd	大
gnyi	夨
gxwi	夷
dfcu	夽
dhdu	奀
djnb	奄
dqtb	奅
danf	奆
dwgj	奉
ffgy	奊
hkdu	奌
udjj	奍
dfff	奎
dwgd	奏
qmwd	奐
dhvd	契
dynw	奒
dqqu	奓
dfaj	奔
yodu	奕
cdjn	奙
deef	奟
usgd	奠
dftj	奢
gdje	奣
ddmd	奤
cnhd	奦
tmtd	奧
uefd	奨
dakk	奩
dwyf	奪
dijg	奫
ddjj	奭
dhdy	奯
llld	奰
yxxd	奱
dftl	奲
vvvv	女
vtfh	奷
vtan	奼
vyvd	奿
vqyy	妁
ynvf	妄
vpqn	妉
vtfg	妊
vfwy	妋
vfjh	妌
vgah	妍
vwjh	妎
vwcy	妐
vynt	妒
vfcy	妓
vywn	妔
vkhh	妕
vwyn	妗
vdhy	妚
bhgv	妛
vnwy	妜
nhdv	妝
vnhf	妞
vmwy	妠
vwvt	妢
vxxn	妣
vcnh	妤
vdhh	妦
vfqn	妧
vdcy	妭
vnxn	妮
vthf	妰
vvkg	妱
vjgg	妲
vqiy	妳
qbvf	妴
vygg	妵
vyxy	妶
vrwy	妷
vskg	妸
vgsy	妺
vntt	妼
vjhh	妽
ekvf	妿
vqkg	姁
vtpy	姂
vghg	姃
vnna	姄
vugh	姅
wfvf	姇
vwyc	姈
vgmh	姉
vmfg	姌
vmah	姍
vmdy	姎
vafg	姏
vnyw	姒
hxvf	姕
vang	姖
vwtf	姙
vmgk	姛
vriy	姝
vfkg	姞
vynw	姟
vtmk	姠
vtdg	姡
vceg	姢
vywr	姣
vrgk	姤
vvvf	姦
vvfh	姧
vgxw	姨
vrhf	姩
vahh	姬
eeev	姭
vgjg	姮
vigq	姯
vqjg	姰
vdfn	姱
vpvg	姲
gqjv	姴
vwgh	姵
vwgk	姶
vdeg	姷
vgdf	姸
vtfq	姺
vqqy	姼
vqdb	姽
vwgg	姾
vadt	娀
vawy	娂
vffg	娃
vmgn	娉
vhqn	娊
vieg	娋
vjfg	娌
vdny	娍
rrvf	娎
vebg	娐
iitv	娑
vtxy	娒
vdqn	娔
vgki	娕
vkhy	娖
vtfp	娗
vgva	娙
vlet	娚
vngb	娜
vdhk	娝
vevg	娞
vkeg	娟
vdfe	娠
vfny	娡
vwyk	娢
vuxt	娣
vtry	娥
vrgw	娦
vukq	娧
vjfh	娨
vqkq	娩
vgkg	娪
vthp	娫
vfhy	娬
vctd	娭
vknw	娯
vwnw	娰
vtjh	娳
vbcy	娵
vadw	娸
vxyx	娹
vccc	娺
vgji	娻
vviy	娽
vdff	娾
bskv	娿
vbsk	婀
vrmh	婂
vpfi	婃
vukg	婄
vqoy	婅
vesy	婇
vfwt	婈
vgey	婊
vhaw	婋
vhgc	婌
vdsk	婍
vwyg	婎
vqky	婏
vjsy	婐
vtvg	婑
vooy	婒
hdhv	婓
vhdd	婔
vgvh	婕
vgdn	婖
veqn	婗
vudb	婘
vqvh	婙
vyki	婛
ahnv	婜
vpgh	婝
vfuf	婞
vldg	婟
vphn	婠
vsww	婡
vrtf	婢
vmfk	婤
vhjf	婥
vgeg	婧
vwga	婨
vmdf	婩
ssvf	婪
vjxx	婫
vetf	婬
vgfg	婭
vndg	婮
gmyv	婯
vmaw	婰
xyxv	婱
vawx	婲
vglb	婳
vyks	婷
vjgr	婸
vsvg	婹
cnhv	婺
vfmf	婻
vadk	婼
vnhc	婽
vwgb	婾
vnhe	婿
vjmy	媀
vnkh	媁
vyuh	媂
vcns	媃
vugd	媄
vadn	媅
vdmd	媆
vplh	媈
vngf	媉
vuej	媊
vdwj	媋
valg	媌
vqmy	媍
vftj	媎
vmdj	媏
ahkv	媐
vtgf	媑
vrgg	媓
vamd	媖
vpgg	媗
vxxr	媘
vdgy	媙
vegc	媛
vhmy	媜
tovf	媝
vjgh	媞
vans	媟
vdae	媠
vgli	媡
vjhg	媢
vivs	媣
vlny	媤
vyna	媥
vleg	媦
vmnk	媧
vusg	媨
vhvh	媫
vwks	媬
edmv	媭
vwgj	媮
vyto	媯
vqbt	媰
verm	媱
vfke	媴
eudv	媵
vabg	媶
vbhj	媸
vqyl	媹
vmgt	媺
tewv	媻
vlwl	媼
vamf	媾
vrqc	媿
vdwt	嫀
vfhw	嫃
vdri	嫄
vuga	嫅
vpwk	嫆
vpjw	嫇
oopv	嫈
vgxi	嫊
vxuu	嫋
veeg	嫍
vyuy	嫎
vyvb	嫏
vlev	嫐
dhsv	嫑
vqmx	嫓
vatn	嫕
vakk	嫗
vlxi	嫘
vyth	嫙
vjlc	嫚
atdv	嫛
vujf	嫜
vovi	嫝
vovh	嫞
vaak	嫟
fitv	嫠
fwhv	嫢
vgho	嫣
vakg	嫤
vgjf	嫥
vgmy	嫧
vakw	嫨
vnwe	嫪
vajd	嫫
voao	嫬
vhaf	嫭
vffn	嫮
gqtv	嫯
vgkw	嫰
voss	嫲
umiv	嫳
vduf	嫴
vrlo	嫵
vwyo	嫶
vbde	嫷
vugk	嫸
vamw	嫹
vueg	嫺
vusy	嫻
vlfo	嫼
vdui	嫽
voqh	嫾
vvfg	嫿
veto	嬀
vwgu	嬁
vujy	嬂
vfpu	嬄
vagf	嬅
vwgn	嬆
vkhm	嬇
vffq	嬈
akuv	嬊
vkkl	嬋
vtol	嬏
vwgw	嬐
vujn	嬑
vryt	嬓
vlff	嬕
vylg	嬗
vuep	嬘
vfwk	嬙
vouo	嬚
vlge	嬛
ujqv	嬜
vwve	嬝
vatf	嬞
vugy	嬟
vkks	嬠
vept	嬡
vywe	嬢
vpns	嬣
vosx	嬤
vfnf	嬦
vvhl	嬧
vuxn	嬨
vegw	嬩
vpgm	嬪
voos	嬫
vfdj	嬬
vgwr	嬭
djev	嬮
vfkf	嬯
ilrv	嬱
leve	嬲
vawc	嬳
vxrh	嬵
vthj	嬶
vemw	嬹
vaan	嬺
vflm	嬻
vqyj	嬼
vlhd	嬽
vgkm	嬾
vako	嬿
vfsh	孀
fkkv	孁
vtvl	孂
vyke	孃
vugi	孄
vwwg	孅
vmmv	孆
vmwk	孈
vaky	孉
vosd	孊
vgmx	孋
yxxv	孌
vkkt	孍
vnij	孎
vaui	孏
bnhg	孑
fpbf	孛
ngkb	孠
bckg	孡
bqnn	孢
brcy	孤
vcbf	孥
xebf	孧
bynw	孩
bpfi	孮
ahnb	孯
ykby	孰
bgfg	孲
bbbj	孴
qytb	孵
yxyb	孶
fitb	孷
nkub	孹
bfdj	孺
bvhl	孻
btwb	孼
bmmv	孾
yxxb	孿
pyyn	宀
pgfj	宇
pdyu	宊
pywu	宍
ptdu	宎
phng	宐
pfjj	宑
ptfn	宒
pntr	宓
pygf	宔
pxcu	宖
phnn	官
pegf	宜
pdwu	実
pgjg	宣
pdef	宥
pahh	宦
pqiu	宨
pdny	宬
pvtk	宭
pftb	宯
pufj	宰
pksu	宲
pdhk	害
ptou	宷
pdfe	宸
pwwk	容
pkgk	宺
pcum	宻
pfqv	宼
pesu	寀
pgvh	寁
pfqc	寇
pgef	寈
pwyf	寉
phmu	寊
pawb	寋
pgkl	富
pnlf	寍
pnhw	寎
pqmd	寏
pnhi	寐
pwvc	寑
pjgh	寔
pdls	寕
pivc	寖
pntf	寗
pfhw	寘
prcy	寙
pahq	寛
pnlh	寜
pajd	寞
plvf	寠
pnhy	寣
pnhk	寤
peto	寪
peqo	寫
pgjn	寭
pdui	寮
pwym	寯
pnhs	寱
pxth	寲
pgqm	寳
pusq	寴
pued	寵
pgrm	寶
pmdu	寷
fffy	封
gmfu	専
gehf	尃
tmdf	射
dqfi	尅
nhdf	將
usgf	尊
oguf	對
uthf	導
hgiu	尗
imkf	尚
idiu	尜
duji	尞
jght	尟
igqx	尡
dnqy	尥
dney	尨
wqgd	尩
dngd	尪
gqgd	尫
dnwj	尬
faqb	尭
dnbs	尮
dnqb	尯
dntf	尰
ykiy	就
dnuo	尲
dnme	尳
dnkm	尵
gqal	尶
ntfn	尾
npwi	屄
ngcf	屋
nkmh	屌
ntfc	屐
nied	屑
ndfe	屒
rgnx	屔
nufk	屖
ntff	屗
ntfb	屘
nbsk	屙
ntgf	屛
ntan	屜
nhdd	屝
nans	屟
nftj	屠
nthh	屣
nulj	層
nttt	履
ntas	屧
ntlv	屨
nttk	屩
npdi	屪
nnhk	屫
nilj	屬
nmmm	屭
ubtr	屰
mmmm	山
tymj	屳
mtnn	屹
mvyy	屻
mgqn	屼
mvyu	岃
mtdy	岆
mqbj	岇
maht	岈
mqrt	岉
mbyy	岋
mgah	岍
mwvt	岎
mfqn	岏
mfcy	岐
mwyn	岑
mwjj	岕
tdmj	岙
mthf	岝
mmdy	岟
mang	岠
mqkg	岣
mpwy	岤
mhcy	岥
mvkf	岧
megg	岨
mxjj	岪
mpxn	岮
mdhg	岯
mxet	岰
mrgg	岴
mvkg	岹
mwyc	岺
mqay	岻
mguf	岼
mqtb	峁
mtuy	峂
ipmj	峃
mcah	峅
mwgk	峆
mtkf	峉
wnnm	峊
mqjg	峋
mgcf	峌
mvgh	峍
mveu	峎
mwgf	峑
mmgk	峒
mgxw	峓
mftx	峔
myjf	峕
mpvg	峖
mqdb	峗
mgjg	峘
mffy	峙
mgqj	峛
mwhf	峜
mdef	峟
mhgh	峠
matq	峣
mywr	峧
mtry	峨
mahb	峫
mgey	峬
mvtk	峮
mtdh	峰
qtnm	峱
mtjj	峲
mwht	峳
mhqn	峴
mpdc	峵
wvgm	島
mufj	峷
wgsm	峹
mgjr	峺
mcwt	峻
mtfk	峼
mdww	峽
irmj	峾
mgkg	峿
myve	崀
mfqw	崁
mwgg	崄
mqeh	崅
mpwa	崆
mpfi	崇
pfim	崈
mijg	崉
mssy	崊
mgaf	崋
mndg	崌
msww	崍
mdsk	崎
mqaj	崏
mjxx	崑
mywf	崒
mldg	崓
mwyf	崔
mdff	崖
mmum	崗
mwga	崙
mfwt	崚
mnbm	崛
mtfg	崜
mgeg	崝
mykb	崞
mgji	崠
mbib	崡
mtvf	崣
mrde	崤
mrtf	崥
mdjn	崦
mswc	崧
mgvh	崨
mldf	崮
mvlg	崰
mmjj	崱
mwgj	崳
mdgy	崴
mjgr	崵
mfff	崶
musg	崷
mdmy	崸
myuh	崹
mytb	崺
mtff	崻
mjgh	崼
mlnu	崽
msvg	崾
mkkn	崿
msyg	嵀
madn	嵁
mtvg	嵂
mute	嵃
mugd	嵄
tdnm	嵇
megc	嵈
myks	嵉
mtux	嵊
mnhg	嵋
mjmy	嵎
mrbt	嵏
mjqn	嵑
kkkm	嵒
mkkk	嵓
mlge	嵔
msjg	嵖
mtuf	嵙
mqqw	嵚
mukh	嵜
mdwy	嵟
mexd	嵠
mwcn	嵡
mwyk	嵢
movk	嵣
oopm	嵤
mqas	嵥
mmgu	嵦
mqyl	嵧
mwno	嵨
mykk	嵩
muxx	嵫
mrqc	嵬
myuy	嵭
mfhw	嵮
muga	嵯
mpwk	嵱
mths	嵲
miwe	嵴
mjff	嵵
mxuu	嵶
mtwh	嵷
mxkj	嵹
mnwe	嵺
movi	嵻
mutg	嵼
maqh	嵽
mcce	嵾
msdm	嵿
mffn	嶀
mlvg	嶁
mujf	嶂
mlrh	嶃
mgmj	嶆
makk	嶇
mnhf	嶈
mkwy	嶉
mrwy	嶊
mwvo	嶋
mnrg	嶍
mnff	嶎
mdsn	嶏
mbtg	嶐
mqke	嶑
mtol	嶓
mwyo	嶕
mwgn	嶖
msaa	嶘
moqh	嶙
mdui	嶚
maqj	嶜
mwgu	嶝
bdam	嶞
musf	嶟
mtdk	嶠
mduw	嶡
mffq	嶢
mlff	嶧
errm	嶨
mmae	嶩
mogi	嶪
mugy	嶬
mwnf	嶭
mwgw	嶮
mkby	嶯
mqeg	嶰
majn	嶱
tmom	嶴
mlhd	嶵
mtmt	嶶
mxth	嶷
moos	嶸
mfnf	嶹
mwym	嶺
mfwy	嶻
megw	嶼
mqty	嶽
mean	嶾
mfdj	嶿
miwa	巀
mday	巁
mued	巃
mook	巆
mhaa	巇
mako	巈
mqky	巉
mmmv	巊
midt	巌
mdht	巎
maky	巏
myka	巐
mtfm	巑
yxxm	巒
mxhm	巓
mfhm	巔
muwv	巕
mkkt	巖
mhay	巘
mutt	巙
vnnn	巛
kthh	川
ytyh	州
ynkb	巟
gvaf	巠
ijsu	巣
vlrn	巤
aaaa	工
agnn	巧
awfw	巬
aefw	巭
gvak	巰
nngn	己
cnhn	巴
rgcv	巵
vknn	巶
awnb	巷
ahkn	巸
bign	巹
nngw	巺
udnb	巻
ckxb	巼
nnaw	巽
gmhk	巿
mhsh	帄
mhwy	帆
vmhk	帇
mhwv	帉
mhcn	帊
qamh	帋
rdmh	希
ynmh	帍
mhpq	帎
vcmh	帑
wayh	帒
mhgs	帓
mhhc	帔
mhrg	帕
mhhk	帖
mhdy	帗
mhrw	帙
vpmh	帚
rmhj	帛
mhdj	帞
yomh	帟
emhj	帠
mhua	帡
mhwk	帢
udmh	帣
vkmh	帤
mhuq	帨
mhie	帩
wnnh	師
vtkh	帬
gkgh	帯
ytvh	帰
mhtf	帲
mhde	帳
mhpb	帵
aqph	帶
ipkh	常
mhuv	帹
mhaw	帺
mhfj	帾
mhwd	帿
mhhm	幀
mhdm	幁
mhnh	幃
mhnf	幄
mhjn	幆
mhna	幈
mhas	幉
mham	幊
tewh	幋
mhjq	幌
mhee	幍
mhpw	幎
mhpe	幏
eudh	幐
tmtt	幑
mhtn	幒
mhce	幓
mhjc	幔
ajdh	幕
mhsi	幖
mhlg	幗
mhgm	幘
mhad	幙
mhji	幜
mhkl	幝
mhow	幞
mhuy	幟
mhro	幠
mhtl	幡
mhuf	幢
umih	幣
imkh	幤
mhir	幥
nkuh	幦
mhks	幧
mhqy	幨
mhfm	幩
mhae	幪
fffh	幫
mhff	幬
mhof	幮
mhtb	幯
mhpn	幰
mhui	幱
gufk	平
rhfk	年
gdfh	幵
tgdf	幷
fjff	幹
xxxx	幺
otci	庅
owyn	庈
ogbn	庉
ofci	庋
oaht	庌
owjk	庎
ocnh	序
ofyi	庒
oqay	底
oqnv	庖
ovwi	庚
ohxv	庛
otui	庝
ougk	庠
oyei	庡
ogcf	庢
oqii	庣
offi	庤
owsi	庥
owwf	座
oftb	庨
owgs	庩
orfc	庪
odny	庬
otfp	庭
osgd	庮
ogey	庯
ouak	庰
ofwt	庱
osww	庲
ortf	庳
oaoi	庶
oany	庹
owcs	庺
oaww	庻
oxdm	庼
ojmy	庽
oewi	庾
oald	庿
opoc	廀
oshd	廂
owfq	廃
ovcc	廄
ofcl	廅
orqc	廆
ouvo	廉
oehc	廋
oukb	廍
orxc	廏
orxq	廐
oakg	廑
ogqt	廒
oykb	廓
olvd	廔
obwc	廕
onwe	廖
oaqh	廗
oonx	廘
ojff	廛
onfj	廜
oadr	廝
oqqw	廞
orlo	廡
oamw	廣
olkx	廤
onkf	廦
ofwk	廧
oqeg	廨
oylt	廩
oene	廫
otgm	廭
ommv	廮
oqog	廯
obfn	廰
ovky	廱
ogmx	廲
tfpd	廷
vgpk	建
mjdp	廽
agth	廾
aghg	廿
wvaj	弅
fcaj	弆
wgka	弇
yoaj	弈
afyi	弍
adyi	弎
ffny	弐
rsyy	弒
xqwy	弞
xang	弡
xbhc	弢
xwfy	弣
xqay	弤
vcxb	弩
xahh	弫
udxb	弮
xykb	弴
xyki	弶
xgmx	弻
xdjx	弼
xans	弽
xilh	弾
pawx	弿
xskk	彁
ogxd	彂
xjaf	彃
xakk	彄
xuev	彅
umix	彆
xkkl	彈
xamw	彉
xglg	彊
xgwr	彌
xhhc	彏
vngg	彐
xgiu	彔
xgeu	彖
xgtx	彘
xgps	彙
vpjs	彚
vowa	彛
xgoa	彝
voxa	彞
vfac	彟
vakc	彠
ettt	彡
myet	彤
yder	彥
gkgy	彧
gmye	彨
hawe	彪
mfke	彫
fkue	彭
pwwe	彮
ujfe	彰
jyke	影
ttth	彳
tqyy	彴
tbyy	彶
twcy	役
thcy	彼
twyc	彾
txjh	彿
tghg	征
tqjg	徇
tugh	徉
tvgh	律
tffg	徍
thht	徏
twgs	徐
tgva	徑
tfhy	徒
tuhy	従
tapy	徔
tpfi	徖
tjgf	得
thhy	徙
tgli	徚
timk	徜
tfhg	徝
twwh	從
tsww	徠
tgvh	徢
tajg	徣
tjgh	徥
tnhc	徦
trgg	徨
ttjt	復
tnkh	徫
tyuy	徬
term	徭
tmgt	微
texd	徯
tghh	徰
tsfi	徱
tnig	徲
tumt	徶
tfln	德
tffq	徺
tryt	徼
tmyt	徾
tjbi	忁
nyny	心
nyyh	忄
tfnu	忎
hgnu	忐
ghnu	忑
anyi	忒
ntnn	忔
ynnu	忘
nwyy	忛
gdnu	忝
khnu	忠
nkhh	忡
nbyy	忣
ntfh	忤
rnnu	忥
nfqn	忨
wcnu	忩
nwcy	忪
nnwy	快
ncnh	忬
nyhy	忭
nqan	忯
nvfh	忰
npqn	忱
ndyy	忲
ngbn	忳
nwyn	忴
nrbh	忷
nnhf	忸
nqwy	忺
nywn	忼
qrnu	忽
wvnu	忿
nang	怇
nann	怈
nqnn	怉
nvkg	怊
nnna	怋
ndhg	怌
nthf	怍
thfn	怎
nmdy	怏
nqkg	怐
nugh	怑
nvcy	怓
ndmh	怖
nhkg	怗
negg	怚
njgg	怛
nqay	怟
nckg	怡
nrwy	怢
rwnu	怣
wfnu	怤
qvnu	急
nguf	怦
ntgg	性
nnxn	怩
nxjh	怫
nntt	怭
nxet	怮
nfcy	怯
nyxy	怰
qryn	怱
ngmw	怲
nkqn	怳
ngny	怴
nsyy	怵
fqyn	怷
synu	怸
wbnu	怹
nyni	怺
nfiy	怽
nkwy	怾
nqqy	恀
wtfn	恁
nqjg	恂
nfkg	恄
nftx	恅
nghg	恆
nagg	恇
nctg	恈
nxjg	恉
neee	恊
nqiy	恌
vbnu	恏
awyn	恐
nqdb	恑
nywr	恔
tlrn	恖
ndfn	恗
nwsy	恘
ugnu	恙
ffnu	恚
nlkg	恛
naay	恜
dhvn	恝
ngxw	恞
nqrb	恟
ndhf	恠
nrdc	恡
uqwn	恣
ntmk	恦
dmjn	恧
ldnu	恩
ntdg	恬
awnu	恭
nwgg	恮
nwcq	恱
nuah	恲
yjnu	恴
gmnu	恵
wsnu	恷
nayn	恾
cehn	恿
nceh	悀
nkeg	悁
nxxf	悂
nlsy	悃
wgsn	悆
nwgs	悇
naah	悈
tonu	悉
rrnu	悊
nykg	悋
nuxt	悌
ntfk	悎
ndww	悏
qton	悐
ngey	悑
nkcn	悒
nhqn	悓
ntxy	悔
nrdh	悕
nfpb	悖
nqkq	悗
nykb	悙
ngki	悚
ncwt	悛
nkgg	悜
njfg	悝
nknd	悞
whtn	悠
tjnu	悡
nyve	悢
tlqn	悤
ntjh	悧
nirb	悩
gkjn	悪
nkgd	悮
npfi	悰
hdhn	悲
fhnn	悳
ndey	悵
ntbg	悸
nphn	悺
nfuf	悻
ngvv	悽
npwa	悾
ngdn	悿
nwga	惀
srnu	惁
njxx	惃
hgin	惄
njsy	惈
ihkn	惉
pqbn	惌
nakg	惐
akgn	惑
tknu	惒
nudb	惓
nooy	惔
njqr	惕
jqrn	惖
nmun	惘
nccc	惙
nqrn	惚
nqaj	惛
nimk	惝
nrqw	惞
nnnu	惢
tqrn	惣
nxyx	惤
ewnu	惥
fhnu	惪
ndae	惰
nplh	惲
nmdj	惴
dwjn	惷
nqjb	惸
njtg	惺
nmjh	惻
nyna	惼
nnnj	惽
nrbt	惾
njgh	惿
ntoy	愀
fpbn	愂
npgg	愃
nlge	愄
nakf	愅
tign	愆
nnkh	愇
nwgj	愉
ngkl	愊
negc	愋
nqmd	愌
natn	愍
ntjt	愎
ndmd	愐
ncee	愑
njqn	愒
njgr	愓
nujg	愔
nkkn	愕
nadn	愖
nptk	愘
ptkn	愙
nadw	愜
najv	愝
dgkn	感
nlny	愢
nlyt	愣
namd	愥
nrqc	愧
namy	愩
nkmy	愪
ngxi	愫
ubtn	愬
nerm	愮
nwyc	愯
njiq	愰
nutd	愱
nmeg	愲
hhnu	愳
nwyk	愴
nxuu	愵
nmgu	愷
swwn	愸
npwk	愹
najf	愺
btxn	愻
nxhw	愼
ngef	愽
nrno	愾
nexd	慀
lgen	慁
icen	慂
nwcn	慃
nssy	慄
ncyj	慅
neeg	慆
rvnn	慇
uxxn	慈
nyxl	慉
nuvo	慊
nlwl	慍
npjw	慏
amnu	慐
ngmj	慒
nsfi	慓
najd	慔
nlag	慖
gkin	慗
lrnu	慙
nmwy	慛
txtn	慜
ntge	慟
ngqt	慠
ndrr	慡
ntfp	慥
giyn	慦
dhdn	慧
nlpy	慩
nakk	慪
twwn	慫
gusn	慭
haln	慮
ntjr	慯
ngjf	慱
nahf	慳
nnrg	慴
onjt	慶
aqpn	慸
fufn	慹
nlvg	慺
nudh	慻
dhgn	慼
ndhy	慽
wwkn	慾
ucan	慿
nnwe	憀
ntln	憁
dwen	憃
tfhn	憄
nipf	憆
nhag	憈
nfke	憉
watn	憊
umin	憋
qqun	憌
ntdk	憍
nwfi	憏
nkhm	憒
ngjn	憓
nwyo	憔
nwgu	憕
nfkk	憘
nkkl	憚
nsjf	憛
nbde	憜
ykbn	憝
nykt	憞
nsoy	憟
dubn	憠
ntgi	憡
nffq	憢
ntol	憣
oopn	憥
nooe	憦
nujf	憧
tdtn	憩
nueg	憪
nuyy	憫
njyi	憬
ndui	憭
nrlo	憮
naqj	憯
ncnk	憰
nyky	憱
nvaf	憳
nkun	憵
nssh	憷
nwgw	憸
nmae	憹
nqdy	憺
nylg	憻
aqkn	憼
naqn	憽
nryt	憿
nake	懄
nhae	懅
nkks	懆
even	懇
nqeg	懈
scnn	懋
nlff	懌
nylt	懍
nfwk	懎
nwym	懏
nept	懓
djen	懕
qtdn	懖
nfoo	懗
iaqn	懘
negw	懙
nean	懚
nfkf	懛
nalq	懜
nxth	懝
nape	懞
ogun	懟
nyuj	懠
nosc	懡
nahl	懢
iamn	懣
nfnf	懤
nfph	懥
nfdj	懦
npns	懧
ndjy	懨
nufe	懩
njai	懪
nrrm	懫
oamn	懬
noaw	懭
ndet	懮
nqyj	懰
naly	懱
ndhn	懳
nfhy	懴
nalh	懵
nyle	懷
hitn	懸
nyke	懹
nuxw	懻
naky	懽
nbbb	懾
fpgn	懿
yxxn	戀
akfn	戁
nosd	戂
nipo	戃
nhhc	戄
ujfn	戇
agny	戈
gnxy	戉
dxyi	戊
dgxy	戌
dnxy	成
nhda	戕
akgd	或
mgka	戙
dhau	戛
depa	戞
fjfa	戟
ujxy	戠
adwa	戡
kbxy	戢
wgda	戣
bcla	戤
jtga	戥
ilay	戦
wyva	戧
sksa	戨
gcca	戩
fwyy	截
deag	戫
pgma	戭
haoa	戯
haja	戱
haga	戲
hhwa	戵
ynnv	戹
ynnn	戺
yndi	戻
nagn	戼
ynuf	戽
yndy	戾
ynye	房
ynma	扁
ynhk	扂
ynmk	扃
ynqq	扅
ynnd	扇
ynkc	扈
ynoo	扊
rtgh	手
rghg	扌
rtyy	扖
rdyy	扙
rgfh	扜
rfnn	扝
rnfh	扟
rcyy	扠
rtnn	扢
rgqn	扤
rtan	扥
rtfh	扦
rvyy	扨
rnhf	扭
rbyy	扱
rwyn	扲
rrcy	扳
rwjh	扴
rwuy	扵
rfwy	扶
rtdy	扷
rthn	扸
rqan	扺
rqwy	扻
rdbn	扼
rgbn	扽
rfcy	技
rcqn	抁
ryhy	抃
ritt	抄
rnwy	抉
rpqn	抌
rtah	抍
rfqn	抏
rdhy	抔
rxnn	抝
rnyy	択
rqug	抣
rgmw	抦
rkwy	抧
rguf	抨
rmfg	抩
regg	抯
rmdy	抰
rqnn	抱
rskg	抲
rnxn	抳
rann	抴
rrwy	抶
rdhg	抷
rtpy	抸
rgsy	抹
rfiy	抺
rjhh	抻
rnan	抿
rkqn	拀
rekg	拁
rthf	拃
rygg	拄
rryy	拆
rwfy	拊
rugh	拌
vcrj	拏
rafg	拑
rdcy	拔
rpxn	拕
rtbn	拖
rxet	拗
rdfh	拜
rrgg	拞
rtwn	拠
rocy	拡
rhgh	拤
rvey	拫
rtdg	括
rfkg	拮
rwtf	拰
rawy	拱
awrj	拲
rwgg	拴
rdhb	拵
rvqy	拶
rqqy	拸
reee	拹
rgmi	拺
rdoy	拻
ruah	拼
rjxt	拽
rwgk	拾
rrey	挀
rgcf	挃
rigq	挄
rbsy	挅
rwsy	挆
rxjg	指
dhvr	挈
rahh	挋
rtkg	挌
rdfn	挎
rmgk	挏
vkrj	挐
rqiy	挑
rgqj	挒
rpta	挓
ryey	挔
rpwn	挖
rgxw	挗
rite	挘
igwr	挙
rgog	挜
rvfy	挦
rwkq	挩
rwwf	挫
rfpb	挬
rgjr	挭
ruxt	挮
rkgg	挰
riit	挱
iitr	挲
rgva	挳
rtxy	挴
rgah	挵
rnnk	挶
rdtb	挷
rhqn	挸
rkcn	挹
rthp	挻
revg	挼
rdww	挾
rtdh	捀
rvtk	捃
rgiy	捄
rfoy	捇
rwgs	捈
rebg	捊
refy	捋
rkej	捌
rjfg	捏
rkeg	捐
rjgy	捑
rgki	捒
rahb	捓
rqeh	捔
rgey	捕
rhht	捗
rcwt	捘
rkkg	捛
rjhc	捜
rukq	捝
rrgw	捠
rntn	捤
rpqb	捥
rdwg	捧
rwfk	捨
ryny	捩
rqaj	捪
rowf	捬
rrtf	捭
rgcj	捯
rjsy	捰
rdff	捱
rudb	捲
rrgm	捳
rwcn	捴
rmaw	捵
rviy	捸
rdfa	捹
rdfi	捺
rtvg	捼
rywf	捽
rphn	捾
rgvv	捿
rdey	掁
rwga	掄
rgeg	掅
rmum	掆
rccc	掇
rukg	掊
roqy	掋
ipkr	掌
rjxx	掍
rdsk	掎
rqeg	掐
radw	掑
rhdd	排
rhgc	掓
ahnr	掔
rfwt	掕
rywy	掖
rgfg	掗
rgmy	掚
rffh	掛
reqn	掜
rakg	掝
rooy	掞
rpgh	掟
resy	採
reeg	掤
rjqr	掦
rpwa	控
rwyg	推
rbcy	掫
rqoy	掬
rgdn	掭
ryne	掮
rheg	掯
rwvr	掰
rrrj	掱
rjqx	掲
rwgb	掵
rovw	掶
rblg	掹
rcjy	掻
ruog	掽
rxge	掾
radk	掿
rgli	揀
rhmy	揁
rusg	揂
ruej	揃
rwgj	揄
dgar	揅
rwgd	揆
rfmf	揇
rqyg	揈
rgkl	揊
rlny	揌
rdwd	揍
rpgg	揎
ralg	描
reag	揑
rtfe	插
rytb	揓
rqrn	揔
radn	揕
rkbg	揖
rrfh	揗
ryna	揙
rqmd	換
rujg	揞
rnhe	揟
rajv	揠
rptk	揢
rvcb	揤
ryuh	揥
rgkj	揦
gkir	揧
ryks	揨
torj	揫
rpwy	揬
rjqn	揭
rtgf	揰
iejr	揱
rans	揲
rdhd	揳
rvgp	揵
rbbh	揶
rsjg	揸
ruxe	揹
refb	揺
rdgy	揻
rdiy	揼
rjlg	揾
rukn	搃
ramf	搆
rpwk	搈
rqbt	搊
rrhw	搋
rnae	搌
rbti	搎
ryxl	搐
rabg	搑
ryuy	搒
ruga	搓
rcyj	搔
rfcl	搕
rqrm	搖
rftj	搘
ruvo	搛
rthy	搝
rykk	搞
rlfh	搟
rube	搠
rccs	搡
rgoj	搢
ruwl	搤
rwnp	搥
rxuu	搦
rynn	搧
rjng	搨
rqas	搩
tewr	搫
rtec	搬
rssy	搮
rmeg	搰
rnuf	搱
rpdk	搳
pawr	搴
rlwl	搵
rwyk	搶
rfhw	搷
rdwt	搸
rgkh	搹
rudr	搼
raws	搽
rpwf	搾
rwgr	搿
rwno	摀
rldn	摁
rbiy	摂
ramy	摃
rpwq	摉
rrsc	摋
rutg	摌
rpwj	摍
rnwe	摎
rdwe	摏
rtwh	摐
rlag	摑
rtdp	摓
raqh	摕
rwfi	摖
rgkw	摗
ryud	摘
rlpy	摙
ripf	摚
ryrc	摛
rxfm	摜
ronx	摝
rlxi	摞
rtln	摠
rvcq	摡
rhaf	摢
rhag	摣
rdrr	摤
rtjr	摥
rdfy	摦
rmwy	摧
rnig	摨
rfwq	摫
rujq	摬
roao	摭
fwfr	摰
rjlc	摱
rlrh	摲
rakk	摳
rffn	摴
rgjf	摶
rvjs	摷
ajdr	摹
rnrg	摺
rahf	摼
rsfi	摽
rxkj	摾
rwuj	摿
fnwr	撀
ryxg	撁
lwcr	撃
rduw	撅
umir	撆
rooe	撈
ykbr	撉
rueg	撊
rugg	撋
rkhm	撌
raqj	撍
rfpu	撎
rvaf	撏
rffq	撓
rjyi	撔
radr	撕
rnbt	撖
ramw	撗
rtwk	撘
rusf	撙
rqdo	撚
roqh	撛
rwgu	撜
reto	撝
rtdk	撟
rfja	撠
rccn	撡
rsjf	撢
rxqc	撧
rwyo	撨
rdui	撩
rcdl	撪
rtfn	撬
rtol	播
rjbc	撮
rbde	撱
rqqw	撳
rykt	撴
ragf	撶
ripq	撹
rfup	撻
rdgn	撼
rryt	撽
rmnp	撾
rwgw	撿
ryxy	擁
rflg	擂
rmae	擃
rylg	擅
rafj	擆
rlff	擇
rogi	擈
rlqj	擉
lbwr	擊
rtdw	擌
rkks	操
aqkr	擎
raqt	擏
rlge	擐
rkby	擑
rwyc	擒
raiy	擓
rwym	擕
rajn	擖
rnkf	擗
nkur	擘
rtmd	擙
rhae	據
raas	擛
rfmy	擜
rjel	擝
rgwr	擟
ryuj	擠
rfkf	擡
rfnf	擣
rthj	擤
egnr	擧
rfdj	擩
djer	擪
rdjy	擫
rawc	擭
rutk	擱
rtvb	擳
rosr	擵
rtuj	擶
rfkm	擷
rvln	擸
rakw	擹
rlvt	擻
rqoj	擼
rrxs	擽
ryup	擿
srrr	攀
rufe	攁
rlll	攂
rawi	攃
rhan	攄
rfwm	攅
rpdn	攇
ront	攈
rdth	攊
rgkm	攋
rlle	攌
rhal	攎
rued	攏
rpae	攐
rpah	攓
rugi	攔
rwwg	攕
rmmv	攖
rono	攗
ryke	攘
rook	攚
rlxy	攞
rosd	攠
ryry	攡
rtfm	攢
raky	攤
rthi	攥
rgmx	攦
rfhm	攧
ripo	攩
rhhc	攫
rxgj	攭
rgke	攮
fcee	攰
ufcy	攱
dskc	攲
fcvf	攳
ttgy	攵
nhty	收
gnty	攷
whty	攸
nnty	攺
wvty	攽
ghty	政
hkhc	敁
qkty	敂
nnat	敃
wgkc	敆
gmit	敇
tkty	敋
wgsc	敍
rdbt	敎
txty	敏
dfet	敐
giyt	救
wjht	敒
wkqt	敓
gkty	敔
gkit	敕
gqty	敖
wgst	敘
ukqt	敚
wynt	敜
umit	敝
mawt	敟
jqrc	敡
jshc	敤
oohc	敥
ukty	敨
ipbt	敩
ccct	敪
ryty	敫
aqkt	敬
jgqt	敭
tfec	敮
nnac	敯
mgkc	敱
ykmc	敲
mgkt	敳
bgjt	敶
hptt	敹
tdkc	敽
ugut	敾
tdkt	敿
lqjc	斀
lfut	斁
wgkt	斂
fitw	斄
errc	斅
errt	斆
yfhy	斌
yhqb	斍
yjfi	斎
yyve	斏
hdhy	斐
gygg	斑
yjew	斔
oufh	料
ccpf	斚
qehf	斛
wgsf	斜
kkpf	斝
ewuf	斞
amwf	斢
lqjf	斣
rtth	斤
nhdr	斨
qkrh	斪
ajrh	斮
adwr	斯
usrh	新
nngr	斲
akgr	斳
oqar	斴
qyvr	斵
xxgr	斷
nilr	斸
ywjh	斺
ytwn	斻
ytbn	施
ytmh	斾
ytbg	斿
yciy	旀
ytrh	旂
ytmy	旃
yttn	旄
yrmh	旆
ythc	旇
yyck	旈
yrny	旊
ytnh	旋
yttg	旌
ytwc	旍
ytnx	旎
ytqi	旐
ydsk	旑
ytyk	旒
ytie	旓
yvgp	旔
ywux	旕
ytdk	旖
ytol	旙
ytsi	旚
yttl	旛
ytyg	旜
ytwj	旝
ytup	旞
ytew	旟
rxaq	旣
mnmq	旤
jqyy	旳
jgfh	旴
jnrt	旸
jgbn	旽
gbnj	旾
jtfh	旿
jqug	昀
jgmh	昁
jdwu	昃
jrcy	昄
jbyy	昅
jtaj	昇
jynt	昈
jgdu	昊
gdjf	昋
qajf	昏
jwvt	昐
jwyn	昑
jqrt	昒
jywu	昗
dujf	昚
jang	昛
jgqr	昜
thjf	昝
jgmw	昞
jtgf	星
jyxy	昡
jbmh	昢
jwet	昣
dwjf	春
jdjj	昦
jfiy	昧
jthf	昨
jgsy	昩
jcaj	昪
jqkg	昫
jvkg	昭
jaer	昮
jghf	昰
jxjh	昲
jrwy	昳
jqtb	昴
ynij	昶
jtuy	昸
jyni	昹
jabj	昻
jdxy	昽
jocy	昿
jqiy	晀
jqiu	晁
jigq	晃
jgjg	晅
jdfn	晇
jtmk	晌
jmgk	晍
jawy	晎
jpvf	晏
jynw	晐
jwyk	晗
jjfh	晘
jcwt	晙
jqkq	晚
juxt	晜
jrdh	晞
jdny	晟
jgey	晡
rrjf	晢
jrrh	晣
jgkg	晤
jpfq	晥
jtxy	晦
jtfk	晧
jdfe	晨
jmaw	晪
jhjf	晫
jywf	晬
jyki	景
jsrh	晰
jooy	晱
jeqn	晲
srjf	晳
jgeg	晴
jthk	晷
jdjn	晻
jssy	晽
jjjg	晿
jtyg	暀
jfaq	暁
jhdd	暃
jpgg	暄
jngg	暅
jplh	暉
jdmy	暊
jwgd	暌
jjqn	暍
jamd	暎
jnkh	暐
jftj	暑
jjtg	暒
jgli	暕
jjgr	暘
jerm	暚
juga	暛
jths	暞
jmgu	暟
jykk	暠
jwcn	暡
jrno	暣
jrdf	暤
jjpv	暥
dssj	暦
vcag	暨
jwfi	暩
jamy	暪
lrjf	暫
jrif	暭
ajdj	暮
jtwh	暰
jaak	暱
jdhv	暳
jakw	暵
jyth	暶
jdui	暸
jwyp	暹
jjyi	暻
umij	暼
joqh	暽
jykt	暾
jfkk	暿
jfpu	曀
rxag	曁
jvip	曃
jagf	曄
jagg	曅
dttj	曆
jffq	曉
jxjm	曊
jsjf	曋
jepa	曌
jlff	曎
jxtb	曏
jjje	曑
jryt	曒
jbmf	曓
jaqt	曔
jogi	曗
jtgo	曛
jnwy	曜
jjai	曝
jpdi	曢
jako	曣
jhal	曥
jgkj	曧
jued	曨
jlxy	曪
jgmx	曬
jipo	曭
jkkt	曮
jnij	曯
jhng	曰
jxyi	曵
qrjf	曶
jqwn	曷
gmjf	曺
jqah	曻
uljf	曾
fwfj	替
jber	朂
wglj	會
jhgi	朄
fcjn	朅
uljr	朆
wglf	朇
eeee	月
efqn	朊
ewvt	朌
ewyc	朎
ebmh	朏
eqkg	朐
muan	朑
emww	朒
eqiy	朓
eyve	朖
yvce	朗
ecwt	朘
mwme	朙
ynje	朚
eykb	朜
adwe	期
eamd	朠
erbt	朡
ahng	朢
eujf	朣
muoe	朥
eued	朧
ssss	木
sghy	朩
fqyi	朮
snhh	朻
styy	杁
sfnn	杇
scyy	杈
swyy	杋
sgqn	杌
sftt	材
svyy	杒
sqyy	杓
stan	杔
sdyy	杖
ynsu	杗
sayy	杙
stnn	杚
gkii	束
sgqt	杤
synn	杧
sitt	杪
sfqn	杬
sgmh	杮
gjii	東
sqwy	杴
stfh	杵
swcy	杸
swxn	杹
snhf	杻
scnh	杼
wcsu	枀
squg	枃
sgah	枅
sxxn	枇
xxsu	枈
sqbh	枊
swvt	枌
swgn	枍
sfwy	枎
smfg	枏
sgxg	枑
saht	枒
swyn	枔
stdy	枖
smwy	枘
sdbn	枙
srhy	枛
sfcy	枝
svfh	枠
stah	枡
synt	枦
smqn	枧
swcu	枩
smyg	枬
shkg	枮
sguf	枰
sckg	枱
cksu	枲
skwy	枳
skvt	枴
skgn	枵
sqkg	枸
sqnn	枹
sgsy	枺
sann	枻
ansu	枼
fasu	枽
sfjg	枾
sfah	枿
shcy	柀
spxn	柁
stbn	柂
swyc	柃
sgmw	柄
snxn	柅
sugh	柈
stpy	柉
stuy	柊
ways	柋
sngk	柌
smdy	柍
swfy	柎
iasu	柒
cnhs	柔
scnt	柕
svkg	柖
swkg	柗
sjhh	柛
sryy	柝
sthf	柞
sqay	柢
srwy	柣
sjgf	查
sjgg	柦
srcy	柧
sdmh	柨
saqy	柩
sxet	柪
sxjh	柫
sdcy	柭
sbmh	柮
sskg	柯
sntt	柲
hxsu	柴
skqn	柷
sdhg	柸
stnt	柹
sket	柺
segf	査
symh	柿
srgq	栃
ipsu	栄
gkhu	栆
stgg	栍
syni	栐
sqjg	栒
dhvs	栔
sahh	栕
sqqy	栘
sudy	栚
seee	栛
sgmi	栜
stdg	栝
gdfs	栞
suah	栟
wtfs	栠
sdjg	栢
swtf	栣
suiy	栤
uqws	栥
syth	栦
sjxt	栧
suqw	栨
sriy	株
sdhb	栫
sqcn	栬
sdmj	栭
sdeg	栯
sway	栰
sawy	栱
sftn	栲
sftx	栳
stmy	栴
sgqj	栵
sldy	栶
sxjg	栺
swdy	栿
qahs	桀
stgs	桁
sigq	桄
sqdb	桅
vksu	桇
spvg	桉
udsu	桊
sgxw	桋
sdfn	桍
sabh	桏
cccs	桑
sfkg	桔
stlg	桖
sbsy	桗
swnn	桘
sctg	桙
svqy	桚
shgh	桛
sivg	桜
sqah	桝
sdxy	桟
svfy	桪
siit	桫
iits	桬
sdfe	桭
sdhk	桮
skgg	桯
sqak	桰
sgva	桱
sfpb	桲
scdf	桳
sebg	桴
sevg	桵
sceh	桶
sqeh	桷
srdh	桸
syve	桹
sgjn	桺
stdh	桻
swiu	桼
swwf	桽
svtk	桾
sjfh	桿
sgki	梀
sgiy	梂
stfp	梃
ssgg	梄
stxy	梅
sdtb	梆
rrsu	梊
skeg	梋
swgs	梌
srxn	梍
stfk	梏
sxxf	梐
sqto	梑
sufh	梓
srgc	梔
svyn	梕
shqn	梘
skkh	梙
sqkq	梚
sngb	梛
sdww	梜
snny	梞
wvgs	梟
skkg	梠
spfq	梡
sieg	梢
smwn	梣
smwv	梤
pwcs	梥
sgkg	梧
sjfg	梩
sgku	梪
svpc	梫
smgn	梬
scwt	梭
snnk	梮
saah	械
slsy	梱
swkq	梲
sthp	梴
sswy	梵
sntn	梶
hkcs	梷
stjh	梸
srgw	梹
ssgh	梺
swxj	梻
sdtf	梼
sfny	梽
sgus	梾
slpy	梿
sukq	棁
tqts	棃
stgi	棅
swga	棆
swcn	棇
sgeg	棈
adws	棊
sesy	棌
spws	棎
hdhs	棐
shdd	棑
sukg	棓
sqaj	棔
sdey	棖
gmii	棗
syny	棙
seeg	棚
syce	棛
sywu	棜
sldg	棝
slty	棞
sgji	棟
ipks	棠
smum	棡
smun	棢
sviy	棣
sajg	棤
srrs	棥
sqvh	棦
saay	棧
ynts	棨
sooy	棪
sudb	棬
sywy	棭
sssu	森
stfg	棰
sccc	棳
sebc	棴
sjsy	棵
ssww	棶
sbcy	棷
bcsu	棸
awvs	棻
sswv	棼
sswn	棽
sspw	棾
seqn	棿
spqb	椀
shaw	椃
suvg	椄
smfk	椆
shwy	椇
sqoy	椈
yqas	椉
sywf	椊
syki	椋
spwa	椌
swyg	椎
sgfg	椏
sndg	椐
srtf	椑
shgc	椒
sgey	椓
svlg	椔
swvs	椕
spgh	椗
sspu	椘
sjjg	椙
sawx	椛
fwms	椝
srsu	椞
sgcj	椡
slgy	椢
smaw	椣
sude	椦
swgb	椧
sowf	椨
sovw	椩
suog	椪
sulh	椫
speg	椬
scde	椮
smdj	椯
sbbh	椰
stjt	椱
snkh	椲
slge	椳
swdc	椴
snhc	椵
srbt	椶
sdgy	椷
sytb	椸
sadn	椹
swks	椺
sajv	椻
stis	椼
suej	椾
sdwj	椿
stky	楀
sptk	楁
ssjg	楂
sngf	楃
syna	楄
sgkl	楅
ssvg	楆
smnk	楇
snhe	楈
sadk	楉
sgkj	楋
sute	楌
splh	楎
sdff	楏
slwj	楐
swgd	楑
slny	楒
swtj	楓
sdhd	楔
sdae	楕
svcb	楖
svgp	楗
scns	楙
sadg	楛
sgli	楝
slyt	楞
syks	楟
sfmf	楠
susg	楢
snhg	楣
sqrn	楤
segc	楥
spgg	楦
samd	楧
shmy	楨
swgr	楩
sans	楪
skbg	楫
sjqn	楬
ogui	業
sftj	楮
srfh	楯
sewy	楰
sdwd	楱
safs	楳
syuh	楴
sbkg	極
stoy	楸
sbcl	楹
srgg	楻
risu	楽
stjg	楿
skkk	榀
spgf	榁
sslf	榃
sjlg	榅
swgj	榆
spyh	榊
svvv	榋
snuh	榌
snie	榍
sdht	榎
suwl	榏
snae	榐
sxuu	榒
sntl	榓
syvb	榔
sgoj	榗
tdas	榘
sawk	榙
sugo	榚
sdwt	榛
srsc	榝
sdri	榞
spuf	榟
spjw	榠
sgxi	榡
spge	榢
serm	榣
sqas	榤
sjiq	榥
fjfs	榦
sahd	榧
shay	榩
scoy	榪
swyf	榫
sfke	榬
stmf	榭
oops	榮
sjff	榯
syke	榱
slwl	榲
sotp	榳
sabg	榵
sovk	榶
spwy	榷
sfjf	榸
srhw	榹
euds	榺
sjng	榻
sfcl	榼
sexd	榽
smeg	榾
smgu	榿
ykms	槀
sbti	槂
tews	槃
sgkh	槅
saqj	槆
sxhw	槇
sutd	槉
ubts	槊
samf	構
swnp	槌
swyk	槍
suga	槎
suvo	槏
kkss	槑
syxl	槒
samy	槓
srdf	槔
shjs	槕
fpds	槖
sdkk	槗
sfhw	槙
ssmy	槚
swyb	槜
swvm	槝
sujn	槞
sccs	槡
snrg	槢
spdk	槣
sdhv	槥
sovh	槦
lrsu	槧
sykb	槨
rxas	槩
srxq	槪
sgjf	槫
sdfy	槬
sdhy	槭
scce	槮
stdp	槰
ssgo	槱
sqef	槲
nhds	槳
sync	槴
skkn	槵
slag	槶
fwfs	槷
srif	槹
sovi	槺
sfwq	槻
fwhs	槼
sgmj	槽
sjlc	槾
sakg	槿
syud	樀
sbgi	樄
syrc	樆
swhe	樇
sujq	樈
sdrr	樉
srrd	樊
scep	樋
sxfm	樌
sgmy	樍
spwj	樎
slxi	樏
shlo	樐
sivs	樑
spnm	樒
svjs	樔
sgkw	樕
wgkk	樖
sffn	樗
sipf	樘
ssfi	標
sonx	樚
snwe	樛
soao	樜
shag	樝
sakk	樞
sujf	樟
swvo	樢
sugi	樣
swhs	樤
sath	樥
styg	樦
snig	樨
sahf	樫
stln	樬
sadf	樭
ssoy	樮
sfvg	樰
safy	樲
svaf	樳
sujy	樴
swyo	樵
sjbc	樶
ssbc	樷
skhm	樻
snbb	樼
susf	樽
sfhy	樾
skkl	樿
sycl	橀
stqj	橁
susd	橂
swxc	橃
srlo	橅
rlgs	橆
stfn	橇
sffq	橈
soqh	橉
sgjl	橊
stdk	橋
sueg	橌
sugg	橍
stol	橎
sugk	橏
gkhs	橐
sdui	橑
sffc	橒
seph	橓
sykt	橔
sipt	橕
sips	橖
saje	橗
swgu	橙
svfj	橚
sduw	橛
dubs	橜
ssjf	橝
syqe	橠
spnh	橣
nnns	橤
sulj	橧
sfam	橨
soof	橩
sqdo	橪
sduf	橭
sqym	橮
sooe	橯
seue	橳
shxi	橴
saet	橵
sfja	橶
sruq	橷
sjjj	橸
sujg	橺
sfup	橽
skks	橾
sglg	橿
sylg	檀
sylt	檁
smae	檂
beas	檃
shdy	檅
sook	檆
swym	檇
sawl	檋
slhd	檌
sogi	檏
sflg	檑
sswj	檒
seac	檓
lbws	檕
suep	檖
nkus	檗
snkf	檘
shnn	檙
sssh	檚
smnp	檛
skby	檝
sqeg	檞
aqks	檠
slff	檡
swgw	檢
sfwk	檣
sutp	檤
sugy	檥
ssfj	檦
saqn	檧
sugw	檨
sris	檪
spwi	檫
sape	檬
sqve	檭
sfnf	檮
sfkf	檯
sxrh	檰
staw	檱
slgf	檲
spgm	檳
sawc	檴
sdak	檶
sgwr	檷
spns	檸
sytk	檹
sahl	檻
sean	檼
sfdj	檽
djes	檿
sadi	櫀
spnj	櫁
snwy	櫂
stgo	櫄
syuj	櫅
srqf	櫆
shcm	櫇
sutk	櫊
sthy	櫋
sdet	櫌
srrm	櫍
soaw	櫎
ssdp	櫏
llls	櫐
slll	櫑
sawi	櫒
sqoj	櫓
sday	櫔
sfwm	櫕
shan	櫖
saly	櫗
sdhn	櫘
saak	櫙
sukk	櫚
stvb	櫛
sflm	櫝
sxxe	櫞
srxs	櫟
sowc	櫠
stfj	櫡
slvt	櫢
salp	櫣
stuj	櫤
sont	櫦
syfj	櫧
shal	櫨
suqe	櫩
sdth	櫪
gefs	櫫
susq	櫬
svcg	櫭
sgkk	櫮
sqot	櫯
syle	櫰
btws	櫱
scne	櫲
sued	櫳
sgkm	櫴
sawo	櫵
spdn	櫶
stxg	櫷
segg	櫸
savj	櫹
sfkk	櫺
smmv	櫻
swwg	櫼
seri	櫾
smas	欁
saif	欂
sqky	欃
segr	欅
sbbb	欇
smwk	欈
sogc	欉
saky	權
shhy	欋
sady	欌
sawe	欍
slxy	欏
sgmx	欐
stfm	欑
sipo	欓
shhc	欔
skkt	欕
sahq	欖
saui	欗
snij	欘
slli	欙
sxgj	欚
sfae	欛
sgke	欜
sfkw	欞
sakq	欟
uqwy	次
jqwy	欥
qkqw	欨
vkqw	欩
bmqw	欪
rhqw	欫
ldqw	欭
ubtw	欮
fkqw	欯
tlqw	欰
hmaw	欳
yvcw	欴
xtdw	欵
gkiw	欶
rdmw	欷
ctdw	欸
dskw	欹
adww	欺
ooqw	欻
cccw	欼
qqwy	欽
qeqw	欿
sfiw	歀
mdmw	歂
tfew	歃
mnmw	歄
sfqw	歅
ujqw	歆
jqww	歇
wgew	歈
ykmw	歊
rhaw	歋
wngw	歍
akfw	歎
akgw	歏
yumw	歒
rwyw	歓
haow	歔
fkuw	歖
vfjw	歗
ooow	歘
uguw	歚
lqjw	歜
lfuw	歝
jxxw	歞
akkw	歡
fhny	武
hfcy	歧
hitr	歩
dhgh	歪
hang	歫
hteu	歬
hffy	歭
hhhf	歮
hobj	歯
vyvh	歰
htgf	歱
hdgy	歲
hgmy	歵
hxjy	歶
dtth	歷
gqrh	歽
gqqr	歾
gqqc	歿
gqtd	殀
gqeg	殂
gqmd	殃
gqwe	殄
gqtg	殅
gqtl	殈
gqqj	殉
gqga	殌
gqeb	殍
gqdw	殎
gqgy	殏
gqgi	殐
gqdq	殑
gqvi	殔
gquk	殕
gqdn	殗
gqbg	殛
gqas	殜
gqdt	殝
gqkm	殞
gqjl	殟
gqah	殢
gqag	殣
gqtr	殤
gqpw	殥
gqwo	殦
gqho	殩
gqfu	殪
gqkl	殫
gqlf	殬
gqgg	殭
gqww	殮
gqfm	殰
gqfy	殱
gqwg	殲
wdwc	段
ygwc	殶
fnwc	殸
atdc	殹
fpwc	殻
rdec	殽
ftjc	殾
nawc	殿
lkwc	毄
akkc	毆
eowc	毇
qytc	毈
atdw	毉
fnwk	毊
xnny	母
txfj	毎
fxdf	毐
txyk	毓
xxnt	毖
lxxb	毘
qkxy	毚
tfni	毜
tfne	毝
xxtn	毞
ittn	毟
ektn	毠
tfns	毢
wcqn	毤
btfn	毦
tfnq	毨
tfng	毪
ykpn	毫
tfny	毬
gkun	毭
ritn	毮
tfno	毯
tfnk	毰
tfnn	毳
tfnd	毴
jhtn	毷
wgen	毹
daen	毻
tfnp	毽
jntn	毾
cccn	毿
lvtn	氀
fitn	氂
imkn	氅
tfnj	氆
ylkn	氈
kkkn	氉
apfn	氋
hhwn	氍
llln	氎
qayi	氐
qafj	氒
ynna	氓
rntr	氕
rnbr	氖
rnri	気
rnjj	氘
rnmj	氙
rnkj	氚
rnjd	氜
rnmw	氝
rngw	氞
rnxj	氟
rntu	氡
rnld	氤
rnsf	氥
rnyw	氦
rnpv	氨
rndq	氪
rngg	氬
rngi	氭
rnvi	氯
rnge	氰
rnjr	氱
rnll	氳
iiii	水
iyyg	氵
ihyy	氺
ignn	汅
tyiu	汆
ingg	汈
icyy	汊
iqyy	汋
ivyy	汍
iwyy	汎
itan	汑
iynn	汒
itnn	汔
itfh	汘
igfh	汙
ifnn	汚
iqan	汦
igah	汧
ifjh	汫
fjiu	汬
imwy	汭
iqug	汮
idcy	汯
idyy	汰
ircy	汳
iyhy	汴
iwyn	汵
inwy	決
itgh	汼
iwvt	汾
icnh	汿
ifqn	沅
icqn	沇
ipqn	沈
pqii	沊
idny	沋
igbn	沌
igxg	沍
iwxn	沎
iavt	沏
inhf	沑
ighn	沔
iqrt	沕
gdiu	沗
ixxn	沘
iitt	沙
igmh	沛
ithn	沜
irhy	沠
inyy	沢
iwry	沨
igsy	沫
ifiy	沬
ipxn	沱
itbn	沲
iwet	沴
ivkg	沼
ingk	泀
imkg	泂
iqkg	泃
ilwy	泅
irwy	泆
iekg	泇
ituy	泈
ifah	泋
ibmh	泏
ibet	泐
ixet	泑
ixcy	泓
ifcy	法
iqtb	泖
ituf	泘
iguf	泙
ihxn	泚
iqay	泜
iryy	泝
ighg	泟
iwyc	泠
inyw	泤
invn	泦
igny	泧
itgg	泩
iyxy	泫
ipwy	泬
iwfy	泭
inan	泯
imdy	泱
itnt	泲
iyni	泳
ivey	泿
itey	洀
iyoy	洂
idoy	洃
ilkg	洄
igmf	洅
ibig	洆
ildy	洇
iqdb	洈
irgk	洉
idhb	洊
iugh	洋
igqj	洌
iahh	洍
ithg	洎
idmj	洏
itgs	洐
iwdy	洑
igmi	洓
iffy	洔
iweg	洕
ikgd	洖
itfq	洗
iftn	洘
iriy	洙
itah	洚
tkiu	洜
ipvg	洝
imgk	洞
igxw	洟
ictg	洠
idiy	洡
iwgg	洤
idjg	洦
iywr	洨
iawy	洪
itlg	洫
iwgq	洬
iagg	洭
iqiy	洮
dhvi	洯
iang	洰
iyth	洲
iuah	洴
iqjg	洵
igcf	洷
iigq	洸
igjg	洹
idfn	洿
imag	浀
iudy	浂
iqvh	浄
ijgh	浉
iway	浌
iutt	浐
inyu	浕
iefy	浖
igiy	浗
intn	浘
irgw	浜
ikhy	浞
iwht	浟
ifpb	浡
igku	浢
ipfq	浣
ipdc	浤
ikcn	浥
igey	浦
ikgg	浧
ipsy	浨
ipwf	浫
ijfg	浬
igjr	浭
igkg	浯
itjh	浰
idfe	浱
itdh	浲
iaye	浳
iwwk	浴
imye	浵
iptg	浶
itxy	海
idww	浹
inkh	浺
imwk	浻
iqkq	浼
ievg	浽
ifoy	浾
ihqn	涀
iset	涁
ilsy	涃
imgn	涄
ijfh	涆
ivyn	涊
ipdy	涋
iftb	涍
ithp	涎
itfp	涏
itry	涐
igki	涑
ivtk	涒
ikeg	涓
imwn	涔
iuxt	涕
iwug	涖
iwkq	涗
ictd	涘
iynd	涙
iukq	涚
ifpq	涜
ikmy	涢
iphn	涫
ifuf	涬
iepc	涭
inmj	涮
idff	涯
iccc	涰
idey	涱
ipwa	涳
ipqb	涴
itfg	涶
igji	涷
ildg	涸
indg	涺
iwfk	涻
iqaj	涽
iijg	涾
iuvg	淁
ijgf	淂
iudb	淃
irde	淆
iadw	淇
inbm	淈
ijsy	淉
iqeg	淊
issy	淋
iimk	淌
imfk	淍
idwg	淎
ijgd	淏
ijjg	淐
iayt	淓
ifhg	淔
ifwf	淕
ihjf	淖
ipfi	淙
iyny	淚
iecn	淝
iswc	淞
imaw	淟
ilgj	淠
iooy	淡
iakg	淢
ieqn	淣
iywu	淤
ixgi	淥
ipnt	淧
ifwt	淩
iwga	淪
iyns	淭
iyce	淯
ihaw	淲
iykb	淳
iqrn	淴
ijgg	淵
isww	淶
igmg	淸
iiiu	淼
iahg	淽
irmh	淿
idfa	渀
iiiy	渁
ijyy	渂
iadk	渃
ihdd	渄
iuaj	渆
ijqx	渇
iyjg	済
ihiy	渋
idsk	渏
irtf	渒
iefw	渓
iudj	渕
icns	渘
iftj	渚
idgy	減
iwgj	渝
iuth	渞
iyks	渟
ians	渠
iwtj	渢
isjg	渣
iyuh	渧
itky	渪
iask	渮
ijag	渱
ixbg	渳
ialg	渵
iamd	渶
iywq	渷
iqyg	渹
ihit	渺
iith	渻
iugd	渼
ifky	渽
iwgd	湀
irwk	湁
irdf	湃
inhg	湄
igli	湅
iueg	湇
iafs	湈
intd	湉
iwye	湌
imdj	湍
idmd	湎
idmy	湏
isrg	湐
inhe	湑
ikbg	湒
iwvl	湓
iuej	湔
ivgp	湕
ideg	湖
ifff	湗
iyod	湙
itxn	湚
ixxr	湝
ihmy	湞
irgg	湟
imdo	湠
ijmy	湡
igkl	湢
innj	湣
iytb	湤
ijtg	湦
icee	湧
ihdy	湨
itgf	湩
ixge	湪
itoy	湫
toiu	湬
iusg	湭
idhd	湱
iegc	湲
ifmf	湳
iuog	湴
iugy	湵
idwj	湷
iykw	湸
idjf	湹
iwks	湺
iykj	湻
ieag	湼
igvl	湽
iamm	満
iaps	溁
igkj	溂
imtg	溄
iovg	溇
iyto	溈
ivcq	溉
inhc	溊
ibcl	溋
iwfq	溌
igoj	溍
isff	溎
iovk	溏
idri	源
iimy	溑
iuvo	溓
iugo	溔
ipfe	溕
iwyf	準
itux	溗
ifcl	溘
idwi	溙
iawk	溚
iamf	溝
icyj	溞
ipjw	溟
iuga	溠
ijff	溡
iwwa	溣
icoy	溤
igef	溥
imgt	溦
ifsy	溨
iwno	溩
iufc	溬
ilwt	溭
iwnh	溮
imgu	溰
idwt	溱
iehc	溲
ithy	溴
irvc	溵
ipwk	溶
ilge	溷
igxi	溸
ifpi	溹
ijng	溻
igxf	溼
irqc	溾
ilug	溿
iyxl	滀
iwcn	滃
iwyk	滄
igkh	滆
iykk	滈
ijiq	滉
irno	滊
iwhs	滌
ibhj	滍
iwru	滏
iqas	滐
imeg	滑
iskk	滒
ipuf	滓
ieeg	滔
eudi	滕
ierm	滛
iujn	滝
idfk	滣
iywt	滧
icnm	滪
iwhe	滫
ijaf	滭
ihae	滮
iaqh	滯
iujq	滰
ipfc	滱
iyuk	滳
ipnm	滵
igqt	滶
ihlo	滷
iytf	滸
ihaf	滹
iwhn	滺
iutg	滻
iovh	滽
iamy	滿
fnwi	漀
iqoy	漁
isfi	漂
iphc	漃
imdf	漄
ivjs	漅
ithh	漇
iwfi	漈
ionx	漉
ilvg	漊
ibtg	漋
ilag	漍
itwh	漎
infy	漏
irxq	漑
ixkj	漒
igmj	漕
iftt	漖
itln	漗
igjf	漙
iakk	漚
iudi	漛
issf	漜
inrg	漝
iehq	漞
iipf	漟
itjr	漡
ilpy	漣
issv	漤
fiti	漦
itdp	漨
iqtk	漪
ijlc	漫
igmy	漬
iada	漭
iovi	漮
imee	漰
igkw	漱
impi	漴
ikkn	漶
igho	漹
idrr	漺
inwe	漻
inig	漽
xidm	潁
imug	潂
itte	潃
igkt	潄
itle	潈
imjx	潉
iwgc	潊
iumt	潎
icnk	潏
iwyo	潐
iqke	潒
igjn	潓
irlo	潕
iggc	潖
iwys	潗
itol	潘
ieto	潙
ivfj	潚
iwgn	潝
ieqo	潟
innw	潠
iykt	潡
iuyy	潣
isoy	潥
idui	潦
iulj	潧
itli	潨
ilaw	潩
itdj	潪
ikkl	潬
isjf	潭
ivaf	潯
ifpu	潱
itie	潲
infj	潳
iaet	潵
ilfo	潶
itvg	潷
isse	潸
isss	潹
inbb	潺
itwi	潻
iujf	潼
iuoj	潽
ioqh	潾
ilnh	潿
ivyh	澀
ihhh	澁
edmi	澃
ivfg	澅
iyct	澈
inbt	澉
iusf	澊
ijyi	澋
iadr	澌
ifkf	澍
ifke	澎
ikkm	澏
iffc	澐
igjl	澑
iadm	澒
ittt	澓
irtk	澔
iagf	澕
iusy	澖
iujg	澗
issj	澘
iego	澙
itmn	澚
iqgj	澛
ipnh	澝
ihad	澞
iylt	澟
ikks	澡
iipl	澢
ifjf	澣
itaw	澨
erri	澩
ifwc	澪
iajy	澫
iuqm	澬
ihqo	澯
iwgw	澰
iogi	澲
itmd	澳
iusr	澵
iylg	澶
ijly	澷
idgn	澸
iqdy	澹
iuep	澻
inkf	澼
ifup	澾
issi	澿
iryt	激
ilqj	濁
iouo	濂
imnp	濄
ipvc	濅
ifam	濆
ifwk	濇
ikby	濈
ihwy	濉
issh	濋
tgjj	濌
ihnn	濎
iggt	濏
ijfj	濐
iuto	濓
ilfj	濖
iajh	濗
ipns	濘
iooo	濙
ioos	濚
iape	濛
ivhl	濜
iadi	濝
ithj	濞
iyuj	濟
iyke	濠
ifdj	濡
inyf	濢
ifnf	濤
iqpw	濥
iean	濦
iogf	濧
iuxn	濨
iawc	濩
igec	濪
ihph	濬
iafl	濭
ipgm	濱
ifpc	濲
itfj	濳
iutd	濶
iiay	濷
imaa	濺
ibkm	濻
irxs	濼
ifwm	濽
ihan	濾
iday	濿
idet	瀀
iufe	瀁
iqoj	瀂
imjr	瀃
itvb	瀄
ioaw	瀇
inpl	瀈
ipeo	瀉
itel	瀊
iptl	瀋
iono	瀌
iojf	瀍
ialy	瀎
ifhy	瀐
iswk	瀒
itmt	瀓
ifwy	瀖
ipdn	瀗
iusq	瀙
ifjn	瀚
igeh	瀞
iooi	瀠
ibdp	瀡
ikhp	瀢
ihqg	瀣
iyle	瀤
inyk	瀥
igej	瀦
iued	瀧
igkm	瀨
itwm	瀩
ilwj	瀭
ifss	瀮
iook	瀯
ixgr	瀰
ildj	瀱
iwgt	瀲
iaoo	瀳
immv	瀴
iolw	瀵
iahk	瀶
inlw	瀷
iwwg	瀸
iqky	瀺
ifly	瀻
ipah	瀽
iugi	瀾
itxi	瀿
ifsh	灀
iuri	灁
ielf	灂
imdu	灃
ibbb	灄
illf	灅
iaal	灆
iogc	灇
ihhy	灈
ivky	灉
ionc	灋
iaky	灌
iuuw	灍
imal	灎
iooq	灐
igmx	灑
itfm	灒
yxxi	灓
imac	灔
iyry	灕
iosd	灖
ijyg	灗
iipo	灙
ierq	灚
iukl	灛
ijym	灝
ifae	灞
inij	灟
iahq	灠
iaui	灡
igke	灢
iyxx	灣
riri	灥
ijxm	灦
imdc	灧
iujm	灨
imdl	灩
isre	灪
oooo	火
oyyy	灬
qyou	灸
otan	灹
owcy	炂
wvou	炃
onhf	炄
odhy	炋
owjh	炌
orcy	炍
odhh	炐
oitt	炒
onwy	炔
oywn	炕
owxb	炛
oyhy	炞
ojgg	炟
oghg	炡
osyy	炢
oskg	炣
ovkg	炤
oxjh	炥
odcy	炦
otbn	炧
opxn	炨
owyc	炩
obmh	炪
oang	炬
mdou	炭
qnou	炰
ckou	炱
ockg	炲
omdy	炴
otuy	炵
oygg	炷
othf	炸
okqn	炾
otmy	炿
otuf	烀
oywr	烄
otlg	烅
otgs	烆
owgg	烇
gqjo	烈
qmwo	烉
ough	烊
wsou	烋
owsy	烌
otfq	烍
gaou	烎
wngo	烏
otey	烐
oqiy	烑
oaay	烒
offg	烓
omgk	烔
dgoy	烕
foxy	烖
oynw	烗
oawy	烘
owgk	烚
ogjg	烜
bigo	烝
oshy	烞
oawu	烡
opta	烢
odoy	烣
oahh	烥
oudy	烪
ordh	烯
oebg	烰
omwk	烱
rrou	烲
ogva	烴
oaqy	烵
opfq	烷
otxy	烸
oyve	烺
othp	烻
ooff	烾
omye	烿
kqwo	焁
ofoy	焃
vtko	焄
otfk	焅
okeg	焆
oieg	焇
ynno	焈
nhdo	焋
ocwt	焌
ouxt	焍
bkco	焏
ogkg	焐
olsy	焑
okkg	焒
owyk	焓
oqhj	焔
onnk	焗
ssou	焚
ojxx	焜
oqaj	焝
oajg	焟
rlgo	無
opwa	焢
bcou	焣
owfo	焤
opqb	焥
wyou	焦
owcn	焧
ojeg	焨
oeeg	焩
opwx	焪
ojqr	焬
oopw	焭
orqw	焮
ohjf	焯
ooou	焱
oywy	焲
owyg	焳
oyce	焴
omum	焵
qdyo	然
jjou	焸
omun	焹
ojta	焺
ojjg	焻
ofaq	焼
jeou	焽
oovw	焿
onbm	煀
oadn	煁
oakf	煂
odff	煃
otgf	煄
owdc	煅
onhc	煆
oplh	煇
owtj	煈
opgg	煊
ojtg	煋
orgg	煌
otoy	煍
ogkl	煏
oamd	煐
onkh	煒
omdj	煓
oohk	煔
ahho	煕
oegc	煖
odmd	煗
odgy	煘
jano	煚
hhou	煛
ojug	煜
onhg	煝
oleg	煟
oans	煠
ovgp	煡
jqko	煦
olge	煨
odmy	煩
ousg	煪
ouey	煫
ojgr	煬
vgqo	煭
ftjo	煮
oxxr	煯
okkk	煰
omnk	煱
wkso	煲
ojlg	煴
ofmf	煵
ojgh	煶
oykw	煷
oyna	煸
oamf	煹
ovep	煺
oqbt	煼
oldn	煾
ogef	煿
ojiq	熀
oeee	熁
orno	熂
olwl	熅
oykk	熇
taho	熈
okmy	熉
cexo	熊
ouwy	熌
opkk	熍
oerm	熎
opjw	熐
oopo	熒
owno	熓
oamy	熕
oqyl	熘
ojaf	熚
osfi	熛
otln	熜
oahf	熞
ykbo	熟
onrg	熠
olvg	熡
otdp	熢
omwy	熣
onug	熤
ocep	熥
oiwy	熦
twwo	熧
nfio	熨
oync	熩
otqq	熪
ooao	熫
gqto	熬
dhdo	熭
oakw	熯
oakk	熰
fwfo	熱
xodm	熲
ojlc	熳
omjx	熴
oyuk	熵
ojbc	熶
oulj	熷
oaqj	熸
fkuo	熹
ofkk	熺
owgn	熻
ovfj	熽
okkl	燀
oagf	燁
osjf	燂
qeoo	燄
otdk	燆
ousf	燇
oykt	燉
ooos	燊
owyo	燋
ofam	燌
ocnk	燏
ooqh	燐
oujf	燑
srro	燓
otol	燔
akuo	燕
ovaf	燖
oueg	燗
ouyy	燘
ijgo	燙
nhao	燛
ouny	燜
ojyi	燝
wyqo	燞
otmd	燠
olff	燡
oajy	燤
ouep	燧
ougy	燨
oryt	燩
oaqn	燪
oouo	燫
oeac	燬
yooc	燮
ofwc	燯
oept	燰
oujn	燱
oeem	燲
ojvo	燳
owgj	燴
ofup	燵
omae	燶
oyli	燷
gego	燹
oyks	燺
otgo	燻
ovhl	燼
ofnf	燽
fnao	燾
ofoo	爀
oahl	爁
afwo	爇
ohan	爈
ovln	爉
oono	爊
ooaw	爌
orxs	爍
opdi	爎
odth	爏
ohal	爐
oawo	爑
qodi	爒
ouqe	爓
yooo	爕
ohqe	爘
oyke	爙
owga	爚
oogc	爜
oelf	爝
ojjj	爞
oaky	爟
ohhy	爠
oajj	爡
oipo	爣
oaui	爤
onij	爥
oahq	爦
ofkw	爧
emgo	爨
osre	爩
rhyi	爪
rhyc	爬
rhyn	爮
emff	爯
egdc	爰
etno	爲
etnb	爳
laky	爴
wrbb	爺
rreg	爼
nhdh	牅
nhdk	牆
thgn	片
thgg	牉
thgk	牊
thga	牋
thgf	牌
thgj	牏
thge	牐
thgs	牒
thgy	牖
thgh	牗
thgm	牘
ahte	牙
ipkt	牚
ptgj	牢
tvyy	牣
tynn	牤
ttfn	牦
tywn	牨
ttgh	牪
wayg	牮
tskg	牱
ttgg	牲
tqay	牴
udtg	牶
twgg	牷
tpbg	牸
tffy	特
tdny	牻
tgkg	牾
ttfk	牿
tqtg	犂
tukg	犃
tdsk	犄
tmum	犅
tgtg	犇
tudb	犈
tykb	犉
thwy	犋
tvgp	犍
fffg	犎
ttuf	犐
tqbt	犓
trno	犔
tath	犕
oopg	犖
tpdk	犗
ossg	犘
tcce	犙
nfig	犚
fitg	犛
tykt	犜
ttdk	犞
xkjg	犟
tday	犡
tflm	犢
tvln	犣
tlcx	犤
tono	犥
tjai	犦
tugy	犧
wywg	犨
tvrg	犩
tutt	犪
qttt	犭
dcyi	犮
qtbn	犯
qtvy	犱
qtft	犲
qtqy	犳
qtfh	犴
qttn	犵
qtcg	犸
qtyw	犺
qtgh	犻
qtat	犽
qtdy	犾
qtyh	犿
nhdy	狀
qtcq	狁
qtgg	狂
qtnf	狃
qtoy	狄
qttf	狅
qtkh	狆
qtsy	狇
qtdg	狉
hdyu	狊
qtfi	狋
qttg	狌
qtqn	狍
qtlh	狎
qttb	狏
qtry	狐
qtwc	狑
qtxj	狒
qthc	狓
qtnx	狔
qtxe	狕
qtpw	狖
qtgy	狘
qtrg	狛
qtqi	狝
qttk	狢
qtqj	狥
qtmf	狦
qttd	狧
qtad	狨
qtfx	狫
qtws	狳
qtxf	狴
qtrh	狶
qtke	狷
qtdw	狹
qtyg	狺
qtct	狻
qtye	狼
qtmy	狽
qtrr	狾
qttp	狿
qtit	猀
qttj	猁
qtjf	猂
qtyi	猄
qthd	猅
qthw	猇
qtrf	猈
qtaw	猉
qteq	猊
dydy	猋
swwy	猌
qtsw	猍
qtjx	猑
jedy	猒
qtjs	猓
qtpi	猔
qtdk	猗
qtrj	猘
qtwy	猚
qtyf	猝
qtwk	猞
qtig	猟
qtmw	猠
qtde	猢
qtrt	猣
qtle	猥
qtec	猨
qtjg	猩
qtmj	猯
qtdd	猰
qtcs	猱
qtjn	猲
qtnc	猳
qtwd	猴
qtya	猵
qtug	猶
usgy	猷
qtnh	猸
qtsg	猹
qtem	猺
qtbi	猻
qtme	猾
qtfe	猿
qtco	獁
mgky	獃
qtyy	獄
qtwh	獅
qtuc	獇
qtul	獈
qtdt	獉
qtjc	獌
qtuq	獍
qtuf	獐
qtlr	獑
qtgt	獓
umiy	獘
qtut	獙
qtoh	獜
qtck	獝
qtdi	獠
qteo	獡
ilgy	獣
qtyt	獤
qtan	獦
qthy	獩
qtwj	獪
qtww	獫
qtqg	獬
qtgr	獮
qtto	獯
qtpm	獱
qtfj	獳
qtae	獴
qtvn	獵
qtow	獷
qthl	獹
qtgm	獺
hagy	獻
qtxr	獼
qtay	獾
qtly	玀
qtkt	玁
qtar	玂
yxit	玅
yxyx	玆
gggg	王
gqyy	玖
ggfh	玗
ggng	玙
gnrt	玚
gwcy	玜
gtfh	玝
gfwy	玞
gwjh	玠
gaht	玡
gwvt	玢
gyhy	玣
gdhh	玤
gnwy	玦
gcqn	玧
gwyn	玪
gmyg	玬
gxxn	玭
gwbn	玱
gway	玳
gann	玴
gafg	玵
gguf	玶
gqnn	玸
gyxy	玹
ghcy	玻
ghxn	玼
gqkg	玽
gvkg	玿
ggny	珁
gskg	珂
gmfg	珃
gtgg	珄
gjhh	珅
gckg	珆
gegg	珇
gekg	珈
gnan	珉
gntt	珌
gvgh	珒
gywr	珓
gdhb	珔
geee	珕
gigq	珖
gtfq	珗
gtey	珘
gawy	珙
gldy	珚
gugh	珜
gwgq	珟
griy	珠
ggwu	珡
gvey	珢
gqjg	珣
grmh	珤
gtmk	珦
gqiy	珧
gwgk	珨
gtgs	珩
gffg	珪
gycq	珫
gdgy	珬
gwgh	珮
gftx	珯
givg	珰
gyet	珳
gtry	珴
gkgg	珵
guxt	珶
gfhy	珷
ggkg	珸
gdny	珹
gvtk	珺
gtxy	珻
gtfp	珽
ghqn	現
gkhy	珿
gwyk	琀
gtnh	琁
gkeg	琄
gtbt	琇
gebg	琈
gyck	琉
gahb	琊
grdh	琋
gmwn	琌
gtjh	琍
gfjp	琎
gieg	琑
gtdh	琒
gpfq	琓
gpgh	琔
grtf	琕
gaay	琖
gywf	琗
gqaj	琘
gndg	琚
gpws	琛
gsww	琜
gjyy	琝
jegy	琞
gwyg	琟
gmaw	琠
ghgc	琡
gukg	琣
gqvh	琤
gdsk	琦
gfgy	琧
gjxx	琨
gjjg	琩
gadw	琪
gdwg	琫
gpqb	琬
gviy	琭
gpfi	琮
gphn	琯
gooy	琰
gmfk	琱
ghdd	琲
gssy	琳
ggxx	琵
ggcb	琶
gufq	琷
ghjf	琸
ggsu	琹
gifc	琺
gftj	琽
glwj	琾
gtky	瑀
gjhg	瑁
gnhg	瑂
gdwj	瑃
gpgg	瑄
gjgh	瑅
gjtg	瑆
ggxy	瑇
gcns	瑈
gnnj	瑉
gnkh	瑋
gdmd	瑌
gxxr	瑎
gpwt	瑏
guej	瑐
gxge	瑑
gjgr	瑒
ggli	瑓
gnhc	瑕
gwdc	瑖
gegc	瑗
gbbh	瑘
gvtr	瑙
gdeg	瑚
gamd	瑛
gwgj	瑜
grgg	瑝
ggnt	瑟
gqyl	瑠
gwnh	瑡
gpwk	瑢
gqrm	瑤
gjlg	瑥
gwno	瑦
gdwt	瑧
ggoj	瑨
oopy	瑩
geeg	瑫
iycy	瑬
govk	瑭
gyvb	瑯
gfhw	瑱
guga	瑳
gcyj	瑵
gprw	瑸
gaws	瑹
giph	瑺
gxfm	瑻
ggjf	瑼
gtwh	瑽
gakg	瑾
atdy	瑿
gmwy	璀
gtln	璁
gadf	璂
gyrc	璃
gujq	璄
gvjs	璅
gnwe	璆
ggqt	璈
glpy	璉
gamy	璊
gujf	璋
gpgw	璌
gagf	璍
gxgx	璏
gkhk	璐
grlo	璑
gwgu	璒
gatb	璓
gulj	璔
gias	璖
ijgy	璗
goqh	璘
gdui	璙
gcnk	璚
gvfj	璛
gamw	璜
gkhm	璝
gogw	璞
gjyi	璟
gtol	璠
gwyp	璡
ggjl	璢
gxxy	璣
ggjn	璤
gaqt	璥
gept	璦
ghqo	璨
ghae	璩
gkks	璪
gipl	璫
gryt	璬
gplp	璭
gylg	璮
gggt	璱
guep	璲
grim	璳
gssh	璴
gegw	璵
gvhl	璶
gget	璷
gpgm	璸
gfnf	璹
emgy	璺
gnyf	璻
gahl	璼
gwmy	璽
gyuj	璾
ghph	璿
gfdj	瓀
gawc	瓁
gafl	瓂
glll	瓃
gflm	瓄
grxs	瓅
grrm	瓆
gdet	瓇
gtqi	瓈
gfwm	瓉
gyup	瓋
gyle	瓌
gbdp	瓍
ggkm	瓎
gued	瓏
ghal	瓐
gdth	瓑
gugi	瓓
gmmv	瓔
xgwy	瓕
gyke	瓖
gmwk	瓗
gaky	瓘
gfno	瓙
gtfm	瓚
ghay	瓛
rcyw	瓞
rcyn	瓟
dfny	瓠
sfiy	瓢
udrf	瓣
ykky	瓤
gnnf	瓧
gnnc	瓪
wvgy	瓫
ygny	瓬
pqgy	瓭
gnnv	瓰
gnnn	瓱
dgny	瓳
wycy	瓴
ckgy	瓵
kegy	瓹
dcgy	瓺
ipky	瓽
tvgy	瓾
ukgy	瓿
tfay	甀
tgdy	甁
ynmy	甂
togy	甃
uxxy	甆
thsy	甈
uvoy	甉
lvgy	甊
yumy	甋
akky	甌
alpy	甍
gjhy	甎
fkuy	甏
uljy	甑
rlgy	甒
mmgy	甖
aafy	甙
adwn	甚
aftd	甛
hawf	甝
jtgg	甠
ydtg	產
uttg	産
getg	甤
gjrg	甦
tgte	甧
tehk	甪
gehy	甫
dheh	甭
qreh	甮
pneh	甯
llll	田
lhnh	甲
mhfd	甴
mgnb	甹
lynn	甿
lgjj	畀
mgjj	畁
lqyy	畂
jhqy	畃
ylcy	畆
lqug	畇
lrcy	畈
lfwy	畉
lfjh	畊
lwjh	畍
ldyy	畎
gklf	畐
ylwy	畒
lugh	畔
yklf	畗
lmfg	畘
cdlf	畚
yxlf	畜
flqy	畞
lwtu	畟
lynw	畡
jafk	畢
lffy	畤
ltkg	略
lffg	畦
ltkf	畧
lyey	畩
lwgs	畭
ltxy	畮
lcwt	畯
gjal	畱
lpeg	畳
vflb	畵
ldsk	畸
lpqb	畹
glgg	畺
ludf	畻
ljgr	畼
ltgf	畽
xxal	畿
vlgh	疀
lnwe	疁
lipg	疂
lujf	疃
lglg	疅
lfnf	疇
gkll	疈
lllg	疊
gvhi	疌
nhjg	疍
nhgi	疎
nhyk	疏
xtdh	疑
uygg	疒
utnv	疙
uqyi	疚
ughi	疜
ufnv	疞
udny	疣
uwjk	疥
unwi	疦
uqav	疧
uvfk	疩
uxxv	疪
udee	疬
uwwi	疭
uygd	疰
uafd	疳
uskd	疴
uanv	疶
uqay	疷
ujgd	疸
uwee	疹
utpi	疺
ukwi	疻
uxjk	疿
uqkd	痀
uhkd	痁
uekd	痂
uyxi	痃
ugmw	病
unxv	痆
uwgd	痊
umgk	痌
ugxw	痍
uded	痏
ulkd	痐
uqqi	痑
ugcf	痓
uffi	痔
uvei	痕
ugog	痖
utxi	痗
ugku	痘
uftb	痚
utwv	痜
uied	痟
ucwt	痠
utjk	痢
ufni	痣
uwwf	痤
uukq	痥
ugkd	痦
uiit	痧
ujhc	痩
ujqr	痬
ueed	痭
udei	痮
uphn	痯
uooi	痰
usfq	痲
ussi	痳
utbd	痵
umaw	痶
urmj	痸
urtf	痺
uwyd	痽
ubsk	痾
utvd	痿
uywu	瘀
uywf	瘁
ugfg	瘂
ugey	瘃
ucde	瘆
utgf	瘇
udhd	瘈
uwgj	瘉
uwnd	瘊
uwtj	瘋
ugkj	瘌
ujgr	瘍
uadn	瘎
uftj	瘏
uewi	瘐
umnk	瘑
uplk	瘒
uqmd	瘓
uadd	瘔
unhc	瘕
uujd	瘖
ucyj	瘙
udhn	瘛
uthn	瘜
ulii	瘝
udwf	瘞
uiwe	瘠
uwyk	瘡
utec	瘢
urqc	瘣
uqyl	瘤
uuga	瘥
uhag	瘧
uawk	瘩
uxde	瘬
usfi	瘭
ucce	瘮
uytd	瘯
ulxi	瘰
udwn	瘱
utwh	瘲
unwe	瘳
uujf	瘴
uwfi	瘵
ugkw	瘶
ugkt	瘷
uekw	瘸
uqqy	瘹
unfi	瘺
ulvd	瘻
uajd	瘼
uamw	癀
uttt	癁
ubtg	癃
uwyo	癄
ugjl	癅
uooe	癆
uued	癇
uwxc	癈
ubwc	癊
ugfn	癋
ugyg	癍
ulge	癏
umae	癑
uwgn	癒
uujn	癔
uyxy	癕
ufld	癗
uajy	癘
uenn	癙
uqdy	癚
unac	癜
uyli	癝
utha	癟
uyuj	癠
uufe	癢
utvb	癤
utmt	癥
udth	癧
ufwy	癨
ugkm	癩
utgm	癪
uqog	癬
ummv	癭
uben	癮
uhhy	癯
uvky	癰
ulli	癳
uyxr	癴
uyxw	癵
wgdu	癸
wwcu	癹
wfqb	発
wgku	登
rrrr	白
rqyy	的
rhxn	皉
rdfj	皋
rxbj	皍
rywr	皎
rifj	皐
rtry	皒
rtfk	皓
rjfh	皔
djdj	皕
rpfq	皖
rmfk	皗
srrf	皙
rmgu	皚
rrrf	皛
rgiq	皝
rrdf	皞
rrif	皡
rept	皧
rgjq	皩
relf	皭
hcfh	皯
hcqn	皰
giyc	皳
cwtc	皴
ajhc	皵
sjgc	皶
plhc	皸
hcpl	皹
haec	皻
ylkc	皽
flmc	皾
xhlf	盄
khlf	盅
dylf	盇
dcyl	盋
qblf	盌
fclf	盍
wgkl	盒
igfl	盓
iwyl	盕
gehl	盙
giyl	盚
vilf	盝
aalf	盞
jelf	盟
xgel	盠
vhgl	盡
ldyl	盢
tewl	盤
wynl	盦
edml	盨
fufl	盩
ijgl	盪
xful	盭
hhhh	目
hynn	盳
htnn	盵
hfqn	盶
hqug	盷
hgbn	盹
hwgn	盻
hdhh	盽
ithf	省
hqan	眂
hghn	眄
hrcy	眅
hitt	眇
hpqn	眈
htfn	眊
hniu	県
hary	眍
hfiy	眎
hmdy	眏
hxet	眑
hjhh	眒
hgny	眓
hwet	眕
hkqn	眖
hqkg	眗
duhf	眘
hckg	眙
tghf	眚
hgsy	眜
hpsh	眝
xhnw	眞
fhwu	真
hnan	眠
hqay	眡
qbhf	眢
hrwy	眣
hnxn	眤
hxhf	眥
hvkg	眧
hyxy	眩
hgmw	眪
hugh	眫
hdxy	眬
hffg	眭
hmgk	眮
hgcf	眰
hgxw	眱
hqjg	眴
hqqy	眵
hagg	眶
hctg	眸
hudy	眹
hrey	眽
hyni	眿
wwhh	睂
hieg	睄
hjfh	睅
hpfq	睆
huxt	睇
hkgg	睈
hwwf	睉
hkeg	睊
htry	睋
hqkq	睌
hhqn	睍
hrdh	睎
hlsy	睏
hooy	睒
hwga	睔
hpqb	睕
hfwt	睖
hjqr	睗
lgke	睘
hyny	睙
hdff	睚
hgeg	睛
tqth	睝
hsww	睞
hywf	睟
hudb	睠
hwyg	睢
hlgj	睤
hrtf	睥
hfwf	睦
hqaj	睧
heqn	睨
hviy	睩
lfuf	睪
hgvh	睫
hesy	睬
hmfk	睭
hwgj	睮
nnah	睯
hadk	睰
hnhc	睱
hjtg	睲
hplh	睴
hfky	睵
hdwj	睶
hvgp	睷
hnhg	睸
hftj	睹
hwnd	睺
hpgg	睻
hjgh	睼
hwgd	睽
hpgh	睿
cnhh	瞀
hhdy	瞁
rfhy	瞂
hrfh	瞃
halg	瞄
hkhm	瞆
hopy	瞇
hwcn	瞈
hovk	瞊
hfhw	瞋
hehc	瞍
hpjw	瞑
hykh	瞓
atdh	瞖
hwvo	瞗
hakk	瞘
hajd	瞙
hpgw	瞚
htwh	瞛
hlvg	瞜
hyrc	瞝
hsfi	瞟
hfwq	瞡
alph	瞢
hkkn	瞣
hugg	瞤
hfkk	瞦
hogw	瞨
hsjf	瞫
hdui	瞭
hyct	瞮
hueg	瞯
hnbt	瞰
hagf	瞱
hcnk	瞲
hujf	瞳
hrlo	瞴
hoqh	瞵
hujg	瞷
haas	瞸
hept	瞹
hwgw	瞼
fkuh	瞽
hhpa	瞾
hhwy	瞿
htmt	矀
hton	矁
hkks	矂
hpns	矃
htgo	矄
hnwy	矅
hawc	矆
hape	矇
hrpy	矈
hpgm	矉
hxrh	矊
hday	矋
hoaw	矌
hhwc	矍
hqmt	矎
hthy	矏
hfwy	矐
hhal	矑
halh	矒
hued	矓
haky	矔
yxxh	矕
hgmx	矖
fhfh	矗
hipo	矘
hunt	矙
cnht	矛
cnhc	矝
cnhk	矞
ctdu	矣
xtdy	矤
tdkg	知
qdtd	矦
tdxh	矧
tdtd	矨
tdan	矩
tdte	矪
tdwf	矬
tdtk	矯
tduj	矰
tdac	矱
tdlx	矲
dgtg	石
dgqn	矹
dtan	矺
dtnn	矻
ditt	砂
dmyg	砃
dnwy	砄
dfwy	砆
ddbn	砈
dhdf	砉
dywn	砊
davt	砌
dqwy	砍
dwjh	砎
dwvt	砏
dbyy	砐
daht	砑
dxxn	砒
dwcy	砓
dgah	研
dvfh	砕
dgbn	砘
dwyn	砛
dwry	砜
dgsy	砞
dthf	砟
degg	砠
dgyy	砡
dskg	砢
dpxn	砣
dtbn	砤
dqay	砥
hxdf	砦
dhkg	砧
dynn	砨
dxjh	砩
dygg	砫
dtpy	砭
vcdf	砮
dyiy	砯
dguf	砰
dwyc	砱
dqnn	砲
dsgg	砵
djhh	砷
dary	砹
dwag	砼
dehh	砽
docy	砿
dcag	硁
dwgg	硂
driy	硃
digq	硄
dffg	硅
dwgk	硆
dtlr	硇
dfkg	硈
dvgh	硉
dqdb	硊
dtkg	硌
dvey	硍
dgaj	硎
dgdf	硏
dmgk	硐
duah	硑
dftx	硓
dawy	硔
dlkg	硘
dmnn	硙
dtdj	硚
dyoy	硛
dgva	硜
dieg	硝
dtfk	硞
dthp	硟
dyve	硠
dpdc	硡
dwgs	硢
dftb	硣
ddww	硤
dceh	硧
dtry	硪
dyck	硫
dayn	硭
iitd	硰
dlsy	硱
dwwk	硲
dfoy	硳
dawx	硴
dhlr	硵
dmwn	硶
dmdf	硸
dswc	硹
dgey	硺
ahnd	硻
deeg	硼
ddjn	硽
dpwa	硿
dqvh	碀
adwd	碁
dpfi	碂
dgeg	碃
dlty	碅
ihcd	碆
dpgh	碇
dqaj	碈
dmfk	碉
daay	碊
dmsk	碋
dajg	碏
dfwt	碐
drtf	碑
dwyg	碓
dfhy	碔
ddsk	碕
dwga	碖
dpqb	碗
dmaw	碘
dmum	碙
dukg	碚
kkkd	碞
dans	碟
dyks	碠
dmnk	碢
djqn	碣
damd	碤
dyna	碥
dptk	碦
dlge	碨
dadn	碪
dwdc	碫
djgh	碮
dvtr	碯
dyuh	碲
dmdo	碳
dsjg	碴
dhmy	碵
ddhd	碶
drfh	碷
dwtj	碸
dpgg	碹
dpwy	確
dykk	碻
damy	碽
dnae	碾
dnie	碿
dubp	磀
dqyl	磂
drhw	磃
dovk	磄
dyuy	磅
dmeg	磆
dtlx	磇
drqc	磈
dccs	磉
dddf	磊
dpdk	磍
dexd	磎
duvo	磏
dmgu	磑
dkmy	磒
dwnp	磓
dqas	磔
dfcl	磕
dnrg	磖
dgef	磗
derm	磘
dywe	磙
dgjf	磚
lrdf	磛
dwfi	磜
dmee	磞
dnwe	磟
dhlo	磠
dade	磡
ddrr	磢
dcce	磣
drvc	磤
dlxi	磥
dsfi	磦
dgmy	磧
ossd	磨
ddhy	磩
dmwy	磪
dtwh	磫
fnwd	磬
ddfe	磭
dmwa	磮
dxxy	磯
dugk	磰
dooe	磱
dias	磲
dulj	磳
dujg	磵
deqo	磶
dusd	磸
dsjf	磹
dtol	磻
dwys	磼
dffq	磽
dkkl	磾
dttd	磿
dueg	礀
dwyo	礁
dfkk	礂
dipr	礃
dtdk	礄
dykt	礅
dtmd	礇
duep	礈
dryt	礉
lbwd	礊
dlff	礋
dflg	礌
dajn	礍
dssh	礎
dogi	礏
errd	礐
dipl	礑
dugy	礒
dglg	礓
dnkf	礔
nkud	礕
degw	礖
dpgm	礗
djxo	礘
dafl	礚
dahl	礛
egnd	礜
dfdj	礝
dape	礞
dcor	礟
duxn	礠
dagf	礡
dufe	礢
daly	礣
dawi	礤
dahm	礥
dlll	礧
drrm	礩
dday	礪
dooi	礯
ddth	礰
dued	礲
dosd	礳
dfsh	礵
daky	礶
daal	礷
dtfm	礸
dkkt	礹
pyyy	礻
pybt	礽
pynn	祀
pybn	祂
pycg	祃
pywj	祄
pytd	祅
pyqa	祇
pyhg	祉
pyyt	祊
pywc	祋
pykh	祌
pyfh	祎
pydk	祐
pyrw	祑
pyvk	祒
pydy	祓
pywf	祔
pynt	祕
pyqy	祗
fifi	祘
pyfi	祙
pytf	祚
pyfc	祛
pydg	祜
pyjh	神
bmfi	祟
hxfi	祡
pyte	祣
pyng	祤
pyug	祥
pykd	祦
pyqi	祧
sfiu	票
pyri	祩
pyqb	祪
pywk	祫
wfiu	祭
pytk	祰
pyuq	祱
pyvc	祲
pyde	祳
pyaa	祴
pyls	祵
pyut	祶
pyqm	祹
pyaw	祺
pyld	祻
pyjs	祼
pyyf	祽
pyft	祾
pyrf	禆
pyfj	禇
pypl	禈
pydd	禊
pysf	禋
pyux	禌
pymk	禍
pyhm	禎
pyec	禐
pyjy	禑
pyxe	禒
pyjr	禓
pynh	禕
pyas	禖
pyln	禗
pyyh	禘
pyue	禙
pyuo	禚
pyfw	禛
pylt	禝
pyyk	禞
pyok	禟
pyco	禡
pyjn	禢
pyaf	禥
pyfk	禧
pyxy	禨
pylw	禩
pyup	禭
pyme	禯
pygr	禰
pyff	禱
pyye	禳
pywa	禴
pyjm	禵
pytm	禶
pyom	禷
tkmy	禹
jmhy	禺
hlrc	禼
tttt	禾
ttan	秅
ttfj	秊
twvt	秎
tfcy	秐
tufh	科
txxn	秕
tqan	秖
ttdy	秗
tnxn	秜
tegg	租
tdhg	秠
tdcy	秡
tgsy	秣
tguf	秤
thkg	秥
dwtu	秦
tmdy	秧
trwy	秩
tsyy	秫
tang	秬
ttnt	秭
tckg	秮
ttdg	秳
uqwt	秶
tgcf	秷
tfkg	秸
twtf	秹
tpta	秺
triy	秼
tpey	秾
tgey	秿
ykpt	稁
tyve	稂
tebg	稃
tcwt	稄
tkkg	稆
tlsy	稇
tjfh	稈
tuxt	稊
tkgg	程
twfi	稌
tieg	稍
tgfg	稏
tfwf	稑
tldg	稒
twyn	稔
tlty	稛
tfwt	稜
tjsy	稞
ylkt	稟
tmfk	稠
tywf	稡
takg	稢
tyki	稤
tojf	稥
tdhd	稧
tleg	稩
tgkl	稫
tdmd	稬
ttgf	種
trbt	稯
tnhe	稰
tehj	稲
tuvo	稴
tuxx	稵
tgky	稶
tlwt	稷
tyxl	稸
tfhw	稹
tnuf	稺
teeg	稻
tpge	稼
ykmt	稾
tykk	稿
fpgc	穀
tabg	穁
tgmn	穂
tpwk	穃
tovi	穅
trie	穆
osst	穈
tvcq	穊
tnwe	穋
qoty	穌
tgmy	積
xtdm	穎
tevn	穏
tqjn	穐
twvo	穒
tlaw	穓
twys	穕
txxy	穖
tgjn	穗
togw	穙
twyo	穛
tjbc	穝
tqgj	穞
tuep	穟
tmae	穠
tfwk	穡
tywe	穣
tfdj	穤
tegw	穥
tpgm	穦
tyuj	穧
twkm	穨
tgwr	穪
tawc	穫
toaw	穬
tqoj	穭
tfkk	穯
telf	穱
tgmx	穲
ttfm	穳
pwnb	穵
pwqu	穸
pwsu	穼
pwtd	穾
pwgn	窀
pwdy	突
pwtg	窂
pwtf	窄
pwhf	窅
pwtp	窆
pwqn	窇
pwgw	窉
pwbm	窋
pwqb	窌
pwqg	窎
pwff	窐
pwgf	窒
pwcn	窓
pwyr	窔
pwqi	窕
pwtk	窖
pwfb	窙
pwfv	窛
pwqe	窞
pwjs	窠
pwcc	窡
pwag	窢
pwjx	窤
pwuj	窨
pwmk	窩
pwif	窪
pwdd	窫
pwwj	窬
pwtx	窮
pwem	窰
pwws	窱
pwof	窲
pwry	窳
pwfw	窴
pwwo	窵
pwlv	窶
pwbb	窷
pwtn	窸
pwnk	窹
pwvs	窼
pwxw	窽
pwbg	窿
pwgq	竀
pwdi	竂
pwfn	竃
pwrt	竅
pwfm	竇
pwfx	竈
pwud	竉
uuuu	立
utfh	竏
uwcy	竐
ukhj	竒
utfn	竓
utah	竔
uwvt	竕
uitt	竗
uqkg	竘
upsh	竚
ujnb	竜
udjg	竡
uctd	竢
updc	竤
ugki	竦
uhjf	竨
upeg	竩
uqvh	竫
utky	竬
ujqn	竭
unua	竮
udjf	竰
ugjf	竱
uulj	竲
uwgu	竳
uusf	竴
ugkh	竵
ujft	竷
ujqq	竸
thth	竹
twyu	竼
tgfj	竽
tynb	笀
tvyu	笂
tgaj	笄
trru	笅
tyhu	笇
tbyu	笈
tquf	笉
trhy	笊
taht	笌
tmwu	笍
tqrr	笏
tywb	笐
ttdu	笑
txxb	笓
tnyw	笖
ttuu	笗
tbmj	笜
tlcu	笝
tckf	笞
trcy	笟
tegf	笡
tnna	笢
tqnb	笣
tvkf	笤
tngk	笥
twfu	符
tmmg	笧
tway	笩
tthf	笮
tvcu	笯
txjj	笰
tqkf	笱
tcaj	笲
tekf	笳
tskf	笴
tibb	笵
tqtb	笷
takf	笸
tanb	笹
tabj	笻
ttkf	笿
tfff	筀
tmaf	筁
tldu	筃
tqiu	筄
ttfq	筅
ttdf	筈
tffu	等
tywr	筊
twgf	筌
tqjf	筍
twau	筏
tagf	筐
tmgk	筒
twgk	答
tgmi	策
twkh	筗
trkf	筘
tdiu	筙
tivf	筜
tpsu	筞
tebf	筟
trcb	筢
ttjj	筣
tkkf	筥
tpfq	筦
thqb	筧
twyk	筨
tceh	筩
talj	筪
taww	筮
tege	筯
tief	筲
ttfp	筳
tdww	筴
tthp	筵
tnnw	筷
tjfj	筸
tagy	筺
tgjr	筻
tkmu	筼
tkgd	筽
ttsu	筿
tukf	箁
tbcu	箃
trtf	箄
tmwx	箆
tldf	箇
tick	箈
trke	箉
tywu	箊
taau	箋
tgcj	箌
trah	箍
thaw	箎
tevh	箏
tgef	箐
tvph	箒
tviu	箓
tirf	箔
tadw	箕
thaj	算
tltu	箘
tebc	箙
tbry	箛
tpwa	箜
traf	箝
tjxx	箟
ttfg	箠
tpqb	箢
tgmj	箣
tihc	箥
tadk	箬
tpgg	箮
twgr	箯
tqjb	箰
tshf	箱
titq	箲
tnua	箳
tith	箵
tdef	箶
tytb	箷
tftj	箸
txqy	箹
tdwj	箺
ttvg	箻
tngf	箼
tiej	箾
tkbf	箿
trgf	篁
tjtg	篂
tnhf	篃
tmdj	篅
tyna	篇
taws	築
tiaw	篊
twnd	篌
ttou	篍
thit	篎
tafw	篏
tsah	篐
twye	篒
tfcl	篕
tovk	篖
tahd	篚
txuu	篛
tbio	篜
tijf	篞
twge	篟
twhs	篠
thdc	篡
tamu	篢
tssu	篥
ttlx	篦
tpwy	篧
tbwi	篨
twnh	篩
trhw	篪
tawr	篫
tujn	篭
tqfy	篯
tukb	篰
tdhv	篲
tjaf	篳
tgep	篴
ttwh	篵
tgho	篶
thdb	篹
trrf	篺
trqq	篼
ttrb	篽
tldy	篾
tgmu	簀
tthh	簁
tlag	簂
ttqq	簃
tync	簄
tutg	簅
tpfc	簆
tytd	簇
tntf	簈
tadf	簊
tvel	簋
tlvf	簍
traj	簎
tonx	簏
tyke	簑
tmfe	簓
tyge	簔
take	簕
tivs	簗
tvoj	簘
tfgf	簙
tlgy	簚
tadr	簛
tijr	簜
tdui	簝
tkkl	簞
tsjf	簟
tgel	簠
tujf	簡
tuyu	簢
tkhm	簣
tlmu	簤
twgu	簦
tamw	簧
tooe	簩
taqj	簪
tvfj	簫
tkhk	簬
tawk	簭
tfwj	簮
tsaw	簯
tyaw	簱
terf	簲
tfjf	簳
tltk	簵
tpyi	簶
tqdy	簷
tipl	簹
tpaf	簺
tmnp	簻
twgw	簽
touo	簾
tigf	簿
trql	籀
twyh	籂
takm	籄
tsfy	籈
tnwy	籊
tfnf	籌
txth	籎
tytw	籏
teui	籐
thde	籑
trgl	籒
titl	籓
tlvt	籔
tsql	籕
tfwy	籗
tqvi	籙
thal	籚
tqaa	籛
trlf	籜
tyny	籝
ttri	籞
tgkm	籟
tued	籠
trww	籡
twgt	籢
tugi	籣
twwy	籤
twga	籥
tqtf	籦
thap	籧
txxr	籪
tyry	籬
tlxy	籮
thhc	籰
twgm	籲
onfh	籸
otnn	籺
ovyy	籾
odyy	粀
otfh	粁
oxxn	粃
oqrt	粅
xxou	粊
ovfh	粋
oxhh	粌
otfn	粍
onyy	粎
oynt	粐
oafg	粓
ogsy	粖
ohkg	粘
vojk	粛
uqwo	粢
ommg	粣
xoxn	粥
oqah	粦
oofg	粧
odjg	粨
oftx	粩
odmj	粫
omag	粬
ohqn	粯
ivwo	粱
hqco	粲
ogjr	粳
ojfg	粴
tmtn	粵
oviy	粶
oqoy	粷
oadw	粸
oywf	粹
odey	粻
opfi	粽
ogeg	精
ojsy	粿
oawx	糀
ocns	糅
ownd	糇
onhe	糈
orbt	糉
odeg	糊
ouej	糋
othj	糌
ouxx	糍
odjf	糎
onie	糏
oxuu	糑
oath	糒
ocyj	糔
ougo	糕
oovk	糖
othy	糗
opge	糘
oanf	糚
oipf	糛
osso	糜
occe	糝
olaw	糞
ogmj	糟
oovi	糠
oujq	糡
oajd	糢
oaet	糤
oxkj	糨
nkuo	糪
olfj	糬
oobt	糭
ofdj	糯
olgf	糰
btwo	糱
oday	糲
oguo	糳
tyoy	糴
awno	糵
bmoy	糶
xcyy	紁
xqyy	約
xgfh	紆
xtnn	紇
xvyy	紉
xdny	紌
xmwy	納
xdyy	紎
xufh	紏
xdhy	紑
xwjh	紒
xcnh	紓
xgbn	純
xxhh	紖
xfcy	紜
xpqn	紞
xwyn	紟
xvfh	紣
rnxi	紥
xrwy	紩
xhxn	紪
xxcy	紭
xdcy	紱
xann	紲
xhcy	紴
xpsh	紵
xwyc	紷
xygg	紸
xvkg	紹
xafg	紺
xmdy	紻
xxjh	紼
xpxn	紽
xwet	紾
xckg	紿
xbmh	絀
xtbn	絁
xtuy	終
xyxy	絃
xmkg	絅
xugh	絆
xqkg	絇
xsyy	絉
xsgg	絊
xocy	絋
xcfg	経
xwtf	絍
xtgs	絎
xjxt	絏
xyth	絒
xffg	絓
xdjg	絔
xigq	絖
xlkg	絗
xuqw	絘
xgjg	絙
xghg	絚
whti	絛
xwgg	絟
xdeg	絠
xqjg	絢
xuah	絣
xwdy	絥
xwgk	給
xmgk	絧
xqiy	絩
xldy	絪
ccci	絫
udxi	絭
xynw	絯
xgcf	絰
xxiy	絲
xtah	絳
xwfc	絵
xqcn	絶
xhqn	絸
xkeg	絹
xrdh	絺
xqkq	絻
xkkg	絽
xgiy	絿
xgki	綀
xykq	綂
xieg	綃
xpfq	綄
xvpc	綅
xgjr	綆
xuxt	綈
xtbt	綉
xdww	綊
xpdc	綋
xwwk	綌
xfpb	綍
xtfp	綎
xevg	綏
xukq	綐
xlsy	綑
xebg	綒
xgva	經
dfni	綔
xfny	綕
xthp	綖
xmwk	綗
xonn	継
xfpq	続
xvyn	綛
xpfi	綜
xssy	綝
xtfg	綞
xyny	綟
xudb	綣
vkbi	綤
xlgj	綥
adwi	綦
xadw	綨
xpqb	綩
xgeg	綪
xaay	綫
xepc	綬
ynti	綮
xqrm	綯
xphn	綰
xmun	網
xccc	綴
xesy	綵
xjsy	綶
xywf	綷
xwga	綸
xthk	綹
xdsk	綺
xrtf	綼
xfwt	綾
xgvv	緀
xgvh	緁
xooy	緂
xwwh	緃
xjxx	緄
xbcy	緅
xjqr	緆
xvlg	緇
xfuf	緈
ahni	緊
xtvg	緌
xqaj	緍
xakg	緎
xwcn	総
xviy	緑
xftj	緒
xamd	緓
xyjg	緕
xshg	緗
xdgy	緘
xakf	緙
xriy	線
rmhi	緜
xwdc	緞
xtgf	緟
xnnj	緡
xalg	緢
xwks	緥
xlny	緦
xusg	緧
xngg	緪
xqrn	緫
xdmd	緬
xleg	緭
xtjt	緮
xwnd	緱
xhit	緲
odhi	緳
xrbt	緵
xwgr	緶
xplh	緷
xsfg	緸
xjgh	緹
xmnk	緺
xgct	緻
xjlg	緼
xhmy	緽
xdjf	緾
xckn	緿
xnhc	縀
xvey	縁
xukn	縂
xnhe	縃
xjjn	縄
xpgg	縇
oopi	縈
xuwl	縊
xwnp	縋
xubp	縌
xyuy	縍
xmeg	縎
tewi	縏
xqbt	縐
xuvo	縑
xuga	縒
xdri	縓
xccs	縔
xlwl	縕
xpdk	縖
xyke	縗
xexd	縘
xabg	縙
xeeg	縚
xgef	縛
xkmy	縜
xfhw	縝
xykk	縞
xdff	縟
xpuf	縡
hiti	縣
xgxi	縤
xdwt	縥
xtuh	縦
xwhs	縧
xjiq	縨
xwfi	縩
xyrc	縭
xpgw	縯
xthh	縰
xtwh	縱
xlxi	縲
xgjf	縳
xyxg	縴
xjlc	縵
fufi	縶
xlvg	縷
xajd	縸
xlpy	縺
ossi	縻
xgmy	績
xcce	縿
txti	繁
xyxf	繂
atdi	繄
xvjs	繅
xnwe	繆
ermi	繇
xxcj	繈
xhqi	繉
xfoy	繊
lwci	繋
xtlt	繌
xvoj	繍
xqdo	繎
xnnw	繏
xgjn	繐
xtdk	繑
xulj	繒
xjbc	繓
xugk	繕
xaet	繖
xoqh	繗
xcnk	繘
xtol	繙
gxif	繛
xusf	繜
xueg	繝
nnni	繠
xvfj	繡
xkhm	繢
xvfg	繣
ahdi	繤
xfkk	繥
xxkj	繦
xffc	繧
xfup	繨
xwgj	繪
lbwi	繫
xfwk	繬
amhj	繭
xlge	繯
xkks	繰
xaqn	繱
xqeg	繲
nkui	繴
xylg	繵
xujn	繶
xmae	繷
xuep	繸
xlff	繹
xqvo	繺
xfdj	繻
xxxn	繼
xkhp	繾
xahl	繿
xwow	纀
xtgo	纁
thdi	纂
xyuj	纃
xatp	纄
xrxs	纅
oxim	纇
xfkm	纈
xfwm	纉
xoaw	纊
xdet	纋
xfhy	纎
xojf	纏
xywm	纐
xhal	纑
xmmv	纓
xqky	纔
xwwy	纖
xtfm	纘
xlxy	纙
gxhi	纛
xahq	纜
xlli	纝
xyxn	纞
xnng	纟
xdfn	绔
ximk	绱
rmbh	缷
rmag	缸
rmou	缹
rmgy	缻
rmqw	缼
rmsg	缽
rmua	缾
rmrk	缿
rmqi	罀
rmmm	罁
rmhf	罅
rmxm	罆
rmuf	罇
rmsf	罈
rmir	罉
lbwm	罊
yxtm	罋
mmrm	罌
lllm	罍
rmjc	罎
rmhl	罏
muyn	罔
pwfj	罕
lwyu	罖
ldhu	罘
lygf	罜
legf	罝
lcnt	罞
lghf	罡
lfff	罣
luxt	罤
lkef	罥
lebf	罦
lssu	罧
ldjn	罨
lhjf	罩
lhdd	罪
lffh	罫
lfmf	罱
llnu	罳
lcou	罵
lqyl	罶
lyfu	罸
lnwy	罹
lvjs	罺
lnff	罻
ljaf	罼
ldoj	罽
lulj	罾
mrrl	羀
lxke	羂
lajh	羃
lxhf	羄
lceo	羆
lakk	羇
lyxi	羉
dugj	羍
ugdu	美
ghhy	羐
ugwv	羒
ugcn	羓
ugou	羔
ugyi	羕
ugnc	羗
ugwc	羚
ugxj	羛
ugps	羜
ugqy	羝
ugnf	羞
uggw	羠
ugad	羢
vtkg	群
ugga	羥
ugpq	羦
ugct	羧
ugiw	羨
ugty	義
ugye	羪
ugpa	羫
ugdy	羬
ugwj	羭
ugow	羮
ugjn	羯
ugmo	羰
ugdi	羱
ugtl	羳
ugug	羴
ugfm	羵
ugww	羷
ugod	羹
ugfj	羺
ugot	羻
nugg	羼
nnyg	羽
wcnf	翁
nwvt	翂
dcng	翃
nvfj	翆
ndcy	翇
sgng	翉
wycn	翎
nwer	翏
fkng	翓
ugng	翔
wgkn	翕
qqng	翗
mqng	翙
nplj	翚
pdcn	翝
nyki	翞
nwyf	翟
nywf	翠
mfkn	翢
nuvf	翣
kman	翤
ftjn	翥
uejn	翦
ynmn	翩
nrfq	翫
nwnd	翭
gkmn	翮
nykk	翯
sfin	翲
atdn	翳
nwvo	翵
rifn	翶
famn	翸
thin	翺
hdgn	翽
lgkn	翾
fnan	翿
ftxb	老
ftxn	耄
ftjf	者
ftxj	耆
ftqk	耇
ftxk	耈
fttk	耉
ftxf	耋
dmjj	而
dmjd	耎
dmjf	耐
mdmj	耑
dish	耓
dibg	耔
difj	耕
diit	耖
ditn	耗
difc	耘
dicn	耙
dihc	耚
dick	耛
dihn	耜
diek	耞
dian	耟
diwk	耠
diee	耡
diae	耢
diwa	耣
diaj	耤
diik	耥
dijy	耦
didf	耨
diaf	耩
diyy	耪
digm	耫
dilv	耬
dixw	耭
dioe	耮
diac	耯
didt	耰
diod	耱
diye	耲
bghg	耳
bwyn	耹
bfcy	耺
bdcy	耾
bwvt	聁
bmfg	聃
bwet	聄
btdy	聅
bxet	聈
bbmh	聉
bqiy	聎
bdmj	聏
bfkg	聐
btdg	聒
awyb	聓
btfk	聕
bkgf	聖
bgeg	聙
bpwa	聜
bakg	聝
tdkb	聟
buah	聠
bwcn	聡
bpgh	聢
beqn	聣
byks	聤
btky	聥
bqrn	聦
bwgd	聧
bxxa	聨
bxxd	聫
bxxo	聮
btln	聰
gqtb	聱
twwb	聳
bfln	聴
bkhm	聵
bbbf	聶
bqdy	聸
bpns	聹
bpwi	聺
ilrb	聻
nbfn	聼
ynvg	肁
gqvg	肂
xtdg	肄
yntg	肇
ynag	肈
tymw	肏
etnn	肐
evyy	肒
ynef	肓
ecyy	肞
efnn	肟
ewcy	股
efcy	肢
ewyn	肣
edhy	肧
edhh	肨
egbn	肫
edny	肬
emwy	肭
edcy	肱
eqrt	肳
exxn	肶
eqwy	肷
ewfh	肸
ewgn	肹
egmh	肺
hpef	肻
efjh	肼
edyy	肽
ejhh	胂
erwy	胅
exjh	胇
muqk	胊
ehkg	胋
ercy	胍
eckg	胎
etnt	胏
mubm	胐
ekwy	胑
enxn	胒
eguf	胓
hxmw	胔
ewfy	胕
eugh	胖
ewet	胗
ethf	胙
edhg	胚
eqay	胝
eskg	胢
etbn	胣
txen	胤
nhef	胥
emdy	胦
eaiy	胨
ehgh	胩
vcmw	胬
eldy	胭
etah	胮
edfn	胯
eigq	胱
eynw	胲
etkg	胳
emgk	胴
egcf	胵
qrbe	胷
edmj	胹
epvg	胺
etgs	胻
euah	胼
effg	胿
bige	脀
muqi	脁
eqcn	脃
edoy	脄
vvve	脋
erhf	脌
ersy	脎
eqkq	脕
eqrk	脗
epfq	脘
egiy	脙
egva	脛
ewwf	脞
eefy	脟
ethp	脠
etfp	脡
etxy	脢
dfee	脣
edfe	脤
edww	脥
eany	脦
muct	脧
egki	脨
whte	脩
erdh	脪
eebg	脬
ekgg	脭
eevg	脮
egey	脯
egku	脰
eniy	脲
eirb	脳
edhk	脴
ekgd	脵
etjh	脷
edey	脹
eywf	脺
egvh	脻
egmy	脼
ewyg	脽
ertf	脾
ewga	腀
ejsy	腂
eudb	腃
etfg	腄
eooy	腅
emaw	腆
etvg	腇
eeqn	腉
eywy	腋
ahne	腎
eccc	腏
eowf	腑
endg	腒
ehdd	腓
epqb	腕
egji	腖
emgj	腗
elgy	腘
epfi	腙
epgh	腚
engf	腛
eafs	腜
edmd	腝
exge	腞
epgf	腟
edwd	腠
emnk	腡
ejmy	腢
eyuh	腣
eujg	腤
emdj	腨
efmf	腩
eplh	腪
etgf	腫
ecns	腬
ekkn	腭
elny	腮
erfh	腯
evgp	腱
elge	腲
eewy	腴
enhc	腵
ewdc	腶
egkl	腷
ejgr	腸
eriy	腺
evep	腿
euvo	膁
ytee	膂
elwl	膃
eehc	膄
eovk	膅
egxi	膆
ewnp	膇
egkh	膈
euwl	膉
egef	膊
eiwe	膌
eexd	膎
eakk	膒
etjr	膓
eonx	膔
elag	膕
etdp	膖
exkj	膙
hale	膚
eipf	膛
eajd	膜
egjf	膞
eyxf	膟
elvg	膢
epwf	膣
efvg	膤
gsdw	膥
eoqh	膦
muuf	膧
eyuk	膪
edui	膫
etfn	膬
ekhm	膭
effq	膮
ewgu	膯
etol	膰
eujy	膱
ewyo	膲
erlo	膴
eayf	膵
eugg	膶
extb	膷
edap	膸
efam	膹
owwe	膺
emnp	膼
ewgj	膾
emae	膿
eouo	臁
nkue	臂
eyxy	臃
ehae	臄
elqj	臅
ewym	臇
eajn	臈
ekks	臊
naww	臋
efkc	臌
eyuj	臍
enyf	臎
epgm	臏
etgo	臐
efdj	臑
eawc	臒
eahm	臔
eono	臕
emge	臖
epay	臗
eako	臙
ehal	臚
efwy	臛
etfm	臜
ehhy	臞
eady	臟
yxxw	臠
ahnh	臣
ahnc	臤
ahnw	臥
nhah	臦
dndy	臧
ahnk	臨
nhaj	臩
thnn	臫
thsu	臬
thdy	臭
thif	臯
thgx	臰
thpy	臱
thsb	臲
gcff	至
gcfk	臵
fgcy	臷
gcfy	臹
gcft	臻
ethg	臼
tfed	臿
dwef	舂
egno	舃
eqou	舄
egnw	與
awye	舊
emgg	舋
tdnh	舏
tdqa	舐
tdmf	舑
tdjr	舓
tdgn	舔
tdoo	舕
wfky	舖
wfkn	舘
tdqy	舚
qahh	舛
epqh	舜
nvph	舝
rlgh	舞
tevt	舠
teag	舡
temh	舢
tewy	舤
tecn	舥
tedy	舦
tety	舧
terc	舨
teyw	航
teyt	舫
tewc	般
texx	舭
teyn	舮
tekh	舯
temg	舳
tetf	舴
terg	舶
teyx	舷
tesk	舸
tewk	船
telh	舺
teaw	舼
teth	舽
tesg	舾
tedn	舿
teeb	艀
tetk	艁
tejf	艃
teie	艄
teye	艆
tetp	艇
teyk	艈
tenn	艉
terh	艊
tebl	艋
tewn	艌
tend	艍
teuh	艏
tert	艐
teya	艑
tejh	艒
teas	艓
teoc	艔
teyy	艕
teua	艖
teul	艗
teec	艘
tegj	艚
telv	艛
teah	艜
tefv	艝
teti	艞
teuf	艟
tewu	艠
teil	艡
tefk	艢
tehe	艣
teuy	艤
teky	艥
teac	艧
teae	艨
teyj	艩
teqj	艪
tehl	艫
teqy	艬
xjqc	艴
uaqc	艵
magc	艶
mdhc	艷
btbh	艸
awyu	芃
avyu	芄
aayu	芅
acyu	芆
atfj	芊
agfj	芋
afnb	芌
aqyu	芍
aghu	芐
aynb	芒
bhbh	芔
axxb	芘
agbn	芚
avtr	芛
arnb	芞
awcu	芟
aqwu	芡
adhu	芣
abnb	芤
awjj	芥
acnh	芧
abyu	芨
aqab	芪
afqb	芫
afcu	芰
awxb	花
aqrr	芴
anwu	芵
aqcu	芶
atdu	芺
qbtt	芻
atfn	芼
aaht	芽
agmh	芾
awbr	芿
aywb	苀
adcu	苃
arjj	苅
aavr	苆
aaqb	苉
adbb	苊
axht	苐
aqbb	苑
amff	苒
awyc	苓
amkf	苘
aehj	苚
askf	苛
auxb	苝
aqnb	苞
anab	苠
anyw	苡
ahnn	苢
aanf	苣
adhg	苤
apsj	苧
anxb	苨
ahkf	苫
alwu	苬
axer	苭
awmj	苮
asgf	苯
axcu	苰
amdu	英
athf	苲
atuu	苳
aegf	苴
arwu	苵
awiu	苶
aaff	苷
atuf	苸
awfu	苻
arcy	苽
antr	苾
afiu	苿
axjj	茀
acnt	茅
aqtb	茆
adcy	茇
ahxb	茈
agsu	茉
argf	茊
aqay	茋
awff	茌
hghk	茍
aqry	茐
aqbj	茒
apwu	茓
atkf	茖
aqkf	茗
avvv	茘
aadr	茙
aqgb	茚
aveu	茛
aahh	茝
avgj	茟
apbf	茡
agqj	茢
aqqu	茤
agmi	茦
auqw	茨
argk	茩
aigq	茪
adhf	茬
aywr	茭
ahgi	茮
awdy	茯
ajru	茰
ariu	茱
aiaf	茳
alkf	茴
aldu	茵
awsu	茶
awau	茷
avkf	茹
aycq	茺
amgk	茼
awkh	茽
aawy	茿
aqjf	荀
agjg	荁
adfn	荂
awgf	荃
aynw	荄
atgs	荇
aqah	荈
ajfj	草
agaj	荊
admj	荋
apvf	荌
anht	荍
agcf	荎
awtf	荏
agxw	荑
auaj	荓
aeer	荕
aftx	荖
adyy	荗
auff	荘
adpu	荙
amjj	荝
apgf	荢
anud	荬
axfu	荮
asff	荰
antn	荱
agku	荳
arfw	荴
avyn	荵
akwn	荶
awsk	荷
afpb	荸
ahhr	荹
afqu	荺
aqto	荻
awgs	荼
aevf	荽
acwt	荾
adfe	莀
aaww	莁
akej	莂
ardh	莃
agjr	莄
aege	莇
aiwc	莈
atjj	莉
anhf	莊
aukq	莌
agiy	莍
arit	莏
aipq	莐
atxu	莓
amwg	莔
agva	莖
avtk	莙
athp	莚
atfp	莛
awht	莜
awwf	莝
apfq	莞
atbr	莠
akhu	莡
aynn	莣
aqtf	莥
aief	莦
ahqb	莧
ayve	莨
aebf	莩
atry	莪
aqkq	莬
avcb	莭
aler	莮
aisu	莯
afqw	莰
atky	莵
abkx	莻
axgn	莼
adya	莽
adfa	莾
agmj	莿
apqb	菀
agef	菁
arqy	菂
aian	菃
agji	菄
aphn	菅
abcu	菆
avdf	菇
aruf	菈
aviu	菉
aqou	菊
akfi	菋
ajxx	菎
oguw	菐
avlf	菑
ajsu	菒
aebc	菔
awga	菕
ajjf	菖
armf	菗
aswc	菘
atfg	菙
aaau	菚
ardy	菝
atqt	菞
aihc	菠
abib	菡
arqn	菢
aahc	菣
audb	菤
asrj	菥
arpu	菦
aoqy	菧
auvf	菨
aukf	菩
apdf	菪
agkg	菫
aivk	菬
aick	菭
aovw	菮
agaf	華
abry	菰
ahdd	菲
adjn	菴
amun	菵
adwg	菶
avph	菷
aywu	菸
aieg	菹
ayne	菺
assu	菻
aoou	菼
ahgc	菽
agdn	菾
agcj	菿
ahaw	萀
aadw	萁
aywf	萃
aqrm	萄
agbj	萅
artf	萆
adeu	萇
ahqy	萈
aecb	萉
asww	萊
agvv	萋
atvf	萎
aqef	萏
agvh	萐
aywq	萒
apeg	萓
arvk	萔
ayjf	萕
aeqb	萖
apfi	萗
adfi	萘
aspq	萙
arcg	萚
ahaj	萛
amwx	萞
atvy	萟
aeef	萠
airf	萡
aiqn	萢
apgh	萣
atou	萩
atjf	萫
aqmu	萯
agli	萰
apgg	萱
aegc	萲
afmf	萳
amnk	萵
aiej	萷
aewu	萸
ajhf	萺
aujf	萻
akkn	萼
abcl	萾
aitd	萿
artd	葀
augv	葁
aqke	葂
ajtf	葃
aetf	葄
awwg	葅
awks	葆
acns	葇
acks	葈
aeqk	葋
agkl	葍
atvg	葎
aivg	葏
awvl	葐
afff	葑
axaf	葒
aiaw	葓
awnd	葔
atis	葕
apwy	葖
aftj	著
agvl	葘
ashf	葙
aadn	葚
ajqn	葛
adhd	葜
agve	葝
axbf	葞
awvc	葠
aqgy	葡
adyl	葢
atgf	董
auej	葥
ankh	葦
afpe	葧
alge	葨
arcb	葩
aqej	葪
adef	葫
agqa	葬
anhc	葭
awdc	葮
axqy	葯
awct	葰
adgy	葳
awgd	葵
aplj	葷
alnu	葸
aytb	葹
akbf	葺
awtj	葻
arbt	葼
asvf	葽
aqbn	葾
ajlf	蒀
asyp	蒁
ayuh	蒂
axge	蒃
apff	蒄
aivs	蒅
aawv	蒆
axxr	蒈
awxx	蒊
ayto	蒍
aire	蒎
apsg	蒏
arqc	蒐
arvc	蒑
awnh	蒒
ajff	蒔
alwl	蒕
afhw	蒖
aiye	蒗
avkr	蒘
agkh	蒚
armw	蒛
afii	蒜
adri	蒝
auqk	蒟
athn	蒠
ayuy	蒡
abws	蒢
atws	蒣
aiws	蒤
aqyl	蒥
adhy	蒧
awge	蒨
ateg	蒩
auga	蒫
apqy	蒬
aqbt	蒭
aeej	蒯
atec	蒰
argy	蒱
axmw	蒳
aube	蒴
aexd	蒵
axwv	蒶
akmu	蒷
auvo	蒹
autd	蒺
axuu	蒻
awyk	蒼
aldn	蒽
aopu	蒾
aykk	蒿
abti	蓀
adwt	蓁
apjw	蓂
aehc	蓃
aiyk	蓅
aoah	蓆
amef	蓇
ayvb	蓈
apwk	蓉
awcn	蓊
awwt	蓌
aovk	蓎
adff	蓐
alfj	蓒
awuk	蓓
augo	蓔
atlx	蓖
atfh	蓗
aywe	蓘
aowf	蓙
awhe	蓚
agmt	蓛
asgn	蓜
aivc	蓡
auft	蓤
awhs	蓧
acne	蓩
acep	蓪
agep	蓫
aodn	蓭
atwh	蓯
athh	蓰
aiua	蓱
aakk	蓲
aakg	蓳
agjf	蓴
argh	蓵
akwy	蓶
arwy	蓷
atrb	蓹
afuy	蓻
anwe	蓼
ajaf	蓽
ahlo	蓾
apwj	蓿
aukb	蔀
alxi	蔂
axkj	蔃
aift	蔆
avcq	蔇
asfi	蔈
aojf	蔊
agkw	蔌
aonx	蔍
aywc	蔎
ayuk	蔏
ayud	蔐
avto	蔒
aqgl	蔔
aaqh	蔕
ahag	蔖
aoao	蔗
acce	蔘
ayth	蔙
anff	蔚
agqt	蔜
ahou	蔝
alvf	蔞
aytd	蔟
axtu	蔠
awfi	蔡
aihv	蔢
apnm	蔤
awvo	蔦
adhv	蔧
alub	蔨
apgw	蔩
alrj	蔪
agho	蔫
anhk	蔬
abwc	蔭
alag	蔮
abgi	蔯
aync	蔰
arsc	蔱
apft	蔲
aige	蔳
aoss	蔴
aday	蔵
agmu	蔶
arqq	蔸
apfc	蔻
aumt	蔽
aeto	蔿
avaf	蕁
aeue	蕂
atol	蕃
aunu	蕄
aijy	蕅
asjf	蕈
awyo	蕉
annn	蕊
ahhh	蕋
ajjj	蕌
aiwj	蕍
atdk	蕎
aqtj	蕏
agwg	蕐
auef	蕑
almu	蕒
affc	蕓
afuc	蕔
aqtg	蕕
aias	蕖
akhk	蕗
affq	蕘
agjn	蕙
atut	蕛
ahdn	蕜
axqc	蕝
ajbc	蕞
awxc	蕟
avki	蕠
afam	蕡
aeph	蕣
ageg	蕤
aahy	蕥
aedm	蕦
attt	蕧
aduw	蕨
axxi	蕬
aeqo	蕮
abtg	蕯
aijl	蕰
atie	蕱
aqwe	蕵
acnm	蕷
anhp	蕸
ayxy	蕹
akby	蕺
adcw	蕻
adcg	蕼
amae	蕽
aflf	蕾
aoec	蕿
aill	薀
atmd	薁
aryt	薂
aigf	薄
aept	薆
atmt	薇
awgj	薈
ahdy	薉
auqm	薋
axtb	薌
aecn	薍
alpa	薎
aujn	薏
atft	薐
aglg	薑
ahqo	薒
afwk	薔
aouo	薕
amnp	薖
alfy	薗
afup	薘
agqr	薚
awnf	薛
ankf	薜
aqdy	薝
agqe	薞
awgw	薟
aodm	薠
aqeg	薢
afkc	薣
agqg	薤
alqj	薥
aono	薦
aykx	薧
alpx	薨
aris	薬
atrf	薭
atgo	薰
aogf	薱
apgm	薲
afkp	薳
apns	薴
afnf	薵
aejf	薶
afdj	薷
aisi	薸
afkf	薹
ayuj	薺
aonf	薼
asfy	薽
agwr	薾
axth	薿
aooo	藀
ayks	藁
abci	藂
aykw	藃
aadi	藄
alyj	藅
apar	藆
aegw	藇
ahwd	藈
atya	藊
anwy	藋
apnj	藌
avhl	藎
adny	藏
aqmt	藑
atjn	藒
apdi	藔
aahm	藖
agkp	藗
ahan	藘
auec	藙
apeo	藛
atqi	藜
afwc	藝
addd	藞
alll	藟
arrr	藠
ayup	藡
alcx	藣
aosr	藦
axec	藧
aitl	藩
alvt	藪
aisf	藫
abkm	藬
apwx	藭
aswo	藮
anfn	藯
aqyj	藰
aurc	藱
asak	藲
aykt	藳
axjl	藴
awke	藵
adth	藶
ayfj	藷
agej	藸
ayjn	藹
auwy	藺
apgn	藼
ausq	藽
agkm	藾
afwy	藿
arlf	蘀
agkk	蘁
anns	蘂
ahhs	蘃
atqs	蘅
atwm	蘈
alpc	蘉
ahhm	蘋
atri	蘌
atge	蘍
afec	蘎
axfm	蘏
ayec	蘐
aosd	蘑
atqn	蘒
atqo	蘓
axtm	蘔
axtp	蘕
anks	蘗
ayke	蘘
aatn	蘙
aqog	蘚
aade	蘛
aako	蘜
awgt	蘞
aben	蘟
ammv	蘡
aued	蘢
aamg	蘣
areo	蘤
afkk	蘦
ahap	蘧
aeri	蘨
atxi	蘩
aial	蘫
aldj	蘮
axjc	蘰
allf	蘲
aamf	蘳
abuy	蘵
atvc	蘶
hght	蘷
asgo	蘸
anye	蘹
ayry	蘺
albi	蘻
alls	蘽
afye	蘾
ayug	虀
autt	虁
ajtg	虄
aeuo	虅
alli	虆
axay	虇
agko	虉
ayxs	虊
aemv	虋
aumx	虌
hawv	虎
hatw	處
hatf	虖
harg	虗
haeg	虘
hant	虙
hawr	虝
ywrw	虠
efhw	虢
fhnw	虣
haww	虤
hawa	虥
aahw	虦
hawn	虧
hase	虨
ijiw	虩
hawo	虪
jnhh	虯
jtan	虴
gqji	虺
jynn	虻
jtnn	虼
xtju	蚃
jdbn	蚅
jnyy	蚇
jgah	蚈
jmwy	蚋
jxxn	蚍
jfcy	蚑
jmyg	蚒
jxhh	蚓
jqan	蚔
jfqn	蚖
jkhh	蚛
jaht	蚜
wvju	蚠
jywn	蚢
jwcy	蚣
cyju	蚤
jwry	蚥
jwjh	蚧
jfwy	蚨
bhgj	蚩
jufh	蚪
jqnn	蚫
jnxn	蚭
jway	蚮
jguf	蚲
jqay	蚳
jxet	蚴
jskg	蚵
jafg	蚶
jryy	蚸
jwfy	蚹
jmfg	蚺
snju	蚻
jdhg	蚽
jhcy	蚾
jdcy	蛂
jhkg	蛅
jegg	蛆
jpxn	蛇
jwyc	蛉
ipju	蛍
jmag	蛐
jctg	蛑
jtkg	蛒
fjxy	蛓
jlkg	蛔
wnnj	蛗
jugh	蛘
jffg	蛙
jgqj	蛚
jvey	蛝
jtdg	蛞
jywr	蛟
jeee	蛠
juah	蛢
jfkg	蛣
jwgk	蛤
jqqy	蛥
jgxw	蛦
jmrr	蛧
jdjg	蛨
awyj	蛩
dhvj	蛪
jqdb	蛫
awju	蛬
jgcf	蛭
jftx	蛯
jgva	蛵
jefy	蛶
jgiy	蛷
jieg	蛸
jceh	蛹
jdww	蛺
jtry	蛾
lqju	蜀
jtnh	蜁
dfej	蜃
jhqn	蜆
rrju	蜇
jkgd	蜈
jebg	蜉
jtjh	蜊
jyve	蜋
jxxf	蜌
jwgs	蜍
jkeg	蜎
jtbt	蜏
jfce	蜐
thpj	蜑
jthp	蜒
jtfp	蜓
jqlg	蜔
jmjd	蜖
jtdk	蜘
jswc	蜙
hdhj	蜚
jndg	蜛
jadw	蜞
jyce	蜟
jlty	蜠
jblg	蜢
jugn	蜣
srju	蜤
jwga	蜦
jyny	蜧
jgvh	蜨
jmfk	蜩
jqrm	蜪
jjxx	蜫
jbib	蜬
jqeg	蜭
jakg	蜮
jdwg	蜯
ecju	蜰
jrtf	蜱
jtvg	蜲
jykb	蜳
jjqr	蜴
jjgg	蜵
ahnj	蜸
jwyg	蜼
jgmy	蜽
jjsy	蜾
jpqb	蜿
jgji	蝀
gfgj	蝁
jthc	蝂
jccc	蝃
jmun	蝄
gdgj	蝅
jhgf	蝆
jpgh	蝊
jiwg	蝋
jtuf	蝌
jvcb	蝍
jyks	蝏
jjhg	蝐
jnhe	蝑
jdmd	蝒
jwgj	蝓
jxxr	蝔
jrgg	蝗
jajv	蝘
jyna	蝙
jcns	蝚
jdgy	蝛
jqmy	蝜
jxge	蝝
jnhg	蝞
jleg	蝟
jgkl	蝠
jytb	蝣
jusg	蝤
jnhc	蝦
nfjj	蝨
jrbt	蝬
jjgh	蝭
jtjt	蝮
jegc	蝯
jdff	蝰
ynjj	蝱
jgxy	蝳
jdeg	蝴
toju	蝵
jans	蝶
jout	蝷
jmnk	蝸
jjlg	蝹
jtky	蝺
jfmf	蝻
jdwj	蝽
jjjn	蝿
uqfj	螀
jvep	螁
jyvb	螂
jyuy	螃
jwnh	螄
jthn	螅
juxx	螆
jexd	螇
jdri	螈
juvo	螊
jehc	螋
tewj	螌
gkmj	融
jgkh	螎
jutd	螏
jwno	螐
jthy	螑
fjfj	螒
jdwt	螓
jrhw	螔
jtlx	螕
jmeg	螖
jovk	螗
sjju	螙
cexj	螚
jpdk	螛
fpgj	螜
jrqc	螝
jpjw	螟
juwl	螠
yjju	螡
oopj	螢
eudj	螣
yjjw	螤
jgxi	螦
jagw	螨
jwhs	螩
jyuk	螪
fotj	螫
jgmj	螬
jyrc	螭
jaqh	螮
gqtj	螯
jonx	螰
nfij	螱
jpwf	螲
jipf	螳
bgjj	螴
jsfi	螵
anjj	螶
ortj	螷
wwkj	螸
jlrh	螹
jlvg	螻
tujj	螽
jpgw	螾
nhdj	螿
jyxf	蟀
jwvs	蟂
jjlc	蟃
fufj	蟄
joao	蟅
jajd	蟆
jlag	蟈
jnwe	蟉
jton	蟋
jtln	蟌
jtjs	蟍
javj	蟏
jiph	蟐
jujf	蟑
jada	蟒
jqke	蟓
jlfo	蟔
jhxh	蟕
jadr	蟖
jwam	蟘
jujy	蟙
fkuj	蟚
jfke	蟛
jias	蟝
jtol	蟠
jeto	蟡
jxxy	蟣
jnnw	蟤
jamw	蟥
jfam	蟦
jooe	蟧
jduw	蟩
jgjn	蟪
jkkl	蟬
jwyo	蟭
jugk	蟮
jvfj	蟰
jrlo	蟱
jvaf	蟳
jdgf	蟵
jbkg	蟶
jipl	蟷
gejj	蟸
jylg	蟺
jugy	蟻
aqkj	蟼
jfup	蟽
jqdy	蟾
lbwj	蟿
juqm	蠀
jaas	蠂
ajmj	蠆
jajy	蠇
madj	蠈
jlge	蠉
jouo	蠊
jlqj	蠋
jjqw	蠍
jyuj	蠐
joos	蠑
gwmj	蠒
jape	蠓
jfdj	蠕
jawc	蠖
jpgm	蠙
adkj	蠚
jaly	蠛
srrj	蠜
jlll	蠝
tvcj	蠞
xgej	蠡
jday	蠣
usgj	蠤
btwj	蠥
fpdj	蠧
jyfj	蠩
uegj	蠪
ejjj	蠫
jatn	蠮
uwlj	蠲
jmmv	蠳
jalj	蠴
jmwk	蠵
aqaj	蠶
jhhy	蠷
jaky	蠸
gkhj	蠹
yxxj	蠻
jhhc	蠼
iwyj	蠽
vxxj	蠿
tlvy	衂
tldh	衃
tlnf	衄
tliu	衆
tlre	衇
tlbg	衈
tlay	衊
vgdl	衋
tigs	衍
tfgs	衎
tfqs	衏
tans	衐
tyxs	衒
tmgs	衕
trhs	衘
tdes	衚
tnks	衛
tuts	衜
ttgs	衝
tvds	衟
tfhs	衠
puyy	衤
pugf	衧
pucy	衩
pubn	衪
puet	衫
pufw	衭
puwv	衯
ykge	衰
puby	衱
pumw	衲
puwc	衳
pupq	衴
pukh	衶
puwj	衸
puqa	衹
yahe	衺
pumf	衻
pufc	衼
putf	衽
wyne	衾
puwn	衿
puqu	袀
fkeu	袁
punw	袂
avye	袃
pumy	袇
pupx	袉
yqne	袌
puqn	袍
puxe	袎
puda	袏
punt	袐
pujg	袒
pueg	袓
pusk	袔
pupw	袕
puwe	袗
putb	袘
purg	袙
pudy	袚
puqy	袛
puwf	袝
yrwe	袠
puug	袢
puan	袣
ycne	袤
pudg	袥
pubm	袦
puqk	袧
puyx	袨
puhk	袩
ycke	袬
puti	袮
puny	袯
xyeu	袰
puwy	袱
yqqe	袲
puqq	袳
pudn	袴
puth	袶
pudb	袸
pudj	袹
pufk	袺
putk	袼
puri	袾
puff	袿
puld	裀
fyey	裁
gqje	裂
puhh	裃
puts	裄
putl	裇
pupl	裈
puve	裉
wvge	裊
pugu	裋
pudw	裌
puls	裍
pukg	裎
yjfe	裏
puke	裐
yeeu	裒
puaa	裓
yemk	裔
puwk	裕
pude	裖
puyk	裗
giye	裘
puvk	裙
rrye	裚
ykce	裛
pugy	補
nhde	裝
iite	裟
vtke	裠
pujf	裡
yqge	裦
puoo	裧
purf	裨
pujx	裩
puqm	裪
puft	裬
puhw	裭
pujj	裮
pumk	裯
pucc	裰
puge	裱
ipke	裳
hdhe	裴
yhde	裵
puhd	裶
puub	裷
hgie	裻
pujr	裼
pund	裾
pudk	裿
puaw	褀
jseu	褁
pufh	褂
puhe	褃
pugv	褄
puyh	褅
pujh	褆
putt	複
pudd	褉
puya	褊
puas	褋
pumj	褍
pujn	褐
puec	褑
ywke	褒
puws	褓
pugl	褔
puav	褗
punh	褘
puue	褙
eqne	褜
pujl	褞
puaf	褠
puak	褡
yrqe	褢
pupk	褣
pufe	褤
pudf	褥
pucx	褦
boye	褧
puua	褨
tewe	褩
purw	褫
pucs	褬
ycoe	褭
puoh	褯
pawe	褰
ylie	褱
pulp	褳
puyc	褵
punr	褶
pulv	褸
pufy	褹
fufe	褺
pusn	褼
nfie	褽
pugj	褿
pugm	襀
puce	襂
ykke	襄
puow	襆
puuj	襇
pujc	襊
pugi	襋
pukl	襌
puqe	襐
puvf	襑
puut	襒
pufq	襓
puui	襕
putd	襖
pulf	襗
puks	襙
puup	襚
pume	襛
puww	襝
pusi	襟
puil	襠
pulj	襡
puyg	襢
putj	襣
pual	襤
pugr	襧
puof	襨
pufm	襩
puay	襪
pulx	襬
puji	襮
puuq	襯
puud	襱
pubb	襵
puer	襷
putm	襸
pugx	襹
puaj	襺
pusr	襻
puac	襼
puai	襽
gmjg	襾
sghg	西
stpu	覂
sjfj	覃
svqr	覅
sttt	覆
sake	覇
sryt	覈
sako	覊
chqn	覌
ihqb	覍
hqbd	覎
hqrr	覐
thgq	覑
dhhq	覔
nthq	覕
ngkq	覗
hkhq	覘
qihq	覙
iphq	覚
rehq	覛
fohq	覝
hqhq	覞
fnhq	覟
vtkq	覠
awwq	覡
oohq	覢
tvhq	覣
hawq	覤
mawq	覥
wgeq	覦
kkfq	覨
ftjq	覩
yupq	覫
pjyq	覭
amfq	覯
haeq	覰
lrhq	覱
akgq	覲
rwyq	観
wgkq	覴
uehq	覵
ecmq	覶
haoq	覷
ujhq	覸
hqtt	覹
hagq	覻
gwmq	覼
ptoq	覾
flmq	覿
akkq	觀
mqbd	觃
qehj	角
qehh	觓
qehe	觔
tqeh	觕
qehw	觖
qeha	觗
qeht	觘
qehy	觚
hxqh	觜
udqh	觠
qehk	觡
dhvh	觢
qehg	解
qehb	觤
qehq	觥
qehi	觫
qmfj	觰
dgkh	觱
qmfr	觴
qehl	觶
errh	觷
qehm	觹
qehs	觻
qeho	觾
yyyy	言
ynhh	訆
ywyy	訉
yqyy	訋
ycyy	訍
ygfh	訏
yvyy	訒
ytnn	訖
ytan	託
ywvt	訜
yaht	訝
ytdy	訞
yxhh	訠
ynwy	訣
yrry	訤
ymwy	訥
ypqn	訦
yrbh	訩
yitt	訬
ywcy	設
ygah	訮
ybyy	訯
ygbn	訰
ytfh	許
ykhh	訲
ynyy	訳
yskg	訶
yjhh	訷
ysyy	訹
ywet	診
yygg	註
yghg	証
yqkg	訽
hxyf	訾
yhxn	訿
yhkg	詀
ywfy	詂
yyxy	詃
yrwy	詄
ywyc	詅
ymdy	詇
yvcy	詉
ykqn	詋
yafg	詌
yann	詍
yang	詎
yxet	詏
ythf	詐
ypxn	詑
yckg	詒
yfcy	詓
yvkg	詔
yhcy	詖
ymkg	詗
ybmh	詘
ydcy	詙
yjgg	詚
ybhc	詜
ypsh	詝
yngk	詞
dxyy	詟
yyni	詠
yqjg	詢
yxjg	詣
ywnk	詤
ywgk	詥
yaay	試
yywr	詨
yvey	詪
yrgk	詬
yqdb	詭
ywgg	詮
ythg	詯
yfkg	詰
ytdg	話
yugh	詳
ydeg	詴
ytfq	詵
yyth	詶
ymgk	詷
qdwy	詹
ytkg	詻
ygdf	詽
yqrb	詾
yffg	詿
yuah	誁
yqiy	誂
yqqy	誃
ydiy	誄
yriy	誅
yagg	誆
ygcf	誈
ynny	誋
yfny	誌
ygki	誎
ytry	誐
yqtg	誑
yctd	誒
ytfp	誔
yfpb	誖
ytjh	誗
ytbt	誘
ygva	誙
yieg	誚
yvpc	誛
ycwt	誜
ywyk	誝
yftb	誟
ydny	誠
yaah	誡
yhqn	誢
yaww	誣
ytfk	誥
yceh	誦
ywkq	說
ydfe	誫
yukq	説
yfpq	読
yawx	誮
yjjg	誯
ywyg	誰
ygvh	誱
ynbm	誳
ypfi	誴
yrde	誵
yywf	誶
ymun	誷
ysww	誺
yijg	誻
ypeg	誼
yeqn	誽
yrtf	諀
yccc	諁
yssy	諃
yykb	諄
adwy	諅
yadw	諆
yooy	談
ytfg	諈
ytvg	諉
yqoy	諊
ygji	諌
yqvh	諍
yajg	諎
ybcy	諏
wkky	諐
ygey	諑
yhgc	諔
yhaw	諕
ywga	論
ywyn	諗
yqaj	諙
ypgh	諚
yewy	諛
ynhe	諝
yyna	諞
yjgh	諟
ypgg	諠
ywgl	諡
yplh	諢
ymnk	諣
ykkn	諤
ytgf	諥
yyuh	諦
yxxr	諧
ygkl	諨
yuog	諩
yyks	諪
ygli	諫
ywgj	諭
yuqk	諮
ymdj	諯
ylny	諰
ysfg	諲
yujg	諳
ydgy	諴
yfmf	諵
yadn	諶
yjgr	諹
yute	諺
yrgg	諻
yegc	諼
yakf	諽
ykbg	諿
yjqn	謁
yleg	謂
yjtg	謃
eudy	謄
yqbt	謅
yynn	謆
pawy	謇
yrqc	謉
yayk	謊
yskk	謌
yehc	謏
yntl	謐
yexd	謑
yfhw	謓
yhag	謔
yrhw	謕
ylwt	謖
yyuy	謗
yuwl	謚
yamf	講
ydri	謜
ytmf	謝
yykk	謞
yeeg	謟
yqrm	謠
yerm	謡
yffn	謣
ysfi	謤
ytln	謥
fnwy	謦
yyrc	謧
yajd	謨
ajdy	謩
yyuk	謪
yyud	謫
ynwe	謬
yuev	謭
ygmy	謮
ylpy	謰
ylvg	謱
ycce	謲
yxfm	謴
ynrg	謵
yoao	謶
ygqt	謸
ytqq	謻
yhaf	謼
xkjy	謽
yjlc	謾
yfje	謿
ynbt	譀
yagf	譁
ykkl	譂
yulj	譄
yvyh	譅
yfkk	譆
ydfj	譇
yykt	譈
yffq	譊
yueg	譋
yeto	譌
owwy	譍
ycnk	譎
yxxy	譏
yusf	譐
ygjn	譓
ynnw	譔
yrlo	譕
yaqj	譖
ytwk	譗
yujy	識
ywyo	譙
ysjf	譚
yfwj	譛
ylge	譞
ykks	譟
yylg	譠
yipl	譡
yuep	譢
ywgw	譣
yryt	譤
aqky	警
youo	譧
ymae	譨
yujn	譩
yajn	譪
yqdy	譫
nkuy	譬
yeac	譭
ugyy	譱
yywe	譲
yfdj	譳
ykhp	譴
yogf	譵
yyyf	譶
yfnf	譸
yxth	譺
mmyf	譻
ahny	譼
egny	譽
yuen	譾
ydhn	譿
yyup	讁
yqmt	讂
yfwm	讃
ylll	讄
yptl	讅
tnky	讆
yuqe	讇
ydth	讈
uegy	讋
yako	讌
ygkk	讍
wyyy	讎
wywy	讐
yyke	讓
yben	讔
yugi	讕
ymwk	讗
ybbb	讘
yaky	讙
yafc	讛
yipo	讜
ykkt	讝
yhay	讞
yfly	讟
ydtf	诪
ypjh	谉
tdwk	谸
wwkc	谹
wwkt	谺
wwkg	谻
wwkw	谼
wwkk	谽
wwka	谾
exdk	谿
wwkd	豀
wwke	豂
wwkm	豄
gkuf	豆
gkuc	豉
magu	豊
gkub	豌
ahnu	豎
gkuo	豏
mdhu	豐
magt	豑
mdhl	豔
geyi	豖
gqge	豗
gegn	豘
gewc	豛
gega	豜
gecn	豝
geqk	豞
geyn	豟
qkeu	象
gegf	豣
geve	豤
geyw	豥
gegy	豧
gerh	豨
gege	豩
ykpe	豪
gefj	豬
genc	豭
gefm	豮
geed	豯
fpfc	豰
gejl	豱
gedi	豲
mgee	豳
geyd	豴
geth	豵
gefu	豷
etyt	豸
eqyy	豹
eftt	豺
epwy	貁
evkg	貂
evgh	貄
ewsy	貅
egjg	貆
evey	貇
etey	貈
edjg	貊
ejfh	貋
erqn	貌
ejfg	貍
ealg	貓
etlx	貔
ekkl	貚
eaky	貛
ehhc	貜
mhny	貝
aymu	貣
mywn	貥
wxmu	貨
mrcy	販
wynm	貪
rfmi	貭
fmny	貮
anmu	貰
hxmu	貲
afmy	貳
khgm	貴
cdmu	貵
waym	貸
mtgg	貹
mkqn	貺
mhkg	貼
qyvm	貿
famu	賁
mtkg	賂
wtfm	賃
mynw	賅
muah	賆
mtlg	賉
madt	賊
mofg	賍
mdxy	賎
pghm	賓
pnmu	賔
mgiy	賕
mwgs	賖
mkkh	賗
mofy	賘
mmfk	賙
swwm	賚
fwfm	賛
mpws	賝
ipkm	賞
mmaw	賟
mukg	賠
ovwm	賡
ahnm	賢
maay	賤
mooy	賧
mdey	賬
vhgm	賮
mqjb	賯
mdwj	賰
mplh	賱
wksm	賲
mfky	賳
gkim	賴
mjhg	賵
fkkm	賷
eudm	賸
muwl	賹
muvo	賺
mgef	賻
mamf	購
atdm	贀
mmty	贁
fufm	贄
gqtm	贅
mdyy	贆
yfhm	贇
mulj	贈
msjf	贉
tfqm	贊
mogw	贌
mqdy	贍
majy	贎
ynky	贏
mvhl	贐
mdny	贓
mmmu	贔
qytm	贕
mflm	贖
mipm	贘
hawm	贙
ujfm	贛
mady	贜
fwwm	赍
foqw	赥
fobc	赧
fojy	赨
foqc	赩
fohm	赪
fofj	赭
fonc	赮
fook	赯
fuyu	赱
fhee	赲
fhnh	赳
fhhi	赴
fhmk	赸
fhqu	赹
fhwn	赺
fhit	赻
fhqw	赼
fhrk	赾
fhqa	赿
fhtt	趀
fhqi	趂
fhrw	趃
fheg	趄
fhvk	超
fhqy	趆
fhud	趇
fhhk	趈
fhbm	趉
fhgy	越
fhfk	趌
fhqq	趍
fhri	趎
fhtd	趏
fhnd	趐
fhuw	趑
fhws	趓
fhgj	趔
fhjf	趕
fhwf	趖
fhkh	趗
fhgi	趚
fhqd	趛
fhqo	趜
fhaj	趞
fhik	趟
fhhf	趠
fhvi	趢
fhpd	趤
fhug	趥
fhuk	趦
fhjh	趧
fhqt	趨
fhlw	趩
fhaw	趪
fhtk	趫
fhfq	趬
fhwo	趭
fhks	趮
fhgr	趰
fhtm	趲
khwy	趴
khqy	趵
khtn	趷
khnw	趹
khfw	趺
khwn	趻
khga	趼
khyt	趽
khhg	趾
khby	趿
khcn	跁
khfc	跂
khry	跅
khck	跆
khwe	跈
khwc	跉
khfi	跊
khdy	跋
khrw	跌
khdg	跍
khpx	跎
khek	跏
khhx	跐
khqn	跑
khsk	跒
khyg	跓
khqk	跔
khhk	跕
khwf	跗
khmg	跚
khhc	跛
khnx	跜
khan	距
khgw	跠
khyo	跡
khqq	跢
khtq	跣
khyr	跤
khbs	跥
khri	跦
khwg	跧
khjx	跩
awyh	跫
khtk	路
khqi	跳
khsg	跴
khdp	跶
khws	跺
khnk	跼
khnn	跽
whth	跾
khfh	跿
khkh	踀
khbn	踂
khie	踃
khhh	踄
rrkh	踅
khct	踆
khtx	踇
khgi	踈
khye	踉
khfb	踋
khdk	踎
khaa	踐
khtv	踒
khhf	踔
khqo	踘
khbc	踙
khwa	踚
khft	踜
khjs	踝
khnd	踞
khpb	踠
khjr	踢
khuk	踣
khyf	踤
khuv	踥
khwh	踨
khug	踫
khqh	踭
khok	踮
khwj	踰
khoc	踱
khrh	踲
khdj	踳
khce	踴
khtf	踵
khjh	踶
khfj	踷
khmj	踹
khvp	踺
khmk	踻
khty	踽
khgl	踾
khas	蹀
khya	蹁
khak	蹃
khyh	蹄
pawh	蹇
khee	蹈
khua	蹉
khjn	蹋
khwk	蹌
khne	蹍
khql	蹓
lrkh	蹔
khjf	蹕
khde	蹖
khox	蹗
khif	蹚
khah	蹛
khpj	蹜
khxm	蹞
khoo	蹠
khnf	蹡
khyd	蹢
khth	蹤
khlp	蹥
khme	蹦
khgj	蹧
khkm	蹪
khwu	蹬
khuj	蹭
khsn	蹮
khtl	蹯
khuf	蹲
khyy	蹴
ykih	蹵
khdw	蹶
dubh	蹷
khoh	蹸
khfq	蹺
khow	蹼
khdi	蹽
khks	躁
khfp	躂
khlj	躅
khhe	躆
khaj	躇
khrt	躈
ajmh	躉
khff	躊
khny	躍
khgr	躎
khvn	躐
khub	躑
khrs	躒
khrm	躓
khof	躕
khxg	躖
khud	躘
khuy	躙
khsp	躚
khui	躝
khyc	躞
khbb	躡
khun	躢
khhy	躣
khpn	躥
khtm	躦
khgx	躧
khut	躨
khay	躪
tmdx	躬
tmdq	躭
tmdv	躮
tmdg	躰
tmds	躲
tmde	躴
tmdn	躵
tmdo	躹
tmdk	躺
tmda	躻
tmdd	躾
tmdi	躿
tmdl	軃
tmdu	軆
tmdm	軉
lgqn	軏
lnfh	軐
lwyy	軓
lvyy	軔
lwcy	軗
lhcy	軙
ldbn	軛
lmwy	軜
lqan	軝
ltfn	軞
ltfg	軠
lwyn	軡
lfcy	転
lqkg	軥
lkqn	軦
lqay	軧
lckg	軩
lxet	軪
lwet	軫
cdlj	軬
lagg	軭
lmdy	軮
lguf	軯
uxlj	軰
lqnn	軳
lygg	軴
lwfy	軵
ldcy	軷
lkwy	軹
lvkg	軺
lskg	軻
lrwy	軼
lcfg	軽
laay	軾
luah	軿
ldmj	輀
lawy	輁
awlj	輂
ligq	輄
lwgg	輇
ltey	輈
lgcf	輊
mdlj	輋
lgmm	輌
lwwk	輍
lieg	輎
lsgg	輏
lpfq	輐
lvtk	輑
lbnn	輒
lqkq	輓
lgey	輔
lmfk	輖
leqn	輗
lfwt	輘
lbcy	輙
lgmy	輛
lvlg	輜
lmun	輞
lccc	輟
ljsy	輠
lqeg	輡
leeg	輣
lgeg	輤
ljxx	輥
fwfl	輦
lphn	輨
hdhl	輩
lwga	輪
lyki	輬
ldmd	輭
lcns	輮
ldgy	輱
ldwd	輳
lrfh	輴
ljqn	輵
lusg	輶
lqyg	輷
ltjt	輹
lgvl	輺
ljlg	輼
lcdl	輽
llwl	轀
ldwt	轃
lonx	轆
lgjf	轉
ldhv	轊
llpy	轋
lfvg	轌
lyct	轍
lnbb	轏
logw	轐
ldui	轑
lfam	轒
ltol	轓
loqh	轔
lajn	轕
lfwk	轖
ldgn	轗
lugy	轙
lbwl	轚
logf	轛
lfdj	轜
egnl	轝
lahl	轞
lxxk	轡
lrxs	轢
ldth	轣
lhal	轤
lauy	轥
ltuf	轷
dufj	辜
ckuf	辝
thuf	辠
uduf	辡
gkif	辢
epcf	辤
btwf	辥
udvf	辧
hwnf	辪
ecmf	辭
udyf	辯
ssde	辳
pyny	辶
typi	込
gfpk	迂
fnpv	迃
gmhp	迊
gbnp	迍
dypi	迏
ywpv	迒
ahtp	迓
tfpk	迕
gdpi	迗
khpk	迚
hkpd	迠
nxpv	迡
anpv	迣
mkpd	迥
ekpd	迦
jhpk	迧
ckpd	迨
ygpd	迬
thfp	迮
qhpi	迯
pxpv	迱
fcpi	迲
lkpd	迴
mgkp	迵
depd	迶
qqpi	迻
fkpd	迼
gqjp	迾
qjpd	迿
tahp	逄
rgkp	逅
ubtp	逆
fbpv	逇
tmkp	逈
gehp	逋
hmnp	逌
sgpd	逎
gepi	逐
giyp	逑
rfmp	逓
gvap	逕
qtop	逖
ctdp	逘
gkpd	逜
rrpk	逝
gkip	速
cwtp	逡
iitp	逤
wwkp	逧
swwp	逨
dfap	逩
ajpd	逪
cccp	逫
tgdp	逬
phnp	逭
vipi	逮
rtbp	逰
mfkp	週
ycep	逳
hjfp	逴
fwfp	逵
jqrp	逷
fufp	逹
fnwp	逺
adkp	逽
jgqp	逿
daep	遀
rfhp	遁
utep	遃
mdmp	遄
nugp	遅
yupp	遆
jghp	遈
hmpi	遉
ytbp	遊
kkfp	遌
rgpd	遑
fmup	遖
amfp	遘
ehcp	遚
qyvp	遛
lipi	遝
nufp	遟
jnpd	遢
copi	遤
xfmp	遦
ujfp	遧
egep	遯
aqpp	遰
lvpd	遱
awwp	遳
usgp	遵
fffp	遶
nnap	選
cnhp	遹
khgp	遺
kkup	遻
hagp	遽
tawp	遾
qehp	邂
pwup	邃
ylkp	邅
wgkp	邆
gwmp	邇
erqp	邈
thpp	邊
vlrp	邋
tqtp	邌
tlvp	邍
qytp	邎
gmyp	邐
gfbh	邘
ynbh	邙
fwbh	邞
ywbh	邟
wvbh	邠
pqbh	邥
dtbh	邦
fqbh	邧
gbnb	邨
dtkc	邫
qkbh	邭
ckbh	邰
rgbh	邱
ntbh	邲
gmwb	邴
vkbh	邵
uxbh	邶
gnnb	邷
qayb	邸
agbh	邼
ffbh	邽
ribh	邾
dfnb	郀
yntb	郂
wgkb	郃
rdcb	郄
gcfb	郅
fkbh	郆
qjbh	郇
rgkb	郈
gdfb	郉
thbh	郋
ffkc	郌
tebh	郍
yvcc	郒
thpb	郔
dnxb	郕
rdmb	郗
kkbh	郘
gehb	郙
gkbh	郚
ebbh	郛
tfkb	郜
fobh	郝
yveb	郞
dwwb	郟
gjrb	郠
vtkb	郡
kgbh	郢
fpbb	郣
rdeb	郩
gvhb	郪
gebh	郬
ykbb	郭
mfkb	郮
bcbh	郰
uabh	郱
swwb	郲
eqbh	郳
ukkc	郶
xtvb	郷
hdyb	郹
qqvc	郺
hnvb	郻
nkab	郼
nhbh	郿
adkb	鄀
uxeb	鄁
kkfb	鄂
tkmb	鄅
wntb	鄇
wgdb	鄈
xtbb	鄊
ehcb	鄋
ovhb	鄌
pjyb	鄍
thnb	鄎
dfeb	鄏
yxlb	鄐
gogb	鄑
wngb	鄔
xtrb	鄕
ykmb	鄗
oveb	鄘
ajdb	鄚
vjsb	鄛
onjb	鄜
nweb	鄝
gjhb	鄟
wvgb	鄡
ujfb	鄣
jlcb	鄤
rlgb	鄦
umic	鄨
vakb	鄩
xjmb	鄪
uljb	鄫
qyvb	鄮
ugub	鄯
oqab	鄰
tolb	鄱
ogub	鄴
kkkb	鄵
wglb	鄶
magb	鄷
alpb	鄸
bcib	鄹
oamb	鄺
fwfb	鄻
ojfb	鄽
depb	鄾
akkb	鄿
akub	酀
qkxb	酁
mwyb	酅
mdhb	酆
gmyb	酈
sgsh	酊
sgnn	配
sgfy	酎
sgbn	酏
sgfh	酐
sggf	酑
isgg	酒
wyng	酓
sgvf	酔
sgtn	酕
sgpq	酖
sgwv	酚
sgfq	酛
sgfw	酜
sgdy	酞
sghk	酟
sgsk	酠
sgpx	酡
sgtf	酢
sgdg	酤
sgny	酦
sgpf	酧
fsgy	酨
sgqk	酩
sgwg	酫
sgmk	酮
sgxj	酯
sgtq	酰
sgxe	酳
sgws	酴
sgfb	酵
sgtx	酶
sgtk	酷
sgef	酹
sggy	酺
sgeb	酻
sgyk	酼
sgwy	醀
sgvi	醁
sgss	醂
sgdn	醃
sgqm	醄
sguk	醅
sgaa	醆
sgoo	醈
sgcc	醊
sgaj	醋
sgjx	醌
sgjh	醍
sgfj	醏
sgde	醐
sgjg	醒
sgpl	醓
tosg	醔
sgyj	醕
sgwq	醗
sgfl	醘
sgec	醙
sgop	醚
sgag	醛
sgrc	醜
sgua	醝
sgml	醠
sgdl	醢
sgok	醣
uefg	醤
sgsi	醥
sgce	醦
sgak	醧
sgyc	醨
sggj	醩
sgne	醪
atdg	醫
nhdg	醬
sgow	醭
sgwo	醮
sgyl	醯
sgsf	醰
sgwc	醱
sgme	醲
sglf	醳
sghe	醵
sgww	醶
sgun	醷
sgto	醺
sgff	醻
sgao	醼
sgfk	醽
sgoi	醿
sgye	釀
emgv	釁
sggx	釃
sgod	釄
sgkt	釅
tony	釈
tomg	釉
tolf	釋
tgjf	重
jgjf	量
fitf	釐
qqyy	釣
qwyy	釩
qgfh	釪
qfnn	釫
qftt	釮
qynn	釯
qvyy	釰
qtnn	釳
qayy	釴
qcyy	釵
qrhy	釽
qaht	釾
qpqn	鈂
qgah	鈃
qwcy	鈆
qfwy	鈇
qmwy	鈉
qwxn	鈋
qnwy	鈌
qgbn	鈍
qqcy	鈎
qxhh	鈏
qwyn	鈐
qrcy	鈑
qbyy	鈒
qnhf	鈕
qwvt	鈖
qcqn	鈗
qfcy	鈘
qxxn	鈚
qqug	鈞
qkhh	鈡
qghn	鈣
qdyy	鈦
qywn	鈧
qfqn	鈨
qynt	鈩
qdbn	鈪
qnyy	鈬
hxqf	鈭
qnxn	鈮
qbmh	鈯
qymh	鈰
qnna	鈱
qskg	鈳
qgmw	鈵
qckg	鈶
qdcy	鈸
qhcy	鈹
qgyy	鈺
qhnn	鈻
qthf	鈼
qdmh	鈽
qwet	鉁
qkry	鉂
qrwy	鉄
qang	鉅
qhkg	鉆
qpxn	鉈
qyxy	鉉
qqnn	鉋
qntt	鉍
qegg	鉏
qygg	鉒
qtmh	鉓
qtuy	鉖
qxjh	鉘
qkwy	鉙
qqtb	鉚
qwfy	鉜
qgny	鉞
qdhg	鉟
qmdy	鉠
qugh	鉡
qsgg	鉢
qsyy	鉥
qghg	鉦
qwiy	鉩
qann	鉪
qekg	鉫
qjgg	鉭
qjhh	鉮
qnyw	鉯
qngk	鉰
qocy	鉱
qhgh	鉲
quxn	鉳
qgaj	鉶
qawy	鉷
qywr	鉸
qqqy	鉹
qtkg	鉻
quah	鉼
qctg	鉾
qwgk	鉿
qqjg	銁
qycq	銃
qdjg	銆
qdiy	銇
qffg	銈
qvgh	銉
qdgy	銊
qwtf	銋
qdhb	銌
qgcf	銍
awyq	銎
qmmg	銏
gqjq	銐
qtfq	銑
qgdf	銒
qwgg	銓
qdhf	銔
qgxw	銕
qriy	銖
qrgk	銗
qqkg	銘
qdfn	銙
qqiy	銚
qwsy	銝
qjqf	銞
qmmh	銟
qftx	銠
qfkg	銡
qfiy	銢
qvkg	銣
qyey	銥
qldy	銦
qigq	銧
qpvg	銨
qtfc	銩
qdeg	銪
qqcn	銫
qftn	銬
qdxy	銭
qxiy	銯
qary	銰
qjfh	銲
rrqf	銴
qtmt	銵
qgiy	銶
qbnn	銸
qtbt	銹
nhdq	銺
quxt	銻
qwwf	銼
qqak	銽
qaiy	銾
qceh	銿
qgku	鋀
qtxy	鋂
qyve	鋃
qgoc	鋄
qufh	鋅
fquq	鋆
itdq	鋈
qgki	鋉
qwwk	鋊
qthp	鋋
qtfp	鋌
qfpb	鋍
qpfq	鋎
qdww	鋏
qpdc	鋐
qcwt	鋑
qtdh	鋒
qtjh	鋓
qqkq	鋔
qfny	鋕
qevg	鋖
qkeg	鋗
qkgd	鋘
qgkg	鋙
whtq	鋚
qkkh	鋛
qkhy	鋜
qefy	鋝
qgva	鋞
qvpc	鋟
qdfe	鋠
qebg	鋢
qege	鋤
qnnk	鋦
qhqn	鋧
qayn	鋩
tjqf	鋫
rrcq	鋬
qukq	鋭
qdny	鋮
qtfk	鋯
qjfg	鋰
qany	鋱
qrgw	鋲
qdtf	鋳
qdqn	鋴
qtwn	鋵
qbcy	鋷
qndg	鋸
qdey	鋹
qpqb	鋺
qhjf	鋽
qqrm	鋾
qimk	鋿
qjsy	錁
qfwt	錂
ihcq	錃
tqtq	錅
qgeg	錆
qudb	錈
qqaj	錉
qywf	錊
qeeg	錋
qmdf	錌
qrtf	錍
qqeg	錎
qgfg	錏
qwyg	錐
qyny	錑
qbsk	錒
qufq	錓
qijg	錔
qjxx	錕
hgiq	錖
qtvg	錗
qtfg	錘
qvlg	錙
qqvh	錚
qdfa	錛
qpfi	錝
qykb	錞
qooy	錟
qdsk	錡
qaay	錢
qccc	錣
qadw	錤
qyce	錥
qphn	錧
qalg	錨
qjjg	錩
qmaw	錪
qgji	錬
qmfk	錭
qldg	錮
qsoy	錰
qviy	録
qblg	錳
qfwf	錴
qawx	錵
qgey	錶
qlnn	錷
qsww	錸
qheg	錹
qayt	錺
qfhy	錻
qdfi	錼
qgot	錽
qhaw	錿
qyki	鍄
qxxr	鍇
qamd	鍈
qjgh	鍉
qgli	鍊
qoac	鍍
qrfh	鍎
qnkh	鍏
qrbt	鍐
qtjt	鍑
qcns	鍒
qkbg	鍓
qkkn	鍔
qplh	鍕
qadn	鍖
qyuh	鍗
qmjh	鍘
iawq	鍙
qjgr	鍚
qnhc	鍜
qjmy	鍝
qhmy	鍞
qjtg	鍟
qrgg	鍠
qlge	鍡
qavk	鍣
qqyg	鍧
qwgd	鍨
cnhq	鍪
toqf	鍫
qwnd	鍭
qwgj	鍮
qegc	鍰
qans	鍱
qnnj	鍲
qmdj	鍴
qlny	鍶
qdff	鍷
qpgg	鍹
qftj	鍺
qjqn	鍻
qyna	鍽
qtgf	鍾
qgvl	鍿
qwhe	鎀
qbbh	鎁
qugd	鎂
qire	鎃
qlwj	鎅
quej	鎆
qjng	鎉
qyuy	鎊
qpdk	鎋
quvo	鎌
qfpi	鎍
qrno	鎎
iycq	鎏
qerm	鎐
qfcl	鎑
qwcn	鎓
qpwk	鎔
qovk	鎕
qwyk	鎗
qgkh	鎘
qube	鎙
qwnp	鎚
qgef	鎛
tewq	鎜
qtlx	鎞
qccs	鎟
qlgh	鎠
quxx	鎡
qwno	鎢
oopq	鎣
qjiq	鎤
qqyl	鎦
qmgu	鎧
qwyf	鎨
qrsc	鎩
qehc	鎪
qykk	鎬
qxhw	鎭
quwl	鎰
qfke	鎱
qipq	鎲
qths	鎳
qthn	鎴
qpge	鎵
qskk	鎶
qcoy	鎷
qwyb	鎸
qudp	鎹
qpyg	鎺
qvmy	鎻
qhar	鎼
qmth	鎽
qjlg	鎾
qhlo	鏀
qvjs	鏁
qakk	鏂
qytd	鏃
qgjf	鏄
qxfm	鏆
qyth	鏇
qgkw	鏉
gqtq	鏊
qamy	鏋
qajd	鏌
qlxi	鏍
qjaf	鏎
qdhv	鏏
qnwe	鏐
qyud	鏑
qcce	鏒
qtln	鏓
qonx	鏕
onjq	鏖
qahf	鏗
qiph	鏛
qipf	鏜
qjlc	鏝
qovh	鏞
qutg	鏟
qtdp	鏠
qsfi	鏢
qoao	鏣
qlvg	鏤
qpwj	鏥
fnwq	鏧
lrqf	鏨
qlrh	鏩
qgmj	鏪
qhaf	鏬
qovi	鏮
qdrr	鏯
qmee	鏰
qyxg	鏲
qulj	鏳
qkhk	鏴
qagf	鏵
qwys	鏶
qogw	鏷
qgjn	鏸
qxkj	鏹
qwxc	鏺
qoqh	鏻
qtgi	鏼
qvfj	鏽
qaet	鏾
qips	鏿
qkhm	鐀
qadr	鐁
qgjl	鐂
qffq	鐃
qamw	鐄
umiq	鐅
bueq	鐆
qtol	鐇
qnnw	鐉
qbjr	鐊
qijr	鐋
qqke	鐌
qcnk	鐍
qwyo	鐎
qusf	鐏
qxfk	鐑
qooe	鐒
qykt	鐓
qsjf	鐔
qaqj	鐕
qxxy	鐖
queg	鐗
qujf	鐘
qwgu	鐙
qgfn	鐚
qjyi	鐛
ykbq	鐜
qvaf	鐞
qfwj	鐟
quoj	鐠
srrq	鐢
qipr	鐣
qugk	鐥
qxjm	鐨
quep	鐩
qhae	鐪
qhdy	鐬
qtmd	鐭
qouo	鐮
qkks	鐰
qwgw	鐱
qlqj	鐲
qflg	鐳
qnkf	鐴
qfky	鐵
qaas	鐷
qlff	鐸
qmnp	鐹
qipl	鐺
qfam	鐼
qfup	鐽
nkuq	鐾
qujn	鐿
qept	鑀
qobt	鑁
qtgo	鑂
qoos	鑅
qogf	鑆
qyuj	鑇
qgwr	鑈
qafl	鑉
qawc	鑊
lgvq	鑋
qpgm	鑌
mmqf	鑍
qakm	鑎
qpns	鑏
qfdj	鑐
qahl	鑑
ahnq	鑒
qkhp	鑓
qrrm	鑕
qaly	鑖
qlll	鑘
qtdj	鑙
qfwm	鑚
qoaw	鑛
qipm	鑜
qatp	鑝
qvln	鑞
qflm	鑟
qrxs	鑠
qhbh	鑡
qhan	鑢
qono	鑣
qjai	鑤
qqoj	鑥
qahm	鑦
qpay	鑧
qued	鑨
qgkk	鑩
qhal	鑪
qqqf	鑫
qahq	鑬
qugi	鑭
qaif	鑮
qwwy	鑯
qwga	鑰
qqky	鑱
qyke	鑲
qpah	鑳
qmwk	鑴
qaky	鑵
qady	鑶
qbbb	鑷
qllf	鑸
qpwn	鑹
qhhy	鑺
qsrr	鑻
qtfm	鑽
yxxq	鑾
qhay	钀
qhhc	钁
qipo	钂
qnij	钃
qaui	钄
qtgn	钅
qnrt	钖
qdhy	钚
qakg	钷
qgog	铔
qahb	铘
qkmh	铞
qkgg	锃
qyck	锍
quga	锎
qujg	锏
qadk	锘
qjgf	锝
qrfm	锧
qrqw	锨
qqrn	锪
qukg	锫
qnhg	镅
qwgr	镎
qduw	镢
qqgj	镥
qpwh	镩
qpwi	镲
dcqy	镹
dctd	镺
dcrw	镻
dcnm	镼
dcdi	镽
dcgr	镾
uhng	門
ugak	開
uywv	閌
udci	閎
uufk	閗
uymh	閙
uguf	閛
ucak	閞
unte	閟
uynw	閡
uudi	関
uwgk	閤
uwai	閥
uwww	閦
uawi	閧
uffd	閨
ulsi	閫
uyve	閬
ukkd	閭
utfp	閮
ujjd	閶
rsuw	閷
udjn	閹
ujyi	閺
uqed	閻
uqaj	閽
uakg	閾
uepc	閿
uawn	闀
uudb	闂
uhdy	闃
usvd	闄
uhhc	闅
ukkk	闆
unkh	闈
usfd	闉
ugli	闌
urii	闎
ufhw	闐
uths	闑
ujnd	闒
ufcl	闔
uubw	闕
ucoi	闖
ugkf	闘
uynk	闙
ufwq	闚
uipf	闛
uxxg	關
umti	闝
unbt	闞
ukhm	闠
ukkl	闡
unkf	闢
uipl	闣
ufup	闥
umau	闦
ufkp	闧
umnv	闿
bnfh	阠
btfh	阡
bgqn	阢
btnn	阣
bufh	阧
bdbn	阨
bdhy	阫
bywn	阬
bcqn	阭
bfqn	阮
bxxn	阰
bfjh	阱
bynn	阸
bqay	阺
bthf	阼
bhkg	阽
btbn	陁
bhcy	陂
bgmw	陃
bqqy	陊
btah	降
briy	陎
bdeg	陏
bqdb	陒
bdfn	陓
bcwt	陖
bieg	陗
bgva	陘
bdfe	陙
bxxf	陛
bdww	陜
bdty	陝
btaf	陞
bhht	陟
bgey	陠
bfhy	陡
bqhj	陥
bdtf	陦
bhdd	陫
bbcy	陬
bdsk	陭
bwyg	陮
bwga	陯
bwyc	陰
bqoy	陱
btfg	陲
brtf	陴
bqrm	陶
btaj	陹
bsfg	陻
bftj	陼
bdmd	陾
badw	陿
btgf	隀
bajv	隁
bwdc	隂
bwgj	隃
bjgh	隄
bjmy	隅
bdgy	隇
blge	隈
beag	隉
bdae	隋
bujg	隌
brgg	隍
bmgu	隑
buvo	隒
bdaa	隓
bgkh	隔
bwno	隖
brqc	隗
buwl	隘
biji	隙
bipf	隚
bwfi	際
bwvo	隝
bgqt	隞
bvjs	隟
bevn	隠
butg	隡
bffq	隢
boqh	隣
bwgu	隥
bnkf	隦
bdap	隨
btmd	隩
bwgw	險
bfam	隫
bgwr	隬
byuj	隮
bfnf	隯
bjxo	隰
bito	隲
bdan	隳
bued	隴
bhaa	隵
ffii	隷
sfii	隸
pwyd	隺
wycu	隻
aywy	隿
dwwy	雁
wysu	集
hghy	雈
tdwy	雉
wyhm	雋
yxty	雍
egwy	雎
hawy	雐
vswy	雑
tkwy	雒
wgsy	雓
kjwy	雖
fjfy	雗
myac	雘
wywc	雙
ywwy	雜
vkcy	雝
btwk	雟
nwey	雡
akfy	難
erry	雤
fghy	雨
ffnb	雩
fghu	雫
fbyu	雭
ftfn	雮
fwvr	雰
fmdu	雵
fwyc	零
faff	雸
fcnt	雺
fqiu	雿
fisu	霂
fipq	霃
fief	霄
ftfp	霆
figh	霈
ffog	霊
fgvv	霋
fmfk	霌
fuvf	霎
fhdd	霏
fixc	霐
ffcn	霒
fiyg	霔
fssu	霖
fiwc	霗
famd	霙
fxxx	霛
fkkk	霝
fiaw	霟
fuwn	霠
feyi	霡
fere	霢
fkmu	霣
fqyl	霤
fsse	霦
fcne	霧
fnrf	霫
flaw	霬
fian	霮
faet	霰
fcnk	霱
fbtg	霳
ffci	霴
fkby	霵
fiyy	霶
fjjr	霷
fnkf	霹
ftmt	霺
fmau	霻
ffco	霼
fyuj	霽
fejf	霾
fcnh	霿
fape	靀
flll	靁
fdth	靂
fyjn	靄
ffcm	靅
ffcp	靆
ffct	靉
fidh	靋
fpgm	靌
fwyo	靍
fqwo	靎
fpwo	靏
flfl	靐
gmhg	靑
gern	靔
ghge	靕
ugeg	靖
geiq	靗
geqc	靘
geph	靛
gero	靝
hdhd	非
dlkf	靣
dmjq	靦
dmjm	靧
djed	靨
akfj	革
akfx	靴
akfc	靶
akft	鞂
akfd	鞅
akff	鞋
pvaf	鞌
akfv	鞍
awyf	鞏
akfq	鞔
whtf	鞗
akfa	鞚
akfb	鞟
akfu	鞡
akfs	鞣
akfo	鞦
akfr	鞭
akfl	鞰
akfh	鞴
tewf	鞶
gkmf	鞷
akfm	鞼
akfg	韁
akfp	韆
nkah	韋
nkay	韌
nkas	韎
udnh	韏
nkak	韐
igqh	韑
fjfh	韓
jghh	韙
nkaf	韚
nkae	韜
nkal	韞
nkan	韢
nkaj	韣
nkam	韥
fnhy	韨
hdhg	韭
ahdg	韮
fhdy	韯
hqcg	韰
wwgy	韱
ujgh	韴
ujbm	韷
ujth	韸
ujrg	韹
ujad	韺
ujtp	韼
wynj	韽
xtyj	響
ujac	頀
xdmy	頃
vdmy	頄
admy	項
kdmy	順
fdmy	頇
edmy	須
hdmy	頉
gdmy	頊
dbdm	頋
wcdm	頌
fcdm	頍
rdmy	頎
ywdm	頏
cnhm	預
fqdm	頑
wvdm	頒
hkdm	頕
ugdm	頖
ghdm	頙
cfdm	頚
didm	頛
wgkm	頜
ywrm	頝
pvdm	頞
tkdm	頟
qdbm	頠
fkdm	頡
tddm	頢
ahkm	頤
hahm	頥
yntm	頦
ndmy	頨
uadm	頩
qidm	頫
gudm	頬
gkum	頭
qadm	頯
dwwm	頰
efdm	頱
tfpm	頲
fodm	頳
xfim	頴
vtkm	頵
tfkm	頶
tbdm	頺
twdm	頽
edmx	頾
ehxm	頿
wydm	顀
oodm	顃
bibm	顄
ynem	顅
ywwm	顇
xxim	顈
qdmy	顉
lndm	顋
ptkm	額
kkfm	顎
pldm	顐
dgkm	顑
jmhm	顒
mdmm	顓
utem	顔
jogm	顕
tlrm	顖
mgkm	顗
drim	願
cccm	顙
xhnm	顚
amfm	顜
medm	顝
nwem	顟
sfim	顠
uedm	顡
amhm	顢
dhgm	顣
fffm	顤
jykm	顥
wyom	顦
dmdj	顨
hdgm	顪
alpm	顭
hhdf	顰
halm	顱
ooym	顲
bbbm	顳
akkm	顴
fdmm	颥
wtji	風
wtje	颩
ghwj	颪
wtjt	颬
wtjn	颮
wtjy	颰
wtjk	颱
wtjj	颲
wtjd	颳
wtjw	颶
wtjo	颷
ermj	颻
wtjc	颼
cowj	颿
wtjl	飀
nrwj	飁
sfij	飄
dydj	飆
oooj	飊
wrnr	飏
wrhk	飐
wrln	飔
ermr	飖
wrql	飗
wroo	飚
nuth	飛
tolh	飜
wyve	食
uwye	飡
wywn	飢
wysh	飣
wyta	飥
wyfh	飦
qwye	飧
wygn	飩
wytf	飪
wytd	飫
udye	飬
wyte	飭
wyvw	飮
wyrc	飯
wyyh	飰
wyyg	飳
wyck	飴
wyeg	飷
wyqb	飹
hxwe	飺
wyqn	飽
wyth	飾
wybm	飿
wyar	餀
wyyr	餃
wywk	餄
wyua	餅
wyqi	餆
wymk	餇
uqwe	餈
wytk	餉
udwe	餋
wyye	餏
hqce	餐
wyfb	餑
wyev	餒
wygy	餔
wyct	餕
wygu	餖
wygi	餗
wyws	餘
wyrh	餙
wyre	餚
wyjx	餛
wyjs	餜
wyay	餝
wyaa	餞
wycc	餟
wyqe	餡
wyuk	餢
wydn	餣
wyde	餦
wytv	餧
wypn	館
wyww	餩
wydd	餪
wypl	餫
wyrg	餭
wyxe	餯
wyts	餰
wywd	餱
wyjn	餲
wyjr	餳
wyda	餴
wyme	餶
wysg	餷
wyup	餸
wyok	餹
wygf	餺
wyuo	餻
wyro	餼
wyql	餾
wyec	餿
wyee	饀
wyfl	饁
wyjl	饂
wyad	饃
wyif	饄
wyjf	饆
wyak	饇
wyuf	饈
wyag	饉
wyat	饊
wykm	饋
wynw	饌
wyfk	饎
nbte	饏
wyfu	饐
wyxy	饑
wyfq	饒
wyis	饓
yxte	饔
kgne	饕
wyhy	饖
xtye	饗
wyfm	饙
wyal	饚
wyae	饛
djee	饜
wyod	饝
wyqy	饞
wyly	饠
wytm	饡
wyge	饢
qnsh	饤
qnta	饦
qnbm	饳
qnwk	饸
qntk	饹
qnye	饻
qngu	饾
qnct	馂
qnjs	馃
qnsg	馇
qnme	馉
qnfl	馌
qngf	馎
qnat	馓
qnge	馕
vuth	馗
uthg	馘
tjwv	馚
tjdy	馛
tjnx	馜
tjnt	馝
tjfb	馞
tjeb	馟
tjwk	馠
tjhd	馡
tjaa	馢
tjdn	馣
tjjn	馤
tjtt	馥
tjuo	馦
tjjl	馧
fnwj	馨
tjfm	馩
tjpm	馪
tjtj	馫
cocy	馭
ucoy	馮
cofh	馯
coqy	馰
cody	馱
cota	馲
cokh	馴
coaj	馵
cofc	馶
cogh	馷
corh	馸
cojg	馹
coby	馺
cocq	馻
coyy	馼
copq	馾
xfco	駂
conw	駃
cony	駅
coar	駆
coty	駇
corg	駈
comk	駉
cohc	駊
covk	駋
qbco	駌
cogf	駍
comg	駎
coan	駏
coyg	駐
vcco	駑
coqk	駒
codg	駓
coeg	駔
ekco	駕
cowc	駖
cowe	駗
cock	駘
cowf	駙
comd	駚
cont	駜
copx	駝
cotb	駞
colg	駟
coqb	駠
kkco	駡
coua	駢
coqi	駣
coad	駥
udco	駦
coqj	駨
cowg	駩
cotq	駪
coiq	駫
cobg	駬
coyw	駭
coyr	駮
cori	駯
cold	駰
coyh	駲
cotp	駳
coaa	駴
cogn	駵
conk	駶
cogi	駷
covc	駸
cojf	駻
cows	駼
coke	駽
couq	駾
comn	騁
couf	騂
cocd	騃
covi	騄
cowy	騅
cowk	騇
cotf	騈
cojx	騉
coqm	騊
cosw	騋
cojs	騍
coaw	騏
cown	騐
cohd	騑
cojn	騔
cosv	騕
ynmo	騗
coqn	騘
couj	騚
conh	騛
covp	騝
codd	騞
cojh	騠
conc	騢
cort	騣
cowd	騤
cocs	騥
coln	騦
coil	騨
corc	騩
coec	騪
pawo	騫
cotx	騬
bhho	騭
coql	騮
eudo	騰
coed	騱
coco	騳
cojv	騴
codi	騵
coqt	騶
cocj	騷
coyn	騸
coag	騹
codr	騻
coox	騼
conr	騽
coli	騾
ajdo	驀
coce	驂
cosi	驃
cotn	驄
cohg	驉
coaf	驊
covj	驌
cooh	驎
conb	驏
coyt	驐
cogl	驑
cokl	驒
cosf	驔
cotk	驕
cofy	驖
coww	驗
colf	驛
cooi	驜
cofs	驝
copm	驞
coao	驠
uego	驡
cohl	驢
couo	驣
coye	驤
couw	驥
coay	驩
cogx	驪
cgjg	驲
cgld	骃
cgcg	骉
cguf	骍
cgvc	骎
cgpi	骔
cgvj	骕
cgwd	骙
cgfh	骦
mevn	骩
mewy	骪
mevy	骫
megf	骬
mefh	骭
meay	骮
mewc	骰
mewj	骱
meqn	骲
mehc	骳
mehx	骴
mesg	骵
meqy	骶
medg	骷
meyw	骸
meyr	骹
merk	骺
medn	骻
metk	骼
meev	骽
megr	骾
meua	骿
merf	髀
mejs	髁
mepk	髂
mejy	髃
meyk	髇
meyy	髈
meos	髍
mene	髎
melv	髏
mefq	髐
melj	髑
medp	髓
mepm	髕
mepy	髖
mehl	髗
yjfk	髙
ykmv	髛
ykma	髜
ykme	髝
dcet	髟
dcew	髠
dceq	髡
dcen	髦
dcek	髫
dceg	髬
dcex	髭
dcey	髮
dcef	髯
dcej	髴
dcea	髷
dces	髹
dced	髺
dcei	鬃
dcer	鬄
dcec	鬆
dceb	鬈
dcee	鬍
dceo	鬏
dcep	鬔
dcem	鬚
hggh	鬥
hggf	鬦
hggw	鬨
hggq	鬩
hggt	鬫
hggr	鬬
hggx	鬮
obxb	鬯
srre	鬰
srme	鬱
gkmh	鬲
hagh	鬳
gkmy	鬴
fwmh	鬶
gkmt	鬷
gkml	鬸
fwhh	鬹
gkmr	鬺
xoxh	鬻
rqci	鬼
rqcr	鬿
rqcj	魀
rqcf	魁
fcrc	魂
rrqc	魄
rqce	魈
rqcg	魊
rqcw	魌
rqcn	魍
rqcy	魎
tvrc	魏
rqco	魐
rqcc	魑
ossc	魔
fnac	魗
djec	魘
ilrc	魙
qovt	魛
qowy	魜
qojh	魝
qoag	魟
qota	魠
qoqy	魡
qonn	魢
qoch	魣
qowx	魤
qoby	魥
qoit	魦
qoyw	魧
qogn	魨
qoqr	魩
qowj	魪
qorc	魬
qofq	魭
qoxx	魮
qojf	魯
qoyy	魰
qogg	魱
qoyn	魲
qogh	魳
qoyt	魴
qowv	魵
qomw	魶
qody	魷
qotn	魸
qosk	魺
qolh	魻
qofc	魼
qodg	魾
qopx	鮀
qolw	鮂
qoxj	鮄
qont	鮅
hxqo	鮆
qofi	鮇
qoqk	鮈
qomg	鮋
qoyx	鮌
qohc	鮍
qohk	鮎
qotg	鮏
qock	鮐
qowf	鮒
qotf	鮓
qoan	鮔
qotu	鮗
qong	鮙
qofk	鮚
qohi	鮛
qork	鮜
udqo	鮝
qodj	鮞
qopv	鮟
qoqb	鮠
qoqi	鮡
qori	鮢
qotk	鮥
qoua	鮩
qode	鮪
qoyr	鮫
qodn	鮬
qoff	鮭
qoug	鮮
qowk	鮯
qolk	鮰
qofx	鮱
qofn	鮳
qouq	鮵
qout	鮷
qoqq	鮸
qoie	鮹
ugqo	鮺
qoct	鮻
qovc	鮼
qoev	鮾
qobn	鮿
qoti	鯀
qogr	鯁
qosg	鯂
qogy	鯄
qotp	鯅
qopq	鯇
iito	鯊
qoyk	鯍
qotj	鯏
qofh	鯐
qorh	鯑
qovl	鯔
qoge	鯖
ufwo	鯗
qotv	鯘
qoyb	鯙
qotb	鯚
qomk	鯛
qouv	鯜
qold	鯝
qogi	鯟
qosw	鯠
qohd	鯡
qoeq	鯢
qojr	鯣
qojx	鯤
qojj	鯧
qowa	鯩
qoft	鯪
qobc	鯫
qobl	鯭
qopi	鯮
qorj	鯯
qown	鯰
qohw	鯱
qoyu	鯲
qonj	鯴
qoce	鯵
qopl	鯶
qowd	鯸
qojg	鯹
qogj	鯻
qort	鯼
qovb	鯽
qowr	鯾
qoya	鯿
qoec	鰀
qomj	鰂
qole	鰃
qojy	鰅
qocs	鰇
qoas	鰈
qorg	鰉
qoav	鰋
qoto	鰍
qovp	鰎
qogl	鰏
qokn	鰐
qott	鰒
qoln	鰓
qonc	鰕
qopf	鰘
qoak	鰙
qopg	鰚
qojl	鰛
qowo	鰞
qocj	鰠
qoql	鰡
qoco	鰢
qowh	鰤
qoux	鰦
qojn	鰨
qoem	鰩
qofl	鰪
qopk	鰫
qohy	鰬
qofj	鰭
qoll	鰮
qoxu	鰯
qoph	鰰
qolp	鰱
qoae	鰳
qomt	鰴
txto	鰵
qowi	鰶
qows	鰷
qoaf	鰹
qojc	鰻
qonr	鰼
qosi	鰾
qogm	鰿
vcao	鱀
qogp	鱁
qonf	鱂
qooi	鱇
qofv	鱈
umio	鱉
qohg	鱋
qoqe	鱌
qowc	鱍
qosf	鱏
qovj	鱐
qouf	鱒
qokl	鱓
qouk	鱔
qotl	鱕
qodw	鱖
qooh	鱗
qovf	鱘
qouj	鱛
qoxb	鱜
qofm	鱝
erro	鱟
qomd	鱡
qoks	鱢
qoyg	鱣
qoxg	鱦
qomu	鱧
qoij	鱨
qoet	鱫
qoyj	鱭
qoew	鱮
qolj	鱰
qovn	鱲
qors	鱳
qoay	鱴
qoue	鱶
qogk	鱷
qohl	鱸
qogx	鱺
qoqo	鱻
qgvt	鱽
qgnn	鱾
qggn	鲀
qgcn	鲃
qgsk	鲄
qggf	鲆
qghk	鲇
qgmg	鲉
qgtf	鲊
qgrg	鲌
qghc	鲏
qgmk	鲖
qgrk	鲘
qgwc	鲙
ugqg	鲝
qgvk	鲪
qgch	鲬
qgaw	鲯
qgld	鲴
qgce	鲹
qgnj	鲺
qgfm	鲼
qggl	鲾
qgic	鲿
qgjh	鳀
qgle	鳂
qgri	鳈
qgya	鳊
qgcj	鳋
qguo	鳒
txtg	鳘
qgoh	鳙
qgnf	鳚
qgnr	鳛
qgac	鳠
qgdn	鳡
qgyg	鳣
qgtn	鳤
wvgo	鳥
wvgn	鳦
wvgw	鳧
vwvo	鳩
cwvo	鳮
wwvo	鳯
tywo	鳰
fwvo	鳱
nfwo	鳵
aywo	鳶
fcwo	鳷
ynwo	鳸
wyno	鳹
fwwo	鳺
wvwo	鳻
ywvo	鳼
gawo	鳽
gmho	鳾
gwvo	鳿
dhwo	鴀
nwwo	鴂
aqwo	鴄
mywo	鴅
pqwo	鴆
xfwo	鴇
dwwo	鴈
ghwo	鴊
gdwo	鴌
arwo	鴎
ekwo	鴐
vcwo	鴑
wyco	鴒
ntwo	鴓
tpwo	鴔
wvgx	鴕
nnao	鴖
uwvo	鴗
cawo	鴘
wvgk	鴚
qbwo	鴛
hxwo	鴜
qkwo	鴝
kgno	鴞
qayo	鴟
jgwo	鴠
egwo	鴡
xewo	鴢
dwvo	鴣
wvgu	鴤
mdwo	鴦
lwvo	鴨
rwwo	鴩
ipwo	鴬
wnno	鴭
dfno	鴮
dmjo	鴯
tdwo	鴰
xjwo	鴲
pvwo	鴳
tgso	鴴
qiwo	鴵
fkwo	鴶
riwo	鴸
ugwo	鴹
gxwo	鴺
iawo	鴻
vkwo	鴽
ctgo	鴾
wgko	鴿
wtfo	鵀
ywro	鵁
wswo	鵂
tewo	鵃
gcfo	鵄
tkwo	鵅
twvs	鵆
rhfo	鵇
yowo	鵉
nnwo	鵋
pfqo	鵍
evwo	鵎
geho	鵏
awwo	鵐
kewo	鵑
wwko	鵒
fpbo	鵓
wvgt	鵔
cwto	鵕
rdmo	鵗
gvao	鵛
uxho	鵜
trxo	鵝
tfko	鵠
fhno	鵡
gkio	鵣
ugjo	鵥
wvgi	鵦
uawo	鵧
wgdo	鵨
ebco	鵩
djno	鵪
hjfo	鵫
eewo	鵬
qwvo	鵭
qewo	鵮
rtfo	鵯
mfko	鵰
yneo	鵳
qkqo	鵵
gfgo	鵶
pqbo	鵷
dsko	鵸
ywto	鵺
pwao	鵼
ccco	鵽
jxxo	鵾
wvga	鵿
eqwo	鶂
wvgq	鶃
gewo	鶄
vlwo	鶅
gjio	鶇
gvho	鶈
ovwo	鶊
ndwo	鶋
nbmo	鶌
jqro	鶍
pfio	鶎
efwo	鶏
sypo	鶐
oowo	鶑
alwo	鶓
ujwo	鶕
towo	鶖
jgho	鶗
dewo	鶘
yupo	鶙
kkfo	鶚
xxro	鶛
acno	鶜
gklo	鶝
rfho	鶞
pwdo	鶟
ajvo	鶠
jqwo	鶡
egdo	鶢
plwo	鶤
nhwo	鶥
amdo	鶧
xgeo	鶨
cnho	鶩
hdyo	鶪
glio	鶫
wyvo	鶬
xywo	鶭
ykmo	鶮
kmwo	鶰
wcno	鶲
pwyo	鶴
qbto	鶵
ovho	鶶
pdho	鶷
xuxo	鶸
qyvo	鶹
iweo	鶺
mewo	鶻
uvoo	鶼
wyfo	鶽
fjfo	鶾
uxxo	鶿
uwlo	鷁
ermo	鷂
jpvo	鷃
exdo	鷄
sswo	鷅
xhno	鷆
fpdc	鷇
rhao	鷉
gkmo	鷊
awgo	鷋
thso	鷍
rdfo	鷎
jdfo	鷐
tuwo	鷑
gjho	鷒
oaoo	鷓
atdo	鷖
akko	鷗
fufo	鷙
nweo	鷚
oveo	鷛
lvwo	鷜
jafo	鷝
drro	鷞
ytto	鷟
dubo	鷢
sjfo	鷣
kklo	鷤
xxio	鷥
wyoo	鷦
fpgo	鷧
agao	鷨
hhpo	鷪
vfjo	鷫
amwo	鷬
tolo	鷭
tdko	鷮
dujo	鷯
thio	鷱
ykio	鷲
uewo	鷳
uswo	鷴
nfto	鷵
lmwo	鷶
usgo	鷷
owwo	鷹
khto	鷺
ujno	鷾
lqjo	鸀
iexo	鸂
ryto	鸄
lfuo	鸅
hako	鸆
ylko	鸇
sjgo	鸉
pnlo	鸋
wvgc	鸌
gwmo	鸍
mmwo	鸎
apfo	鸏
qtyo	鸑
lllo	鸓
halo	鸕
fsho	鸘
mmvo	鸚
hhwo	鸜
gmyo	鸝
yxxo	鸞
nqyg	鸤
wbqg	鸧
kgng	鸮
wycg	鸰
ipqg	鸴
tgsg	鸻
teqg	鸼
alqg	鹋
jxxg	鹍
qeqg	鹐
ovwg	鹒
pqbg	鹓
vijg	鹔
jqwg	鹖
toqg	鹙
nhqg	鹛
gkmg	鹝
wcng	鹟
qyvg	鹠
uwlg	鹢
lgkg	鹮
qync	鹱
apfg	鹲
fshg	鹴
hlou	鹵
hlon	鹶
hloc	鹷
hloy	鹹
hloa	鹺
hloo	鹻
hlow	鹼
ahnl	鹽
onjx	鹿
onjw	麂
wvox	麄
onjn	麅
onjg	麈
ffox	麉
onjo	麋
onjd	麌
onjk	麍
onje	麎
ssox	麓
onji	麖
onjj	麘
onjy	麙
onjc	麚
onjs	麜
swwq	麥
swwt	麨
swww	麩
swwc	麬
swwa	麯
swwo	麴
swwd	麵
swwu	麷
gqqo	麹
gqdd	麺
ossx	麼
ossn	麾
ossk	麿
ossm	黂
agmw	黃
amwn	黅
amwq	黆
amwk	黇
errw	黌
twiu	黍
twik	黏
twic	黐
jfou	黒
lfon	黔
lfoy	默
jfdo	黙
wayo	黛
lfoe	黝
lfok	點
lfoq	黟
ddyo	黡
lfot	黢
lfox	黣
lfoi	黥
lfob	黦
tqto	黧
lfoa	黭
lfoj	黯
lfow	黰
djeo	黶
lfom	黷
lfol	黸
oguv	黺
oguy	黻
xhng	黽
fqxf	黿
fwxf	鼀
fcxf	鼁
jgxf	鼂
ffxf	鼃
rixf	鼄
tdkx	鼅
pjyx	鼆
gqtx	鼇
kklx	鼉
nkux	鼊
jgkn	鼌
hndn	鼎
bhnn	鼐
hhnn	鼑
fthn	鼒
fkuc	鼓
fkuu	鼕
fafc	鼖
qifc	鼗
fkuf	鼙
ijgc	鼝
enun	鼠
enuy	鼣
enux	鼧
enuu	鼨
enug	鼪
enum	鼬
enuf	鼭
enup	鼮
enuk	鼯
enue	鼱
enul	鼲
enuv	鼴
enuw	鼶
enud	鼷
enuo	鼸
thlj	鼻
thlh	鼼
thlv	鼽
thlf	鼾
thlq	鼿
thly	齀
thlk	齁
thli	齂
thln	齃
thlg	齄
thlc	齆
thle	齈
yuho	齌
yuhl	齍
yuhm	齎
yuhg	齏
hbnn	齓
hbxn	齔
hbtn	齕
hbat	齖
hbrh	齗
hbwj	齘
hbqn	齙
hbtf	齚
hban	齛
hbhx	齜
hbck	齝
hbkw	齞
hbeg	齟
hbvk	齠
hbwc	齡
hobc	齢
hbqk	齣
udhb	齤
hbjx	齥
hbve	齦
dhvb	齧
hbyr	齩
hbkh	齪
hbls	齫
hbgk	齬
hbrr	齭
hbdk	齮
hbeq	齯
hbaj	齰
hbbc	齱
hbty	齲
hbpl	齳
hbue	齴
hbjy	齵
hbkn	齶
hbnf	齷
hbul	齸
ugab	齹
hbqt	齺
hbfw	齻
hbsh	齼
hbsi	齽
hagb	齾
hwbn	龁
hwbr	龂
uegd	龍
uega	龏
oued	龐
uegi	龒
deud	龓
uegw	龔
wgkd	龕
fkkd	龗
ttxg	龝
wgki	龣
aaab	㐂
rvnv	㐆
vcnb	㐐
vknb	㐒
sknb	㐓
yknb	㐔
fknn	㐖
gknb	㐚
giyv	㐜
rqkn	㐝
iebn	㐢
olnv	㐣
qegn	㐥
ynht	㐧
gbwi	㐪
yrbj	㐫
yckb	㐬
ylkf	㐭
ywae	㐮
wgqn	㐳
wcgg	㐷
wqwy	㐸
wrnn	㐹
wwry	㐽
wfqn	㐾
wbmh	㑁
wgmw	㑂
wxet	㑃
wkqn	㑆
wyoy	㑊
wmag	㑋
wagg	㑌
wdiy	㑍
wpfy	㑏
wcdc	㑓
wdmy	㑔
wmqy	㑕
wtmt	㑗
wbnn	㑙
wrrh	㑜
woah	㑞
wrgw	㑟
wjcf	㑠
wvcb	㑡
wfcb	㑢
walg	㑤
wjqr	㑥
wtbg	㑧
wktd	㑨
wlqy	㑩
wlgj	㑭
wcns	㑱
wfmf	㑲
wutd	㑵
wrno	㑶
wcex	㑷
wwyb	㑺
wpnm	㑻
wltk	㑼
wipf	㑽
wqyg	㑾
wvjs	㑿
wlff	㒁
wafy	㒃
wqdo	㒄
wrlo	㒇
wnbt	㒈
wips	㒉
wvyh	㒊
wadr	㒋
woow	㒌
wcci	㒍
wpau	㒏
wogi	㒒
wfup	㒓
wlqj	㒔
wajy	㒖
wahu	㒘
wean	㒚
wnwy	㒛
wegw	㒜
waly	㒝
wmwm	㒞
whqg	㒠
weri	㒡
wbbb	㒤
wmdu	㒥
wllf	㒦
wetn	㒨
wahe	㒪
ghfq	㒫
fqgd	㒬
kqkq	㒭
fqge	㒮
tyqu	㒱
mhty	㒳
tybm	㒴
muwn	㒺
jhqb	㒻
amhy	㒼
judb	㒽
jyry	㒿
pyta	㓃
cccq	㓄
uwxn	㓆
uwgg	㓌
uycq	㓍
uvpc	㓎
umwk	㓏
ufwf	㓐
ufuf	㓑
ufmf	㓓
ujaf	㓖
udhi	㓗
fjjh	㓝
dhvt	㓞
hcjh	㓟
hkjh	㓠
rmjh	㓡
tkjh	㓢
fkjh	㓤
ivjh	㓥
djjh	㓦
yvcv	㓪
udvj	㓬
jqwj	㓭
mfkj	㓮
vljh	㓯
ynmj	㓲
jghj	㓳
thsj	㓷
nngj	㓸
dooj	㓹
hayj	㓺
lghj	㓻
swij	㓼
mpfj	㓽
twij	㓿
jykj	㔀
xqcv	㔃
sojh	㔄
vfjj	㔅
wxwj	㔇
ahdj	㔈
ntkj	㔉
ylkj	㔊
bcij	㔌
btwv	㔎
dddj	㔏
tghj	㔐
awnv	㔑
mwyj	㔒
tfet	㔓
ekkf	㔔
rnet	㔕
xjet	㔗
bmet	㔘
uaet	㔙
tdet	㔚
fker	㔛
ebet	㔜
gmhe	㔝
tgve	㔟
jqwe	㔠
xqce	㔢
llle	㔣
ptoe	㔤
lcee	㔥
ugwe	㔦
quxe	㔨
xjfj	㔬
awkd	㔯
aewi	㔱
annw	㔵
aujm	㔶
arhw	㔸
hlkf	㔽
gnhk	㔿
dgak	㕃
dgxi	㕄
dyei	㕈
dwyd	㕍
dfkf	㕑
ugqc	㕗
cwty	㕙
cyyi	㕚
khcu	㕜
nmhc	㕞
kwyy	㕨
kdhh	㕩
kpqn	㕪
ktdy	㕭
kwry	㕮
krbh	㕳
kpwn	㕴
ydhk	㕻
ikxb	㕾
kvgh	㖀
krdc	㖁
kjxt	㖂
krgk	㖃
kyth	㖄
kmag	㖆
kwhg	㖉
kvfy	㖊
wjkx	㖋
ufkx	㖍
kxwj	㖎
kkvt	㖐
kuxt	㖒
ktdh	㖓
kgdk	㖔
ufkf	㖖
kmwn	㖗
kdfe	㖘
ekkx	㖙
wfkx	㖚
dkxb	㖛
ykkx	㖜
fikx	㖝
kepc	㖟
kdfi	㖠
kohx	㖢
kukg	㖣
kbib	㖤
klty	㖥
kgji	㖦
kqaj	㖧
kviy	㖨
kbcy	㖩
kakg	㖪
kfwt	㖫
kecy	㖬
kgdn	㖭
mgkx	㖯
kxmk	㖰
vkkx	㖲
ivkx	㖳
kaqr	㖴
ksfg	㖶
kjgh	㖷
kwvl	㖹
kdwj	㖺
kcns	㖻
kafs	㖼
kkut	㖾
kbbh	㖿
kmxx	㗀
kith	㗂
knnj	㗃
knhc	㗇
kcee	㗈
kqdd	㗋
kpgf	㗌
ktjg	㗍
keks	㗎
kdyl	㗐
kwnp	㗓
kamf	㗕
keeg	㗖
kerf	㗗
kgef	㗘
kqbt	㗙
kttd	㗛
kyxl	㗜
kugo	㗝
kdhc	㗞
vckx	㗠
ktge	㗢
kaqh	㗣
kbqb	㗦
knrg	㗩
khxi	㗪
kwfi	㗫
ipkq	㗬
kton	㗭
qkow	㗮
ftjx	㗯
ktwh	㗰
kwys	㗱
kvfg	㗲
ktwk	㗳
kueg	㗴
koow	㗵
kwxc	㗶
kpam	㗷
ktrs	㗸
kgdd	㗺
kmnp	㗻
kogi	㗼
kusk	㗿
keoy	㘀
kuxn	㘂
ksly	㘄
ktqs	㘅
koos	㘇
kxth	㘈
ktvb	㘉
kfyg	㘊
kahm	㘋
kiwa	㘍
uthx	㘏
kcor	㘐
kffi	㘑
ttgx	㘒
kugi	㘓
kaal	㘕
kutm	㘖
yxxk	㘘
kkkt	㘙
kwgd	㘛
lnte	㘠
lked	㘣
lijg	㘤
leri	㘥
fxxn	㘩
fqcy	㘬
ftet	㘯
fnvn	㘲
uxff	㘳
fdmh	㘵
fary	㘷
fway	㘺
fldy	㘻
fftn	㘼
ffxy	㘽
fpgf	㘾
ftxy	㙁
fukq	㙂
frgw	㙃
fxxf	㙄
fksy	㙅
fmaw	㙉
fdey	㙊
fadw	㙋
fvij	㙌
fccc	㙍
ftjt	㙏
fmdj	㙐
tkmf	㙑
lcnf	㙒
fnkh	㙔
ftky	㙖
flge	㙗
fsvg	㙘
idnf	㙙
ykmf	㙜
fths	㙞
atdf	㙠
famy	㙢
fxde	㙣
fgjl	㙧
fxxy	㙨
fdui	㙩
fwys	㙫
fduw	㙭
ftwk	㙮
fwfc	㙯
kgnf	㙱
fyxy	㙲
fdgn	㙳
fqdy	㙴
fykf	㙵
fjxo	㙷
fwow	㙸
falq	㙹
fakm	㙺
fojf	㙻
fddj	㙽
ferb	㙾
fhaa	㚀
fgke	㚂
fpru	㚃
rbwt	㚇
bqqu	㚉
qqmk	㚋
qqjs	㚌
qqkm	㚍
dtyy	㚒
fwfw	㚘
ekdu	㚙
dqkf	㚚
dxjf	㚛
dssu	㚞
qkxd	㚟
dugo	㚠
dskk	㚡
vgjh	㚦
vnfh	㚨
vtfn	㚪
vbyy	㚫
vqug	㚬
vpwn	㚮
vwry	㚯
vdhg	㚰
vhkg	㚲
vekg	㚳
vdmh	㚴
vtuy	㚵
vwiy	㚷
vngk	㚸
vqtb	㚹
agnv	㚽
vkqn	㚾
vqnn	㚿
vqvg	㛀
vguf	㛁
vrcn	㛂
dhvv	㛃
vyey	㛄
vbsy	㛆
vofg	㛇
vftn	㛈
vwsy	㛊
vwny	㛋
vctg	㛌
vdww	㛍
vkkg	㛎
vgiy	㛏
vgjr	㛐
hqcv	㛑
vgku	㛒
vrdh	㛓
vtdh	㛔
vkcn	㛕
vcwt	㛖
vwwf	㛗
vfpb	㛘
vufh	㛙
vceh	㛚
vtmt	㛛
whtv	㛜
vqmd	㛟
vujg	㛠
vpfq	㛡
vtbt	㛢
vkmy	㛣
vssy	㛦
vmdg	㛧
vufq	㛨
vyce	㛩
vdjn	㛪
vjqr	㛫
vfwf	㛬
vajg	㛭
vpoc	㛮
vqke	㛯
vnnj	㛰
vvtr	㛴
vemf	㛵
vmdo	㛶
tdnv	㛷
vfku	㛸
vwgr	㛹
vpoy	㛽
vgkh	㛿
vshg	㜀
vsjg	㜁
fffv	㜂
vwtj	㜄
vyxl	㜅
vvkc	㜉
vnae	㜊
vuwl	㜋
vovk	㜍
vexd	㜎
vmgu	㜐
igev	㜑
veah	㜒
vawk	㜓
vlpy	㜕
vgmj	㜖
vhag	㜘
vonx	㜙
vpwj	㜚
vlqw	㜛
vgqt	㜜
lrvf	㜞
vnbt	㜟
vtwh	㜡
vlvg	㜢
vqdo	㜣
vsjf	㜤
vlmy	㜥
vvaf	㜦
vduw	㜧
vnig	㜨
vtmd	㜩
vqdy	㜬
vipl	㜭
vahl	㜮
vaho	㜯
vrxs	㜰
vrrm	㜱
vyle	㜳
valh	㜴
xgwv	㜷
vhhy	㜹
vtfm	㜺
vyxn	㜻
vccg	㜼
bwjh	㜾
bcnh	㜿
qjbf	㝁
brrh	㝂
bqkq	㝃
bfkk	㝆
pqyu	㝌
pgng	㝍
pwcu	㝐
pncu	㝕
pqqu	㝖
pyve	㝗
pggw	㝙
pthp	㝚
pgfg	㝞
pghq	㝟
ptky	㝢
pdhd	㝣
pamf	㝤
pnho	㝥
pwyb	㝦
pfke	㝨
povi	㝩
pfuy	㝪
pbtg	㝫
pdhw	㝬
pnjg	㝭
pbmc	㝮
ptdk	㝯
pthy	㝰
pnhq	㝱
pnhh	㝲
jgfu	㝵
lqfu	㝶
vavf	㝷
irqb	㝸
itqy	㝹
uvot	㝺
akgt	㝻
dngf	㝼
dnii	㝽
dnda	㝾
dnjx	㞁
dnev	㞂
wwky	㞃
dndk	㞆
dnya	㞈
dnua	㞉
nvyi	㞍
ntpi	㞏
nffn	㞑
nthd	㞒
nxjd	㞓
nqqi	㞔
nwed	㞕
ngmi	㞖
ngiy	㞗
ntfi	㞙
ntfe	㞚
ntxj	㞛
nttv	㞜
nusd	㞟
naae	㞡
bhgd	㞢
bhwv	㞣
mwyu	㞩
mqyu	㞮
mkhh	㞲
mqan	㞴
bhgf	㞷
mskg	㞹
mtdu	㞺
mkgn	㞻
bimj	㞼
mnxn	㞾
mfru	㞿
mdfh	㟁
mugh	㟄
mrbq	㟅
mwxf	㟆
mwwf	㟇
mptg	㟉
mebg	㟊
mukq	㟋
mevg	㟎
mfpb	㟑
mrdh	㟓
mkuf	㟕
mgaj	㟖
mwvv	㟗
majg	㟙
sfcm	㟚
mraf	㟛
mxqi	㟜
mawb	㟟
mudb	㟡
mviu	㟤
mcde	㟥
mplj	㟦
mmdj	㟨
nnam	㟩
mriy	㟫
mptk	㟯
mpjw	㟰
mugo	㟱
mdri	㟲
mlgh	㟵
mawk	㟷
mrdf	㟸
mbqb	㟹
mlvf	㟺
lrmj	㟻
mgqt	㟼
msfi	㟽
movh	㟾
myud	㠃
mnrf	㠄
mttt	㠅
mkkl	㠆
myky	㠇
mugg	㠈
mhag	㠊
madw	㠌
mwys	㠍
msfj	㠒
mape	㠓
mnkf	㠔
mbtc	㠕
mtmd	㠗
myke	㠙
mogf	㠚
mawc	㠛
mfwm	㠝
tmgm	㠞
mhal	㠠
myce	㠡
mrqe	㠢
mllf	㠥
mmdu	㠦
mosd	㠧
msrf	㠨
wnkb	㠩
uoga	㠮
hnnd	㠯
mhxn	㠲
mhvy	㠴
mhtw	㠶
mhby	㠷
mhfw	㠸
mhwj	㠹
mhit	㠺
mhrh	㠼
mhtu	㠽
hxmh	㠿
umii	㡀
mhdn	㡁
mhqj	㡄
mhqq	㡅
mhbn	㡇
mhxx	㡉
mhqe	㡊
mhje	㡌
mhuj	㡐
tomh	㡑
mhpl	㡓
mhuo	㡘
mhtx	㡙
mhaf	㡚
mhak	㡛
mhwi	㡜
mhtp	㡝
mhlv	㡞
mhgj	㡟
mhwu	㡠
mhdf	㡡
yupd	㡣
mhoi	㡤
mhen	㡥
mhpm	㡦
mhet	㡪
xjqn	㡫
xxaq	㡬
xxgn	㡭
xxdn	㡮
otav	㡯
oqyi	㡱
oqav	㡳
okwi	㡶
oegd	㡹
ojgd	㡺
oqtb	㡻
ojxe	㡼
ovgk	㡽
ovei	㡾
oubt	㡿
ogmi	㢀
oqqi	㢁
ogku	㢄
ojfd	㢆
owyd	㢈
otta	㢉
odsk	㢊
owqq	㢋
obsk	㢌
otfe	㢎
ohag	㢒
oxty	㢕
oake	㢙
ohae	㢚
owgw	㢛
oaln	㢜
oqot	㢝
onlw	㢞
imka	㢢
fqny	㢤
sksy	㢦
xnna	㢯
xciy	㢱
xxgw	㢲
xtey	㢳
xlry	㢴
xmqy	㢷
xuvg	㢺
xumi	㢼
xbxn	㢽
xgkh	㣂
xycx	㣃
xias	㣄
xaqj	㣅
xgrh	㣇
fjye	㣋
hket	㣌
cket	㣍
rier	㣎
djfe	㣏
riet	㣐
ovee	㣑
ulje	㣒
tqkg	㣘
tadt	㣝
twcq	㣞
thtu	㣠
taay	㣤
tssy	㣩
tegc	㣪
tkbg	㣬
tfmf	㣮
tnie	㣯
tton	㣰
trlo	㣳
tfup	㣵
tpns	㣷
togg	㣸
town	㣹
nvyy	㣼
ncyy	㣾
nqyy	㣿
bynu	㤂
aqnu	㤅
nrcy	㤆
naht	㤉
nrry	㤊
nafg	㤌
eknu	㤎
ntuy	㤏
hknu	㤐
ndkg	㤑
ndfh	㤒
nsgg	㤓
nwfy	㤔
nbmh	㤕
npsh	㤖
mngn	㤙
ntgs	㤚
nwtf	㤛
nycq	㤝
npta	㤞
manu	㤟
gqjn	㤠
ngqj	㤡
ndeg	㤢
njry	㤤
nynw	㤥
ngkr	㤦
gqbn	㤪
denu	㤫
nffg	㤬
ntdj	㤭
nmwk	㤯
wthn	㤰
ngku	㤱
ndhk	㤳
nbnn	㤴
btnu	㤵
nfoy	㤸
qytn	㤻
nfce	㤼
ndtf	㤽
npws	㤾
ndjn	㤿
nfhg	㥀
njgf	㥂
nfwt	㥄
nepc	㥅
nviy	㥆
mhhn	㥈
nukg	㥉
nqoy	㥌
tqtn	㥎
nmaw	㥏
nesy	㥒
ndsk	㥓
njyy	㥗
nkhn	㥙
newy	㥚
nbkg	㥛
nleg	㥜
nxbg	㥝
nuey	㥞
nxge	㥟
nnhe	㥠
nnxs	㥡
nusg	㥢
dffn	㥣
njmy	㥥
novg	㥪
nykj	㥫
nyuy	㥬
ndwi	㥭
eavn	㥯
nehc	㥰
nahd	㥱
ndri	㥳
nrhw	㥴
nnan	㥸
owvn	㥹
nfcl	㥺
dtxn	㥻
ngho	㥼
ngmy	㥽
gqtn	㥿
ntdp	㦀
lpnu	㦁
ipkn	㦂
naqh	㦅
nhaf	㦆
nonx	㦇
nugl	㦈
nagf	㦊
ndfj	㦋
nkkt	㦍
nvfg	㦎
nnnw	㦏
nafy	㦐
nnbt	㦑
nlyg	㦒
nqdo	㦓
jedn	㦔
nbtg	㦕
nuny	㦖
nssi	㦗
rytn	㦘
njmn	㦙
udnf	㦚
ejfn	㦟
nogf	㦠
nrxs	㦡
ntvb	㦢
tnkn	㦣
npdn	㦥
nueq	㦦
ntfj	㦧
nugi	㦨
nben	㦩
nyoc	㦪
ntfm	㦫
nlxy	㦬
nfkw	㦭
acgd	㦯
fqxy	㦲
atkd	㦴
riay	㦵
ceha	㦷
hjfa	㦸
jgqa	㦹
dfea	㦺
nray	㦻
dwea	㦼
deav	㦽
ynbv	㦾
ynsi	㦿
ynld	㧂
rnhh	㧃
rmgg	㧇
rgmh	㧊
raht	㧎
rdxy	㧔
rqtb	㧕
hxrj	㧘
rntt	㧙
jtyr	㧛
ramh	㧜
ekrj	㧝
rtdc	㧞
rciy	㧠
rynw	㧡
rriy	㧣
rycq	㧤
rtfq	㧥
ryck	㧧
rwgh	㧩
rqdb	㧪
abrj	㧭
rftx	㧯
rtni	㧰
rpsy	㧲
rdhk	㧵
rtmt	㧶
rgdk	㧷
rykb	㧸
rjgf	㧹
rldg	㧽
rtgi	㨀
rfhg	㨁
rgji	㨂
ihcr	㨇
rnnj	㨉
rdae	㨊
fprc	㨌
fffr	㨍
rdmd	㨎
rmdo	㨏
rwks	㨐
rrbt	㨑
rbcl	㨕
rgct	㨖
rhvh	㨗
rith	㨘
rhay	㨜
rnie	㨝
rgxi	㨞
rpjw	㨠
rcex	㨢
rxmw	㨥
rqyl	㨨
rotp	㨩
rjiq	㨪
rjtl	㨫
rfke	㨬
rync	㨭
rrqq	㨮
rywe	㨰
raps	㨲
rfjn	㨴
ruev	㨵
rwvo	㨶
rpnm	㨸
rdhv	㨹
lrrj	㨻
ltkr	㨼
rqef	㩂
rpau	㩃
rmln	㩄
rgjl	㩅
ryky	㩆
rvfg	㩇
rwgn	㩉
rvfj	㩋
rxjm	㩌
rjey	㩎
rlfo	㩏
rtff	㩐
rgdd	㩑
rssi	㩒
eawr	㩓
rnac	㩔
rfwc	㩕
rmwb	㩗
rpaf	㩙
rahl	㩜
roos	㩞
rpas	㩟
raly	㩢
rnpl	㩣
rget	㩤
rjai	㩧
rdhn	㩨
rxdm	㩪
rrrm	㩫
rhaa	㩬
rerb	㩭
regr	㩮
raks	㩰
rhhy	㩴
rpao	㩷
rccg	㩹
xxfc	㩺
qdbc	㩻
tfac	㩾
tnty	㩿
gfty	㪀
rnhc	㪂
skhc	㪃
xjty	㪄
gmwc	㪅
qayc	㪆
vtkc	㪊
jfhc	㪋
cehc	㪌
fpbt	㪍
rtfc	㪏
djnc	㪑
eqhc	㪒
tfuc	㪓
sshc	㪔
hjfc	㪕
vihc	㪖
ukhc	㪗
jsty	㪙
adwc	㪛
mdmc	㪜
glic	㪝
ykjt	㪟
uvoc	㪠
pdhc	㪡
ehcc	㪢
vfjc	㪩
gdhc	㪪
halc	㪭
fkkc	㪮
yqmd	㪱
fquf	㪴
djuf	㪶
lvuf	㪹
dhhf	㪺
skrh	㪼
gjrj	㪽
tkrh	㪾
btbr	㪿
jjrh	㫀
oaor	㫂
fqyr	㫄
yrkh	㫊
yrhg	㫌
ytsv	㫏
jgqb	㫕
jkqn	㫛
jbhc	㫞
jwkg	㫟
jtuu	㫡
jjnb	㫣
jpvg	㫨
dwhj	㫪
jgog	㫫
jqjg	㫬
jjgq	㫯
jfpb	㫲
jvph	㫶
jrnr	㫹
jrmj	㫼
jviy	㫽
jimk	㫾
jiwk	㬁
jjmy	㬂
jcko	㬃
jlyr	㬅
jnnj	㬆
jqmd	㬇
jwnd	㬋
jyji	㬌
jgef	㬍
jgoj	㬐
jpyg	㬕
jynk	㬖
jyct	㬚
jwgn	㬛
julj	㬝
jmjn	㬞
qruj	㬟
jqvo	㬠
jfwc	㬡
jogf	㬣
jjxo	㬤
jbmo	㬥
jbmi	㬧
jdhn	㬩
etfh	㬳
eywr	㬵
etfk	㬶
elsy	㬷
eawx	㬸
eqvh	㬹
eayk	㬻
eykt	㬿
etaw	㭀
snfh	㭄
bgsu	㭆
scqn	㭇
sthn	㭊
sdhh	㭋
stgh	㭌
sfnh	㭏
dgsu	㭐
scah	㭓
sffy	㭙
stey	㭚
srey	㭛
sadt	㭜
ssvb	㭝
stfq	㭠
stlr	㭡
sqyg	㭤
sqmy	㭥
spta	㭦
sahb	㭨
sefy	㭩
skej	㭭
svgq	㭮
sbnn	㭯
hxgi	㭰
salh	㭱
swwk	㭲
sftb	㭳
sjcf	㭴
sqlg	㭵
sayt	㭶
slet	㭷
sxyx	㭹
sdjn	㭺
simk	㭻
sijg	㭼
soqy	㭽
snbm	㭾
sjqb	㭿
sbib	㮀
srde	㮁
hdsu	㮂
stvg	㮃
sfqy	㮄
swug	㮆
sdfi	㮈
sdeb	㮋
uejs	㮍
sdhl	㮎
sith	㮐
stfe	㮑
ssfg	㮒
sngg	㮓
stgf	㮔
sdmd	㮕
sakf	㮖
hlws	㮚
sjgh	㮛
sanf	㮜
suqk	㮞
saps	㮠
swnd	㮢
vcas	㮣
scdl	㮥
sfpi	㮦
swno	㮧
slwt	㮨
saws	㮪
sclf	㮭
sdhr	㮮
stlx	㮰
sqbt	㮲
seud	㮳
sehc	㮴
syty	㮵
sube	㮶
sdnj	㮷
sudp	㮸
sgct	㮹
scyj	㮻
stec	㮽
yvcs	㮾
sjaf	㮿
sbuk	㯁
saqh	㯂
sswi	㯃
ssrc	㯄
sorf	㯅
sutg	㯆
shdf	㯇
sgkp	㯈
shaf	㯉
sgho	㯊
xsdm	㯋
sysy	㯎
fnws	㯏
bdas	㯐
sehq	㯒
sadr	㯕
sfln	㯖
susy	㯗
syct	㯙
stwk	㯚
sfpg	㯛
sayf	㯜
skhk	㯝
sxke	㯞
ssvi	㯟
syxg	㯠
snnw	㯢
sads	㯦
sfhk	㯧
sfwc	㯪
shae	㯫
ssvp	㯬
slqj	㯮
stam	㯯
slfh	㯰
saqt	㯳
sapk	㯴
sobt	㯶
swow	㯷
svhl	㯸
ahns	㯺
safl	㯼
sgmp	㯾
svln	㯿
stqi	㰀
sddd	㰁
sptl	㰂
srmi	㰃
smaa	㰄
syup	㰅
sslp	㰈
sfwo	㰊
shhm	㰋
uegs	㰍
smwm	㰎
styk	㰏
sbdp	㰐
snns	㰑
serb	㰒
sahm	㰓
syoc	㰔
syry	㰚
sars	㰛
sfhm	㰜
nnqw	㰝
mqwy	㰞
rnqw	㰟
ywqw	㰠
gaqw	㰢
hxqw	㰣
skqw	㰤
anqw	㰥
fcqw	㰦
ckqw	㰧
ffqw	㰪
tfqw	㰫
qjqw	㰬
dfnw	㰭
gkuw	㰯
dwww	㰰
tfjw	㰱
ukqw	㰴
thkw	㰶
gqxw	㰷
dgkw	㰹
nhfw	㰺
ajvw	㰽
ryqw	㰾
exdw	㰿
qbtw	㱀
bmfw	㱁
oviw	㱂
fpgw	㱅
hagw	㱆
ssfw	㱈
fwyw	㱋
bbbw	㱌
liqw	㱎
fhyi	㱐
hskf	㱒
hwyc	㱓
hxqu	㱔
hvph	㱕
djeh	㱘
gqgn	㱙
gqhy	㱜
gqhc	㱟
gqye	㱢
gqev	㱣
gqdk	㱦
gqpb	㱧
gqfd	㱩
gqnj	㱪
gqle	㱬
gqwc	㱭
gqmu	㱯
gqrc	㱱
gqul	㱲
ajdq	㱳
gqgm	㱴
gqfe	㱶
gqws	㱷
gqnf	㱸
gqhl	㱺
nnwc	㱼
pqwc	㱽
yntc	㱾
fmgc	㱿
dfec	㲀
pwac	㲁
imkc	㲂
hjxc	㲃
fnwu	㲇
qkxx	㲋
tfnb	㲌
fctn	㲍
qktn	㲒
uftn	㲔
eftn	㲕
ietn	㲖
ebtn	㲗
mtfn	㲘
tdkn	㲛
ootn	㲜
ywwn	㲞
amdn	㲟
ehcn	㲣
ykgn	㲤
ovhn	㲥
abtn	㲨
ooon	㲭
pnln	㲰
qayw	㲳
rnkh	㲴
rnho	㲶
rnkl	㲷
iwcy	㳂
ivfh	㳃
iqwy	㳄
idhy	㳅
iufh	㳆
idmh	㳍
icah	㳎
ikry	㳏
isnn	㳐
idkg	㳓
icfy	㳔
iudg	㳕
iyey	㳖
icyf	㳗
iceg	㳙
iewy	㳛
ifpy	㳡
iftx	㳣
iuay	㳤
ibnn	㳧
ivgq	㳨
idhk	㳪
iksy	㳭
iniy	㳮
iyca	㳰
ibjg	㳱
idqn	㳳
intf	㳴
itbg	㳵
iqrj	㳷
iajg	㳻
akgi	㳼
ixti	㳽
iufq	㳾
iycs	㳿
iatp	㴀
igdj	㴁
imwg	㴄
ilwk	㴅
ivph	㴆
irgm	㴈
iccf	㴉
iubj	㴊
ivij	㴋
ivdg	㴌
ibdi	㴍
idfi	㴎
ihgn	㴐
iout	㴑
iqvn	㴔
iakf	㴖
isvg	㴗
ijhg	㴘
itfe	㴙
iuey	㴚
igct	㴛
tjwi	㴝
iehj	㴞
idjb	㴟
ibkb	㴠
iiwh	㴢
iigw	㴣
isyg	㴤
imie	㴥
ieud	㴨
ivkc	㴩
iths	㴪
itmf	㴬
ipwh	㴭
inie	㴮
iexj	㴯
icex	㴰
ipwu	㴱
irhw	㴲
ifdy	㴳
iogn	㴴
intl	㴵
ibpq	㴷
iopy	㴹
igkf	㴻
ipwj	㴼
iton	㴽
ifpt	㴾
isdm	㴿
iytd	㵀
ioao	㵂
ijpx	㵃
iakd	㵄
iwym	㵅
ijtk	㵆
itdf	㵇
iivd	㵈
ijbc	㵊
ilmy	㵋
iuny	㵍
iayf	㵏
iduw	㵐
ixjm	㵒
ipjh	㵓
idfj	㵔
iccn	㵕
ivki	㵖
iwrq	㵚
iyek	㵝
ipwm	㵠
iflg	㵢
ijqw	㵣
indw	㵤
ipnl	㵥
idap	㵦
iajn	㵧
iaas	㵩
ibbj	㵫
iebl	㵬
ifto	㵭
iwdo	㵯
irlh	㵲
ipne	㵳
ibci	㵵
imad	㵹
illl	㵽
irrr	㵿
iene	㶀
iiro	㶃
iuqe	㶄
ierb	㶅
iyfj	㶆
iooj	㶈
iexg	㶉
iahm	㶊
iogg	㶋
ibxg	㶌
ilgp	㶎
iben	㶏
iown	㶐
iuco	㶒
illd	㶔
ituj	㶕
iwho	㶖
txxi	㶗
itsf	㶘
iiog	㶙
isae	㶚
iytw	㶛
iion	㶝
ijye	㶞
illi	㶟
icof	㶠
opqn	㶩
duou	㶫
oxet	㶭
gmwo	㶮
oehh	㶲
vgou	㶳
oqqy	㶴
opey	㶶
oqjg	㶷
oaiy	㶹
ogdk	㶺
tdho	㶻
octd	㶼
okmw	㶽
ofpb	㶿
oonf	㷀
oceh	㷁
ahno	㷂
odeu	㷃
odjn	㷈
nfof	㷉
ovph	㷌
ojqn	㷎
ttfo	㷏
oefg	㷐
osff	㷑
oqrn	㷓
oehj	㷔
thno	㷗
ocks	㷘
oyod	㷜
odjb	㷞
ownp	㷟
hano	㷡
ugao	㷢
ougg	㷣
oobg	㷥
boou	㷦
odri	㷧
omth	㷨
owyb	㷪
fnwo	㷫
ofdg	㷯
oyrc	㷰
cefo	㷱
otge	㷲
dtto	㷴
olfo	㷵
onnw	㷷
oykf	㸀
uepo	㸂
lfho	㸃
oyuj	㸄
otvb	㸅
ofwm	㸇
ofwy	㸌
ohaa	㸍
obbb	㸎
tudh	㸔
wreg	㸖
wrmk	㸗
wrls	㸘
wrfj	㸙
thgw	㸝
udtf	㸤
ahyi	㸦
tnhh	㸨
tgmh	㸬
tpxn	㸰
dtgj	㸴
dhvg	㸷
trgk	㸸
tefy	㸹
tctd	㸻
tfpw	㸿
tfpb	㹀
tplh	㹆
tjqn	㹇
tdri	㹉
twhe	㹋
tyud	㹍
fqdg	㹕
tooh	㹙
took	㹚
tdht	㹛
qtqa	㹝
qtnw	㹟
qtyx	㹡
qtek	㹢
qtmg	㹨
qtcf	㹩
qtgw	㹫
qtiq	㹰
qtfb	㹲
qtrq	㹸
qtij	㹺
qttv	㹻
qtqo	㹼
qtaa	㹽
qtvr	㺁
qtym	㺆
qtun	㺊
qtuo	㺌
qtlv	㺏
qtvs	㺐
qtne	㺒
qttl	㺕
qtkl	㺗
qtwo	㺘
qtca	㺛
qtal	㺝
qtew	㺞
qtpy	㺠
qtbg	㺦
gnhh	㺩
gfnn	㺮
ggmh	㺰
wbgy	㺱
gnfg	㺲
gcah	㺹
gnhy	㺼
gmkg	㺾
gahh	㺿
gjry	㻀
glkg	㻁
guah	㻂
magy	㻃
gtgh	㻄
gwfc	㻅
gceg	㻆
gwgg	㻇
grgk	㻈
ghht	㻉
gqkq	㻊
ggki	㻋
gwgs	㻌
gvoy	㻏
glty	㻒
gbcy	㻓
gtfg	㻔
gnbm	㻕
gpjh	㻘
gyce	㻙
gjqr	㻛
gwwh	㻜
ggkj	㻝
gdae	㻟
gans	㻡
gytb	㻢
gusg	㻥
gjmy	㻦
guvo	㻩
gwyb	㻪
gffn	㻬
gyxf	㻭
gwfi	㻮
ghaf	㻯
gdhv	㻰
glvg	㻲
gjlc	㻴
gnbb	㻵
gtvg	㻶
ggmi	㻷
gaqj	㻸
gsjf	㻼
glqj	㻿
gfup	㼀
gugy	㼁
gvln	㼃
gxxl	㼄
glxy	㼈
rcyq	㼉
gbny	㼊
drcy	㼋
diry	㼍
rcyr	㼎
evry	㼏
rcyo	㼓
jlry	㼔
mhgy	㼙
gagy	㼛
qbgy	㼝
rigy	㼡
ahky	㼢
djgy	㼣
ftgy	㼥
cehy	㼧
jsgy	㼫
fhky	㼭
gvhy	㼮
gjiy	㼯
jghy	㼵
ayny	㼹
ovhy	㼺
ujfy	㼿
toly	㽃
afgy	㽍
afuo	㽐
afsf	㽑
lywn	㽘
lcqn	㽙
kklf	㽞
lefy	㽟
lqoy	㽤
luxx	㽧
luga	㽨
lcce	㽩
yxtl	㽫
lmwk	㽯
eenh	㽰
unhk	㽱
ugnv	㽲
udyi	㽴
upqv	㽸
urci	㽹
ubyi	㽺
ufci	㽻
uxhk	㽼
ubmk	㽾
urcy	㽿
usyi	㾁
uckd	㾂
upxv	㾃
umfd	㾆
ugmi	㾊
udmj	㾍
uvkd	㾒
uked	㾓
ujfd	㾖
ugjr	㾘
urdh	㾙
uhxf	㾚
udww	㾜
uhhe	㾟
ufcb	㾡
upwa	㾤
uhgc	㾥
uukd	㾦
ujsi	㾧
udsk	㾨
utfx	㾩
uith	㾪
uyna	㾫
uxxr	㾬
utoi	㾭
urgd	㾮
uwfq	㾱
uuqv	㾳
usjg	㾴
uyfk	㾵
umed	㾶
urhw	㾷
uhxs	㾹
ubws	㾻
uvep	㾼
uwnp	㾽
uuvo	㾾
uyvb	㾿
urdf	㿁
umgt	㿂
uaqh	㿃
uatc	㿄
utye	㿆
unrd	㿇
uxty	㿈
uaqj	㿊
ukks	㿋
ufam	㿎
uvtg	㿏
ufhq	㿐
unwy	㿑
ufnf	㿒
udwh	㿓
ulll	㿔
uuqe	㿕
uhal	㿖
utwm	㿗
uook	㿘
ulxy	㿚
ugmx	㿛
rqiu	㿡
jerf	㿢
rdwj	㿤
hcvy	㿪
xxhc	㿫
ryhc	㿭
ywrc	㿰
rrhc	㿱
hcvl	㿳
dbhc	㿴
hcdd	㿵
yupc	㿶
ugac	㿷
hcjc	㿸
hcfp	㿹
galf	㿼
wgnl	㿽
pslf	㿾
iblf	䀀
pntl	䀄
pyfl	䀅
drml	䀇
vcal	䀈
tdkl	䀉
inwl	䀊
fthl	䀋
ujfl	䀍
hgnn	䀎
hcyy	䀑
hvyy	䀓
hxhh	䀕
hgdy	䀖
hgah	䀘
havt	䀙
hqbj	䀚
hqrt	䀛
qrhf	䀜
hxxn	䀝
hufh	䀞
hxjh	䀟
hhkg	䀡
htdy	䀢
hntt	䀣
qhhf	䀤
htni	䀥
htdg	䀨
htkg	䀩
htgs	䀪
hwgg	䀬
hynw	䀭
hynk	䀮
hgey	䀯
hwwk	䀰
htdh	䀱
htxy	䀲
hgki	䀳
hgva	䀴
hctd	䀵
hyve	䀶
hfce	䀷
rrhf	䀸
hdww	䀹
hmgn	䀻
hdfe	䀼
hthp	䀽
dchf	䀾
hrrh	䀿
hrrj	䁀
hyki	䁁
hfuf	䁄
hblg	䁅
hdjn	䁆
pnth	䁇
ynah	䁉
hcyh	䁊
hans	䁋
hleg	䁌
hyks	䁎
hsvg	䁏
hamd	䁐
hjgr	䁑
hkbg	䁒
hrbt	䁓
hegc	䁔
hnnj	䁕
hmgu	䁗
herm	䁘
hjpv	䁙
hkmy	䁚
hrqc	䁛
hjiq	䁜
ooph	䁝
wwwh	䁞
huga	䁟
huvo	䁠
huwy	䁡
hyth	䁢
hgjf	䁣
hyud	䁤
haak	䁥
hakw	䁧
hykb	䁨
hqoy	䁩
hlrh	䁪
hlfo	䁫
hulj	䁬
hdyy	䁭
haqj	䁮
hffq	䁱
hlmy	䁲
hylg	䁴
hlge	䁵
hryt	䁶
hmae	䁸
hnkf	䁹
hlff	䁺
hrxs	䁻
hvln	䁽
lfoh	䁿
hugy	䂀
hqky	䂁
helf	䂃
hhhc	䂄
hyxj	䂅
cnhy	䂆
dahs	䂋
tdvk	䂏
tdbm	䂐
tdhx	䂑
tdfk	䂒
tdff	䂔
tdxe	䂕
gwkf	䂖
ekdf	䂟
dhxn	䂣
dnna	䂥
dldy	䂩
dtah	䂫
dofg	䂯
dtjh	䂰
dukq	䂱
fced	䂲
dfce	䂶
dtfx	䂷
dqoy	䂹
djsy	䂺
ddey	䂻
dsww	䂾
dgvv	䃀
djxx	䃂
dmun	䃃
dyki	䃄
dulh	䃅
dxxr	䃈
dnnj	䃉
daeg	䃊
duey	䃍
djtg	䃏
dtec	䃑
damf	䃓
oopd	䃕
dwno	䃖
dvij	䃗
dahf	䃘
donx	䃙
dytd	䃚
dlpy	䃛
ykbd	䃞
daet	䃟
dqqw	䃢
dvfj	䃤
btgd	䃧
dxkj	䃨
dmae	䃩
dylg	䃪
dqdy	䃫
dmrc	䃬
dfup	䃮
dris	䃯
dpwi	䃰
dtel	䃲
dvln	䃳
dyce	䃵
dugi	䃹
dfae	䃻
pyhy	䃼
pyxx	䃾
pyay	䄀
pyan	䄁
udfi	䄅
pykg	䄇
pygu	䄈
pydn	䄋
pycc	䄌
pyaj	䄍
pyad	䄏
pyqj	䄑
pyrg	䄓
pyil	䄕
pyjg	䄗
pylv	䄛
pyyc	䄜
pywi	䄞
pyyg	䄠
pyyj	䄢
pyfm	䄣
pygm	䄤
tayy	䄩
ttfh	䄭
tmwy	䄲
tgxw	䄺
tgmg	䄼
tjxt	䄿
tgqj	䅀
pvtu	䅁
ttkg	䅂
awyt	䅃
teee	䅄
tuqw	䅆
udtu	䅈
tota	䅊
tqkq	䅋
ttbt	䅎
tntn	䅏
thqn	䅐
tevg	䅑
tayn	䅒
tqkc	䅓
tndg	䅕
tdjn	䅖
tjjg	䅛
tmeg	䅢
ttfe	䅤
talg	䅦
tyji	䅫
tuwl	䅬
tldn	䅰
tmgu	䅱
tfpi	䅴
tugo	䅵
tauf	䅸
tlvg	䅹
tjlc	䅼
fnwt	䅽
tlfo	䆀
tlff	䆁
tuqm	䆅
tkks	䆆
tuxw	䆊
tqxg	䆋
tolw	䆏
pwsj	䆑
pwcq	䆓
pwnw	䆕
pwdc	䆖
pwlj	䆘
pwgh	䆙
pwka	䆛
pwtt	䆤
pwge	䆥
pwtv	䆧
pwjd	䆨
pwhd	䆩
igqa	䆪
pwic	䆮
pwcv	䆯
pwio	䆱
pwoi	䆲
pwck	䆷
pwhe	䆽
pwab	䇀
utnn	䇄
uufh	䇆
ucfg	䇈
uocy	䇊
uieg	䇌
ukhy	䇍
uajg	䇎
uykb	䇏
uviy	䇐
vcau	䇒
edmu	䇓
ufdj	䇕
tqtr	䇖
twcu	䇗
txhj	䇙
twhu	䇚
tqwu	䇜
taff	䇞
tqer	䇟
tygf	䇠
tpsj	䇡
ttah	䇨
tjxr	䇩
tahh	䇫
triu	䇬
tlqu	䇱
tkej	䇷
tkgf	䇸
tvtk	䇹
tgku	䇺
tkcb	䇼
tgki	䇿
tmmj	䈀
tuaj	䈂
tivk	䈃
tbib	䈄
tecb	䈈
tuvf	䈉
tynh	䈍
tndo	䈐
twct	䈗
tckn	䈚
thmc	䈛
twvc	䈜
tykj	䈞
tmjj	䈟
tcks	䈢
tght	䈣
tqee	䈥
teto	䈧
tbve	䈨
txmw	䈫
tigy	䈬
trqc	䈭
tuqk	䈮
teef	䈱
tjnf	䈳
tstk	䈷
tqef	䈸
tpnm	䈼
tsie	䈾
tpjw	䈿
toao	䉀
tbwc	䉁
tfuy	䉅
tadj	䉇
taet	䉈
tqey	䉉
tcdl	䉊
tvnh	䉋
tbue	䉌
tunu	䉍
tips	䉎
tqeg	䉏
ttol	䉒
tsjs	䉓
tgqa	䉔
tulj	䉕
tlwc	䉖
trkb	䉗
tspi	䉘
tffc	䉙
ttmd	䉛
trwc	䉟
ttmt	䉠
teqo	䉣
tovt	䉤
trtn	䉥
tsdp	䉦
tqyj	䉧
tuec	䉨
tsak	䉩
tlll	䉪
towc	䉬
tahm	䉯
tmer	䉰
tpuk	䉱
txgr	䉲
tudf	䉸
tfkw	䉹
uxou	䉾
owgh	䊃
oqkg	䊅
opsy	䊉
ontn	䊊
ooxx	䊌
oudb	䊎
oimk	䊑
omeg	䊘
dgao	䊙
orsc	䊛
ogjf	䊜
oton	䊝
oyud	䊞
ofpu	䊦
oxjm	䊧
olhd	䊫
tjso	䊬
oyfj	䊰
soug	䊲
oosd	䊳
xftt	䊷
xgxg	䊺
ynxi	䋀
xmry	䋄
xynt	䋆
xnyy	䋇
vcxi	䋈
xpwy	䋉
xskg	䋍
xjgg	䋎
xthf	䋏
xgny	䋐
xgmw	䋑
xcnt	䋒
xqvg	䋓
wtfi	䋕
xvgh	䋖
xdiy	䋘
ynci	䋜
xivg	䋝
xmrr	䋞
xgey	䋠
xwgs	䋡
rrxi	䋢
xndg	䋧
xukg	䋨
xeqn	䋩
xbsk	䋪
xqvh	䋫
xgdn	䋬
xyce	䋭
hdxi	䋰
xsww	䋱
xkjn	䋲
xuxe	䋳
xcns	䋴
xrfh	䋸
xgkl	䋹
xtoy	䋺
xfmf	䋻
xbcl	䋼
xdqq	䋾
xtuf	䌀
xsvg	䌁
xgmc	䌄
xovk	䌅
xrqc	䌆
xfpi	䌇
xjng	䌈
xlgh	䌉
xerm	䌊
xawk	䌋
xnrg	䌌
ltki	䌎
xpnm	䌏
xehq	䌐
xahf	䌑
xonx	䌒
txwi	䌓
xoss	䌕
xwys	䌖
xrlo	䌗
xsoy	䌚
xogi	䌜
xssi	䌝
xnkf	䌟
dgki	䌠
xmau	䌡
xfwc	䌢
xean	䌥
xfnf	䌧
xawi	䌨
xaly	䌩
xuqe	䌪
xued	䌬
xawo	䌭
xfsh	䌮
xaky	䌯
xbbb	䌰
xato	䌲
xnij	䌵
xjtl	䍀
rmgf	䍂
rmhk	䍄
rmwc	䍅
rmps	䍆
rmkw	䍉
rmyr	䍊
rmuk	䍌
rmao	䍎
mjgd	䍏
mrrf	䍑
laht	䍓
ldcu	䍔
lqnb	䍖
ltxu	䍙
lyve	䍚
lldf	䍛
lwyf	䍜
lijf	䍝
mrrg	䍞
lrbt	䍟
lyrc	䍠
lrlo	䍢
lyuj	䍤
lyry	䍦
uggh	䍨
uggs	䍪
ugxy	䍭
ugqb	䍯
ugeq	䍲
ugcc	䍳
ugtv	䍴
uggi	䍶
ugkn	䍺
ugdh	䍽
gang	䍾
mfng	䎃
vkng	䎄
teng	䎇
njxt	䎈
tkng	䎊
tfkn	䎋
nkhy	䎌
nijg	䎓
uljn	䎖
vfjn	䎘
pghn	䎙
ftxx	䎜
vdmj	䎟
vydj	䎠
dink	䎤
dioo	䎦
diuk	䎧
didn	䎨
divl	䎩
dijf	䎪
dirt	䎫
ditp	䎭
diyd	䎮
diaw	䎯
bjhh	䎶
bgkg	䎸
tobf	䎹
brmj	䎺
bviy	䎼
bqaj	䎽
btoy	䎿
bgkj	䏀
bpuf	䏁
behc	䏂
bpjw	䏃
bpwf	䏄
bgmj	䏆
bsfi	䏇
bxxi	䏈
vinn	䏋
ewyy	䏎
enwy	䏐
qmww	䏑
ethn	䏒
mufq	䏓
enfg	䏔
exhh	䏖
ernn	䏗
eaqn	䏘
epqn	䏙
eitt	䏚
equg	䏛
ebyy	䏜
egsy	䏞
entt	䏟
efiy	䏡
ehcy	䏢
emfg	䏥
etdg	䏦
eqqy	䏧
ewnn	䏨
ewgk	䏩
eeiy	䏮
evyn	䏰
ennk	䏱
euxt	䏲
eieg	䏴
exxf	䏶
egkg	䏸
ehqn	䏹
etdh	䏺
cefc	䏻
eaay	䏼
eukg	䏽
edwg	䏾
edsk	䐀
eviy	䐂
elty	䐃
entd	䐅
eesy	䐆
eqrj	䐇
efhg	䐈
evlg	䐉
ejxx	䐊
ewcn	䐋
mawe	䐌
efku	䐍
ejgh	䐎
edwj	䐏
etoy	䐐
eans	䐑
edqq	䐒
eyna	䐔
ekbg	䐕
enoy	䐖
eftj	䐗
eegc	䐘
evcb	䐚
edbg	䐛
eimy	䐝
exuu	䐞
eamf	䐟
yuhw	䐡
ekmy	䐣
euga	䐤
efcl	䐦
eykk	䐧
ewyb	䐪
etwh	䐫
egmj	䐬
eaqh	䐭
eutg	䐮
elxi	䐯
ewhe	䐰
eyud	䐱
enrg	䐲
eqoy	䐳
vcae	䐴
eamw	䐵
eaqj	䐶
evfg	䐸
evfj	䐹
esjf	䐺
eduf	䐻
edhi	䐼
eamy	䐽
etmd	䐿
enkf	䑀
erre	䑁
eegw	䑂
muae	䑃
ethj	䑄
ealq	䑅
euge	䑆
erxs	䑈
eyny	䑉
ekhp	䑊
eyke	䑋
eugi	䑌
emmv	䑍
afpf	䑓
tdeg	䑚
aooh	䑞
epqg	䑟
tecy	䑡
tegq	䑢
teet	䑣
teby	䑥
teqk	䑦
tetb	䑨
teqi	䑬
teia	䑭
tepb	䑱
tehf	䑲
teje	䑵
tepi	䑸
teyb	䑻
teqt	䑼
tejn	䑽
tepj	䑿
tenr	䒁
tenf	䒂
tefm	䒈
wgnc	䒊
mdqc	䒋
pjyc	䒌
adyc	䒎
uljc	䒏
uytg	䒑
angf	䒒
agnb	䒓
anfj	䒖
atnb	䒗
aitr	䒚
axnb	䒛
atgj	䒜
arru	䒝
adhj	䒠
axhj	䒡
atpu	䒦
apvy	䒯
abig	䒱
avta	䒲
avbf	䒵
ajxr	䒶
adiu	䒹
axiu	䒺
amnb	䒻
amaf	䒼
amrr	䒽
ayeu	䒾
apef	䒿
affu	䓁
akcb	䓃
aqtr	䓄
airj	䓅
arrj	䓆
afou	䓇
atwc	䓈
agkf	䓊
aiqa	䓋
afnu	䓌
adhk	䓏
adgn	䓐
aiga	䓑
aqlf	䓒
aftb	䓔
afqp	䓕
atfx	䓙
anbm	䓛
aiqy	䓜
ablf	䓝
aijf	䓠
aldf	䓢
agmy	䓣
aqrn	䓤
amaw	䓦
abkg	䓧
aprm	䓨
asfc	䓩
ajqr	䓪
arsj	䓭
agxu	䓯
ahxs	䓱
awuq	䓲
atve	䓳
admd	䓴
agkj	䓶
aits	䓷
avvf	䓸
apfv	䓻
avdy	䓼
aiiv	䓾
aclf	䓿
awtv	䔀
apuf	䔂
apyg	䔃
aerm	䔄
askk	䔅
amgu	䔇
aamu	䔈
axit	䔋
arsg	䔌
acou	䔍
abuk	䔒
aytf	䔓
aujq	䔔
aegy	䔕
abft	䔖
armg	䔘
aqqy	䔙
axdm	䔛
abmf	䔜
ahxi	䔝
ayxf	䔞
asie	䔠
awwn	䔢
atjg	䔣
ardj	䔤
avoj	䔥
astx	䔦
atjs	䔧
axty	䔨
agkt	䔩
apnh	䔭
apgl	䔰
arkb	䔱
aqdo	䔳
abmc	䔴
ausu	䔵
arjh	䔶
aggn	䔷
abue	䔹
abde	䔺
avyh	䔼
aijn	䔽
arjn	䔾
ausf	䔿
affw	䕀
ahds	䕁
ackp	䕂
abil	䕄
avec	䕅
aswj	䕆
aorc	䕇
anhs	䕈
alff	䕉
aylg	䕊
afok	䕋
atwy	䕌
ayek	䕍
ajgl	䕎
augy	䕏
apyl	䕐
axev	䕑
apwi	䕓
aijc	䕕
abtp	䕖
athj	䕗
aydw	䕛
anyf	䕜
atef	䕝
auye	䕞
aemw	䕟
aowc	䕠
aukk	䕡
adua	䕢
apun	䕣
awwr	䕥
aeui	䕨
asdi	䕩
ailf	䕪
arht	䕫
axgg	䕬
aotl	䕰
aoyi	䕲
axgr	䕳
afko	䕵
aosi	䕷
alfk	䕸
aogc	䕺
agmx	䕻
aaky	䕼
akhj	䕽
ajmn	䖁
ayxr	䖂
afkw	䖅
asge	䖆
asre	䖇
haxv	䖈
hawj	䖌
hati	䖍
bhaw	䖎
haqy	䖏
hagu	䖒
bmhw	䖓
hawg	䖕
hawl	䖖
hady	䖗
hawi	䖛
ynju	䖟
jwyy	䖠
jnfg	䖡
jitt	䖢
jrhy	䖣
qbju	䖤
jntt	䖩
hxju	䖪
jwfh	䖫
udju	䖭
ffju	䖯
jrey	䖰
jpta	䖳
trxj	䖸
jyck	䖻
jfcb	䖼
tjju	䖽
tqtj	䖿
jfwt	䗀
jdsk	䗁
jhaw	䗂
jaay	䗃
jwrr	䗄
jdey	䗅
jphn	䗆
jqoy	䗇
jafs	䗋
jsfg	䗎
jpoc	䗏
ytbj	䗐
juog	䗒
jfcl	䗘
pawj	䗙
jwhe	䗛
jqyl	䗜
pyjj	䗝
gdjj	䗞
atdj	䗟
afjj	䗣
jovh	䗤
jtdp	䗦
jovi	䗧
jdhy	䗩
oaoj	䗪
joss	䗫
jkkn	䗭
jdrr	䗮
jxfm	䗰
jogw	䗱
jwgu	䗳
jttp	䗴
jglg	䗵
jajn	䗶
jujn	䗷
juxn	䗹
jtvb	䗻
xwyj	䗽
jpns	䗿
fwyj	䘁
jfhy	䘂
jpdn	䘆
jdae	䘈
jtly	䘊
jwwg	䘋
aadj	䘌
jyxx	䘎
tlvw	䘐
tlyi	䘑
tlct	䘒
tlqe	䘓
tlpk	䘔
tyws	䘕
trms	䘖
tmts	䘗
tgxs	䘘
yefj	䘚
pucg	䘞
puxh	䘟
pudr	䘠
xxye	䘡
pups	䘢
puhx	䘣
pusy	䘤
punx	䘦
pumd	䘧
puqj	䘩
puyq	䘪
vkye	䘫
fwwe	䘮
puie	䘯
putp	䘰
pusc	䘴
puvi	䘵
puyf	䘹
puph	䘺
pupb	䘼
pupn	䘾
punm	䘿
puee	䙀
pusv	䙅
purh	䙉
pugh	䙊
pupg	䙋
puyl	䙒
pulc	䙓
puyd	䙗
pung	䙙
puwu	䙞
pugd	䙣
pump	䙤
puaq	䙦
puje	䙨
puae	䙩
pumv	䙬
punj	䙱
sdnb	䙴
spey	䙶
hqfi	䙸
gahq	䙹
tnhq	䙻
duhq	䙽
pxhq	䙾
tehq	䚀
tmkq	䚁
hmnq	䚃
vihq	䚄
amdq	䚆
sfhq	䚈
dhvq	䚉
uwlq	䚊
kmhq	䚋
rdfq	䚌
oqaq	䚏
tdkq	䚐
lmhq	䚑
ujfq	䚒
sjfq	䚓
gmyq	䚕
tqes	䚘
qehx	䚠
qehn	䚡
qehu	䚥
yufh	䚵
ygdy	䚶
ynfg	䚼
yqwy	䚿
yrcy	䛀
ymfg	䛁
yfqn	䛃
yqbn	䛄
ywkg	䛇
ydxy	䛋
yqnn	䛌
yxjh	䛍
ypwy	䛎
ynxn	䛏
ngky	䛐
yntt	䛑
jtyy	䛓
ydmj	䛔
yjry	䛕
yjxt	䛖
ytlr	䛜
ynfm	䛝
yjfh	䛞
ygku	䛠
yqak	䛡
ykhy	䛤
yrdh	䛥
ywwk	䛦
ypwx	䛪
ydey	䛫
yfuf	䛭
ythk	䛮
yjxx	䛰
ykhn	䛱
ydjn	䛳
yepc	䛵
ydhs	䛶
ypqb	䛷
yohk	䛸
yxge	䛹
ylwj	䛺
yrfh	䛻
yeag	䛼
ytfe	䛽
ygxi	䛾
ygkh	䛿
yrdf	䜂
ossy	䜆
yvjs	䜈
yswi	䜉
ygmj	䜊
ykhm	䜋
ydui	䜍
yooe	䜎
ybde	䜏
bday	䜐
ygfn	䜑
ytmd	䜒
yaas	䜓
ydap	䜔
yajy	䜕
ysmy	䜖
ydgn	䜗
yaqt	䜘
yjxo	䜙
ylip	䜚
yqkq	䜛
yhph	䜜
ydet	䜡
ypdn	䜢
yawy	䜤
yjgp	䜥
wwkv	䜪
hpgk	䜭
wwkf	䜰
gkuh	䜶
cnhu	䜼
gkul	䝀
gefg	䝅
qrge	䝆
wqge	䝇
gerb	䝈
gecc	䝌
gepl	䝍
gemj	䝎
gelv	䝏
gebe	䝐
gebi	䝒
gevn	䝓
geay	䝔
gebb	䝕
erhy	䝖
eary	䝙
ehaw	䝞
edhd	䝟
edri	䝠
ejlc	䝢
eias	䝣
etli	䝦
mqug	䝧
jcmu	䝨
mwet	䝩
mnhy	䝪
mygg	䝬
myxy	䝮
mtbn	䝯
eeem	䝱
mnyu	䝲
hqcm	䝳
myki	䝶
tdkm	䝷
mafc	䝸
mpqb	䝹
yymu	䝺
fhnm	䝾
ewmu	䝿
mwnd	䞀
majv	䞁
mdmd	䞂
mimy	䞆
meto	䞈
mudm	䞉
mhah	䞊
musq	䞋
mtdg	䞌
mjjg	䞎
mlny	䞏
foag	䞑
fomk	䞒
foga	䞓
fhay	䞖
fhtn	䞘
fhgn	䞛
fhdh	䞜
fhxj	䞞
fhrd	䞟
fhry	䞣
fhff	䞨
fhwk	䞩
fhar	䞪
fhtb	䞬
fhct	䞭
fheb	䞯
fhfo	䞰
fhcc	䞵
fhjr	䞶
fhrg	䞹
fhrh	䞺
fhxe	䞼
fhfi	䞽
fhua	䟀
fhvs	䟁
fhjc	䟂
fhgm	䟄
fhlj	䟉
fhhe	䟊
fhwa	䟑
khsh	䟓
khcy	䟕
khmh	䟖
khqa	䟗
khav	䟙
khmw	䟜
khtc	䟦
khna	䟨
khtp	䟪
khrg	䟬
khtd	䟯
khts	䟰
khyq	䟲
khrr	䟷
khef	䟹
khmy	䟺
khcc	䟾
khvi	䟿
khik	䠀
khcf	䠁
sskh	䠂
khlt	䠅
khnm	䠇
khrf	䠋
khnc	䠍
khhs	䠕
khpy	䠚
khem	䠛
khab	䠜
khkl	䠤
khtj	䠦
khnj	䠧
khbi	䠫
khwb	䠬
khuo	䠮
tmdc	䠲
tmdw	䠹
lnhh	䡂
lfqn	䡇
lrry	䡈
lxcy	䡏
tlgs	䡓
lqqy	䡔
lgwf	䡖
awyl	䡗
lqlg	䡘
lrqn	䡚
lfwf	䡜
hwlj	䡞
lhmy	䡠
lyna	䡢
lplh	䡣
ftjl	䡤
lpwk	䡥
lccs	䡦
lwno	䡧
lfhw	䡩
ltdp	䡫
ljlc	䡬
lugf	䡭
ltwh	䡮
ltln	䡯
fnwl	䡰
lkkl	䡲
ladr	䡳
luep	䡵
lnkf	䡶
lafl	䡷
laly	䡸
lfph	䡹
ldhn	䡺
lthy	䡻
ltfm	䡽
lhay	䡾
lfkw	䡿
ltnn	䢀
ckss	䢄
pwdf	䢆
etle	䢉
gjpk	䢋
gapk	䢎
ufpk	䢏
egpd	䢐
qayp	䢑
ywrp	䢒
pgfp	䢓
dgxp	䢕
mapd	䢗
pfpi	䢘
gjrp	䢚
mwkp	䢛
vpmp	䢜
gfgp	䢝
sspi	䢞
ytpi	䢟
ansp	䢡
wyvp	䢢
qypd	䢣
tsyp	䢤
ghhp	䢥
yxip	䢦
nwep	䢧
twwp	䢨
gktp	䢩
tdkp	䢪
epqp	䢬
ugup	䢭
flpd	䢮
ooqp	䢯
nwyp	䢰
flmp	䢱
hhwp	䢲
tdbh	䢴
fcbh	䢵
mybh	䢷
egbh	䢸
anbh	䢹
bmbh	䢺
awbh	䢼
awkc	䢽
pvbh	䢿
dibh	䣂
gvab	䣆
giyb	䣇
kckc	䣈
iitc	䣉
imkb	䣊
tobh	䣋
vlbh	䣎
wawb	䣏
amdb	䣐
khgb	䣒
gkmb	䣓
imbh	䣔
cobh	䣕
cokc	䣖
ipkb	䣘
meeb	䣙
lvbh	䣚
haeb	䣜
nftb	䣝
kkub	䣞
ugtb	䣡
diab	䣢
hhwb	䣤
sget	䣦
sgay	䣧
sgta	䣨
sggn	䣩
sggh	䣪
sgfc	䣫
sgan	䣰
sgca	䣲
sgnk	䣳
sgrq	䣴
sgtd	䣶
sgri	䣷
sgwk	䣻
sgyi	䣼
sgas	䤂
sgpc	䤇
sgnl	䤉
sgab	䤊
sghr	䤏
sgaw	䤑
sgxy	䤒
sgae	䤓
ilrg	䤔
sgrs	䤕
ujfg	䤗
qnhh	䤛
qmfg	䤡
qqdb	䤥
qway	䤦
qlkg	䤧
qrey	䤨
qmwn	䤫
qiit	䤬
qrdh	䤭
qhht	䤮
qgae	䤯
fqwq	䤰
qmrh	䤱
qfoy	䤲
qbib	䤴
qajv	䤷
qxge	䤸
qpoc	䤹
qdrh	䤺
qdae	䤻
qliy	䤽
qdhr	䤿
qbhj	䥀
qclf	䥁
qpfe	䥂
qdaj	䥄
yhdq	䥆
qada	䥈
qpqy	䥉
qgmy	䥊
qyko	䥋
pjjq	䥌
fufq	䥍
qtrb	䥏
qswq	䥑
xcjq	䥒
qadf	䥓
qumt	䥕
qusd	䥖
qwwj	䥘
qbue	䥙
whhq	䥚
qdhi	䥛
qusy	䥜
qrjn	䥟
fkuq	䥢
eawq	䥣
quto	䥥
qdap	䥦
qhph	䥧
qukk	䥨
qjxo	䥪
giyq	䥭
qsab	䥮
qlcx	䥯
qynj	䥰
qpeo	䥱
qakw	䥲
qdet	䥳
qmwm	䥴
qjfq	䥵
qdth	䥶
qthj	䥷
xgwq	䥸
qqrt	䥼
qrgq	䥿
qdtb	䦁
qgje	䦄
dcda	䦈
dclg	䦉
dcgt	䦋
ufqv	䦎
uuak	䦕
ufkd	䦖
utld	䦗
utdd	䦚
ufoi	䦝
uigd	䦞
uifc	䦢
uccc	䦤
ueqv	䦧
uamd	䦫
utjd	䦭
udwj	䦮
uqjn	䦰
ueto	䦱
uxtb	䦳
ugwr	䦵
ujmy	䦸
bnwy	䦼
wnnq	䦾
bkhh	䦿
bqkg	䧁
bvkg	䧂
btkg	䧄
bgxw	䧅
bawy	䧆
byey	䧇
bhqn	䧋
bevg	䧌
bkeg	䧎
bykb	䧐
bsww	䧒
baay	䧖
btjt	䧗
bxge	䧘
bykk	䧚
byuy	䧛
bovk	䧜
bcoy	䧞
beeg	䧟
bgjf	䧠
bovh	䧡
bakk	䧢
bogw	䧤
bgjn	䧥
beto	䧦
bugy	䧧
bogi	䧨
bnbt	䧩
bodv	䧪
byke	䧫
bpgm	䧬
bpdn	䧮
bqky	䧯
bqoi	䧰
pqwy	䧵
tfky	䧼
towy	䧽
jpvy	䨃
dujy	䨅
pghy	䨈
mmvy	䨉
ftab	䨋
ffqb	䨌
fxcu	䨎
fuqw	䨏
fgxw	䨑
flkf	䨓
figf	䨕
fdef	䨖
febf	䨗
fhqb	䨘
fsrj	䨛
feef	䨜
fiff	䨟
fbib	䨡
fmpu	䨤
fuwc	䨧
fpyh	䨩
fswq	䨫
ffce	䨭
fdhv	䨮
fbgi	䨯
fiaf	䨰
fogf	䨴
fisf	䨵
fchn	䨶
fssc	䨷
fwho	䨹
ffcc	䨺
geac	䨼
ohdd	䨾
gdhd	䨿
hdhm	䩀
dmjx	䩃
dmjc	䩅
dmjb	䩊
dmjs	䩋
dmji	䩍
dmjw	䩎
nkaw	䪏
nkat	䪐
nkax	䪑
nkag	䪒
nkao	䪕
nkac	䪗
tnhg	䪠
ujag	䪦
ujqy	䪨
ekuj	䪪
ujga	䪫
ujqt	䪮
ujun	䪰
gqdm	䪲
vtdm	䪳
pqdm	䪴
ahtm	䪵
egdm	䪶
qkdm	䪷
cadm	䪻
kgnm	䪽
dmwe	䪾
vcdm	䫀
qqdm	䫂
dfem	䫃
ukqm	䫄
psdm	䫅
dnxm	䫆
emfm	䫇
dhkm	䫊
adwm	䫏
ssdm	䫐
dskm	䫑
qajm	䫒
dhvm	䫔
yupm	䫕
nhfm	䫗
jqwm	䫘
fasm	䫙
mxxm	䫜
tjdm	䫝
ugom	䫞
kmdm	䫟
edhm	䫠
uvom	䫡
rham	䫢
exdm	䫣
pjym	䫤
rqcm	䫥
fclm	䫦
rdfm	䫧
lvdm	䫫
aqam	䫬
vakm	䫮
ydsm	䫯
dmoh	䫰
lqjm	䫳
ssfm	䫴
thpm	䫵
gkkm	䫷
wtjv	䫸
dcwj	䫺
wtjx	䬁
ukqj	䬇
wtjq	䬈
wtjm	䬙
fnuh	䬠
ftjh	䬡
wyvt	䬢
wytn	䬣
nwye	䬤
dhwe	䬩
kvwe	䬭
wyhk	䬯
wyqk	䬲
wygs	䬴
wynp	䭀
rrwe	䭁
wykc	䭂
wyld	䭅
dewe	䭌
wygl	䭍
wyas	䭎
wyun	䭐
wywp	䭔
lrwe	䭕
wyji	䭘
wydi	䭜
wywj	䭝
wykp	䭤
wyaf	䭦
wyoi	䭧
qnjf	䭪
xjuh	䭫
uthm	䭭
tjui	䭱
tjdk	䭲
tvrj	䭳
cofj	䭴
cogj	䭶
cowr	䭸
cowv	䭻
corw	䭿
coca	䮁
cogy	䮅
codf	䮆
covg	䮇
coqq	䮈
cogw	䮊
cogk	䮏
coef	䮑
cohf	䮓
cocc	䮕
cojj	䮖
comf	䮗
coeq	䮘
coft	䮚
cobf	䮛
coas	䮜
codj	䮞
copc	䮟
cott	䮡
copy	䮤
come	䮩
coqs	䮪
colv	䮫
cosq	䮮
cogt	䮯
coyd	䮰
cogp	䮱
cowu	䮴
colj	䮷
cohy	䮹
coyj	䮺
coff	䮻
cooo	䮽
coud	䮾
coph	䮿
cgpv	䯃
cgkw	䯄
cgbc	䯅
menn	䯆
meet	䯇
meqw	䯉
mesk	䯊
medy	䯋
menv	䯌
mewf	䯎
metd	䯏
meiq	䯑
mets	䯒
meff	䯓
mepa	䯔
metp	䯕
meye	䯖
mexf	䯗
mepq	䯘
megy	䯙
mexe	䯚
mepb	䯛
mejr	䯜
mede	䯝
memk	䯞
meue	䯟
mejl	䯠
meuo	䯡
osse	䯢
mekm	䯣
mejo	䯥
ykpk	䯧
ykmd	䯨
ykll	䯬
dcev	䰀
dcel	䰐
hggn	䰗
hgge	䰘
gkmc	䰙
rqch	䰠
rqcs	䰢
gjic	䰤
akgc	䰥
iwec	䰪
rqcq	䰫
fdmc	䰰
qosh	䰳
qobg	䰵
qodh	䰷
qocn	䰾
qoxe	䱂
qorw	䱃
qory	䱄
qogs	䱅
qobb	䱆
qoeg	䱉
qoah	䱌
qogu	䱏
qoeb	䱐
qorr	䱑
qokc	䱒
qowt	䱔
qotx	䱕
tjqo	䱘
qoaj	䱜
qorf	䱝
qond	䱟
qoaa	䱠
qoyf	䱣
rmho	䱥
qoub	䱧
qomn	䱩
qodd	䱮
qoyh	䱱
qodf	䱳
qome	䱻
qolv	䱾
qolr	䱿
qovs	䲃
qoar	䲉
qobe	䲊
qofw	䲌
teuo	䲍
qohe	䲐
qouy	䲑
qoqg	䲒
qoww	䲓
qots	䲗
qgwb	䲝
qgig	䲤
qawo	䲭
bywo	䲯
ywwo	䲳
owvo	䲴
itwo	䲵
wjwo	䲸
yxwo	䲻
tgwo	䲼
agno	䲾
nxwo	䲿
xwvo	䳇
dcyo	䳊
jwvo	䳋
cewo	䳌
ewvo	䳎
ffwo	䳏
fwvy	䳒
ebwo	䳕
mgno	䳙
jfwo	䳚
jvwo	䳛
wgso	䳜
ukwo	䳝
jewo	䳟
tfao	䳠
fqxo	䳣
pgjo	䳦
rgwo	䳨
svwo	䳩
mdmo	䳪
vcbo	䳭
eyno	䳮
bmfo	䳳
liwo	䳴
lrwo	䳻
ujfo	䴀
pjmo	䴁
qkeo	䴂
fffo	䴃
epqo	䴄
famo	䴅
tmoo	䴈
lgko	䴉
ugto	䴊
pgro	䴐
fkko	䴒
hloe	䴛
godx	䴡
onjv	䴧
swwr	䴯
txts	䵈
myaw	䵊
amwe	䵋
amwb	䵍
amwl	䵐
twiy	䵑
twid	䵕
twil	䵗
twiq	䵙
twie	䵚
twif	䵛
gdlo	䵡
lfog	䵣
galo	䵤
lfoc	䵥
flfy	䵧
tjlo	䵩
lfor	䵮
lfos	䵲
thdo	䵵
qkxg	䵶
ffxg	䵷
hndv	䵻
wffc	䵾
yuhv	䶒
hbcn	䶕
hbwn	䶖
hbsk	䶗
hbug	䶘
gqjb	䶛
hbtk	䶜
hbdw	䶝
hbaw	䶞
hbqe	䶟
dgkb	䶠
hbmj	䶡
hbdy	䶢
hbmu	䶣
hbme	䶤
hbhg	䶥
hbgm	䶦
hbfq	䶧
hbww	䶨
hbyj	䶩
hbfy	䶪
hbkt	䶫
dxyg	䶭
vtxg	䶯
tutx	䶱
oqwa	䶴
